apophysial fracture	złamanie wyrostka
articular fracture	złamanie wewnątrzstawowe
atlas	kręg szczytowy
axis	kręg obrotowy
Barton fracture	złamanie typu Bartona
basal skull fracture	złamanie podstawy czaski
basilar bone	część podstawna kości potylicznej
bending fracture	złamanie spowodowane zgięciem
Bennett fracture	złamanie Bennetta
bimalleolar fracture	złamanie dwukostkowe
birth fracture	złamanie okołoporodowe
blow-out fracture	złamanie rozprężające oczodołu
bones of cranium	kości czaszki
bones of digits	kości palców
bones of foot	kości stopy
bones of lower limb	kości kończyny dolnej
boxer's fracture	złamanie kości śródręcza
calcaneus	kość piętowa
capillary fracture	złamanie szczelinowate
capitate	kość główkowata
carpal bones	kości nadgarstka
cervical vertebrae	kręgi szyjne
Chance fracture	złamanie Chance'a
clavicle	obojczyk
clay shoveler's fracture	złamanie awulsyjne podstawy wyrostka kolczystego kręgu C-7, C-6 lub T-1
closed fracture	złamanie proste/zamknięte
closed skull fracture	złamanie kości czaszki proste/zamknięte
coccygeal vertebrae	kregi guziczne
coccyx	kość guziczna
Colles fracture	złamanie Collesa
comminuted (skull) fracture	złamanie wieloodłamkowe (czaszki)
compact bone	istota zbita
complex fracture	złamanie złożone
compound (skull) fracture	złamanie otwarte (czaszki)
cortical bone	istota korowa
craniofacial dysjunction fracture	złamanie poprzeczne kości twarzy
cribriform plate of ethmoid bone	blaszka sitowa kości sitowej
cuboid (bone)	kość sześcienna
dentate fracture	złamanie z nierównym brzegiem odłamów
depressed fracture	złamanie z wgnieceniem
depressed skull fracture	złamanie z wgnieceniem kości czaszki
derby hat fracture	złamanie czaszki z wgnieceniem
diastatic skull fracture	złamanie z rozejściem się szwów czaszki
direct fracture	złamanie bezpośrednie
dishpan fracture	złamanie z wgnieceniem kości czaszki
dislocation fracture	złamanie ze zwichnięciem
distal phalanx of foot	paliczek dalszy stopy
distal phalanx of hand	paliczek dalszy ręki
double fracture	złamanie podwójne
Dupuytren fracture	złamanie Dupuytrena
epiphyseal fracture	złamanie nasadowe
epiphysial fracture	złamanie nasadowe
ethmoid (bone)	kość sitowa
expressed skull fracture	złamanie czaszki z przemieszczeniem odłamu
extracapsular fracture	złamanie przystawowe (pozatorebkowe)
facial bones	kości twarzoczaszki
fatigue fracture	złamanie zmęczeniowe
femur	kość udowa
fetal fracture	złamanie wewnątrzmaciczne
fibula	strzałka
fissured fracture	złamanie szczelinowe
flat bone	kość płaska
folding fracture	złamanie częściowe
fracture	złamanie
fracture by contrecoup	złamanie z odbicia
frontal bone	kość czołowa
Galeazzi fracture	złamanie Galeazziego
Gosselin fracture	złamanie Gosselina
greenstick fracture	złamanie typu zielonej gałązki
growing fracture	złamanie rosnące
Guérin fracture	złamanie Guérina
gutter fracture	złamanie z wytworzeniem rowka
hairline fracture	złamanie szczelinowate
hamate (bone)	kość haczykowata
hangman's fracture	złamanie wisielcze
hip bone	kość miedniczna
hip fracture	złamanie biodra
horizontal fracture	złamanie poprzeczne
humerus	kość ramienna
hyoid bone	kość gnykowa
ilium	kość biodrowa
impacted fracture	złamanie zaklinowane
incisive bone	kość przysieczna
incomplete fracture	złamanie niezupełne
incus	kowadełko
indirect fracture	złamanie z odbicia
inferior nasal concha	małżowina nosowa dolna
interalveolar septa	przegrody międzyzębodołowe szczęki i żuchwy
intermediate cuneiform (bone)	kość klinowata pośrednia
interparietal bone	kość międzyciemieniowa
intertrochanteric fracture	złamanie międzykrętarzowe
intraarticular fracture	złamanie wewnątrzstawowe
intracapsular fracture	złamanie wewnątrztorebkowe
intrauterine fracture	złamanie wewnątrzmaciczne
irregular bone	kość nieregularna/ kość różnokształtna
ischium	kość kulszowa
lacrimal bone	kość łzowa
lateral cuneiform (bone)	kość klinowata boczna
Le Fort I fracture	złamanie typu Le Fort I
Le Fort II fracture	złamanie typu Le Fort II
Le Fort III craniofacial dysjunction	złamanie kości twarzoczaszki z oddzieleniem kości
Le Fort III fracture	złamanie typu Le Fort III
linear (skull) fracture	złamanie szczelinowate (czaszki)
linear fracture	złamanie podłużne
long bone	kość długa
longitudinal fracture	złamanie szczelinowate
lumbar vertebrae	kręgi lędźwiowe
lunate (bone)	kość księżycowata
malleus	młoteczek
mandible	żuchwa
march fracture	złamanie marszowe
mastoid process	wyrostek sutkowaty
maxilla	szczęka
medial cuneiform (bone)	kość klinowata przyśrodkowa
metacarpal (bones) [I–V]	kości śródręcza (I–V)
metatarsal (bones) [I–V]	kości śródstopia (I–V)
middle phalanges of foot and hand	paliczki środkowe stopy i ręki
Monteggia fracture	złamanie Monteggi
multiple fracture	złamanie wielokrotne
nasal bone	kość nosowa
navicular (bone)	kość łódkowata
neurogenic fracture	złamanie kości zmienionej troficznie
oblique fracture	złamanie skośne
occipital bone	kość potyliczna
occult fracture	złamanie utajone
open (skull) fracture	złamanie otwarte (czaszki)
palatine bone	kość podniebienna
parietal bone	kość ciemieniowa
parry fracture	złamanie obronne kości łokciowej
patella	rzepka
pathologic fracture	złamanie patologiczne
pectoral girdle	obręcz kończyny górnej/ obręcz barkowa
pelvic girdle	obręcz kończyny dolnej/ obręcz miedniczna
petrochanteric fracture	złamanie przezkrętarzowe
petrous part of temporal bone	część skalista kości skroniowej
pilon fracture	złamanie typu pilon
ping-pong fracture	złamanie czaszki z wgnieceniem
pisiform (bone)	kość grochowata
pneumatized bone	kość pneumatyczna
pond fracture	złamanie czaszki z wgnieceniem
Pott fracture	złamanie Potta
proximal phalanx of foot	paliczek bliższy stopy
proximal phalanx of hand	paliczek bliższy ręki
pubis	kość łonowa
pyramidal fracture	złamanie piętra twarzy
radius	kość promieniowa
rib	kość żebrowa/ żebro
ribs	żebra
sacral vertebrae	kręgi krzyżowe
sacrum	kość krzyżowa
scaphoid (bone)	kość łódeczkowata
scapula	łopatka
segmental fracture	złamanie podwójne
sesamoid bone	trzeszczka
Shepherd fracture	złamanie Shepherda
short bone	kość krótka
shoulder girdle	obręcz kończyny górnej/ obręcz barkowa
silver-fork fracture	złamanie bagnetowate
simple fracture	złamanie proste/zamknięte
simple skull fracture	złamanie kości czaszki proste/zamknięte
Skillern fracture	złamanie Skillerna
skull fracture	pęknięcie czaszki
Smith fracture	złamanie Smitha
sphenoid (bone)	kość klinowa
spiral fracture	złamanie spiralne
splintered fracture	złamanie wieloodłamkowe
spontaneous fracure	złamanie samoistne
sprain fracture	złamanie z oderwania
stable fracture	złamanie stabilne
stapes	strzemiączko
stellate fracture	złamanie gwiaździste czaszki
sternum	mostek
strain fracture	złamanie z oderwania
stress fracture	złamanie zmęczeniowe
subcapital fracture	złamanie podgłowowe
subperiosteal fracture	złamanie podokostnowe
substantia spongiosa	istota gąbczasta
supracondylar fracture	złamanie nadkłykciowe
suprasternal bones	kości nadmostkowe
sutural bones	kości szwów
talus	kość skokowa
temporal bone	kość skroniowa
thoracic (dorsal) vertebrae	kręgi piersiowe
tibia	kość piszczelowa /piszczel
toddler's fracture	złamanie u małego dziecka
torsion fracture	złamanie skrętowe
torus fracture	złamanie częściowe
transcervical fracture	złamanie szyjki kości
transcondylar fracture	złamanie przezkłykciowe
transverse facial fracture	złamanie poprzeczne kości twarzy
transverse fracture	złamanie poprzeczne
trapezium (bone)	kość czworoboczna większa
trapezoid bone (wrist)	kość czworoboczna mniejsza
triangular bone	kość trójkątna
trimalleolar fracture	złamanie trójkostkowe
tripod fracture	złamanie jarzmowo-szczękowe
triquetrum (bone)	kość trójgraniasta
tympanic ring	pierścień bębenkowy
ulna	kość łokciowa
unstable fracture	złamanie niestabilne
ununited fracture	złamanie niezrośnięte
vesalianum	kość Wesaliusza
vomer (bone)	lemiesz
zygomatic bone	kość jarzmowa
[paid at] 100% [no reimbursement]	100%
aphasia	afazja
death cerificate	akt zgonu
limb amputation	amputacja kończyny
angio-CT	angio-TK
article ... section ... item ...	art. ... ust. ... pkt. ...
motor artifacts	artefakty ruchowe
asystole	asystolia
atropine	atropina
AV [atrioventricular] block	AV blok
nitrites	azotyny
pupil	źrenica
parenteral nutrition	żywienie pozajelitowe
intracerebral	śródmózgowy
health care service	świadczenie zdrowotne
patient	świadczeniobiorca
service provider	świadczeniodawca
wheezes	świsty
diagnostic examinations	badania diagnostyczne
pathology tests	badania diagnostyki laboratoryjnej
digital imaging examinations	badania diagnostyki obrazowej
additional examinations	badania dodatkowe
control examination	badanie kontrolne
laryngological examination	badanie laryngologiczne
MR examination	badanie MR
MRI examination	badanie MR
general urinalysis	badanie ogólne moczu
physical examination	badanie przedmiotowe
radiological examination	badanie radiologiczne
non-injury pain	ból nieurazowy
tympanic membrane	błona bębenkowa
apnea	bezdech
protein	białko
diarrhea	biegunka
bilirubin	bilirubina
tenderness to palpation	bolesność palpacyjna
leteral sulcus	bruzda boczne
abdomen	brzuch
postgraduate medical education centre	centrum medycznego kształcenia podyplomowego
C-section	cesarskie cięcie
Caesarean section	cesarskie cięcie
catheter	cewnik
catheterization	cewnikowanie
surgery of the stomach and intestines	chirurgia żołądka i jelit
one day surgery	chirurgia jednego dnia
vascular surgery	chirurgia naczyniowa
general surgery	chirurgia ogólna
clinical surgery	chirurgia polikliniczna
maxillary surgery	chirurgia szczękowa
maxillofacial surgery	chirurgia szczękowa
trauma and orthopedic surgery	chirurgia urazowo-ortopedyczna
chronic illness	choroba przewlekła
internal illness	choroba wewnętrzna
infectious disease	choroba zakaźna
pregnancy	ciąża
blood pressure	ciśnienie tętnicze
blood pressure	ciśnienie tętnicze
specific gravity	ciężar właściwy
C-section	cięcie cesarskie
Caesarean section	cięcie cesarskie
total CK	CK całkowita
Postgraduate Medical Education Centre	CMKP
BP	CTK
respiratory rate	częstość oddechów
heart action	czynność serca
heart activity	czynność serca
vital functions	czynności życiowe
date of registration	data rejestracji
date of appointment	data wizyty
dosage	dawkowanie
defibrillation	defibrylacja
spinal board	deska ortopedyczna
medical imaging	diagnostyka obrazowa
hemodialysis	dializa pozaustrojowa
intravenous	dożylny
lower pole	dolny biegun
dopmaine	dopamina
convulsions	drgawki
way of administration	droga podania
shortness of breath	duszność
DWI [Diffusion-Weighted Imaging]	DWI
CEO	dyrektor naczelny
ECG, EKG	EKG
medical history report	epikryza
erythrocytes	erytrocyty
fresh erythrocytes	erytrocyty świeże
FFP [fresh frozen plasma]	FFP
FLAIR [Long Tau IR]	FLAIR
FRFSE [Fast Recovery FSE]	FRFSE
FSE [Fast Spin Echo]	FSE
whirrs	furczenie
doctor's office	gabinet lekarski
GCS [Glasgow Coma Scale]	GCS
glucose	glukoza
lower leg	goleń
HCT [hematocrit]	HCT
HGB [hemoglobin]	HGB
medical history	historia choroby
upper respiratory tract infection	i.g.d.o.
upper respiratory tract infection	infekcja górnych dróg oddechowych
intensive care	intensywna terapia
intubation	intubacja
admissions	IP
admissions	izba przyjęć
abdominal cavity	jama brzuszna
referring unit	jednostka kierująca
cardoversion	kardiowersja
discharge summary	karta informacyjna
hospital discharge summary report	karta informacyjna leczenia szpitalnego
hospital discharge summary report	karta informacyjna z leczenia szpitalnego
emergency medical services form	karta medycznych czynności ratunkowych
statistical record	karta statystyczna
ambulatory medical record	karta wizyty ambulatoryjnej
statement of death	karta zgonu
ketones	ketony
head	kierownik
RPBCs [packed red blood cells]	KKCZ
platelet concentrate	KKP
chest	klatka piersiowa
intensive care clinic	klinika intensywnej terapii
collar	kołnierz
cervical collar	kołnierz szyjny
lower limb	kończyna dolna
upper limb	kończyna górna
humerus	kość ramieniowa
proximal dones	kości proksymalne
Health Ministry code	kod resortowy
ehmoidal air cells	komórki sitowe
packed red blood cells	koncentrat krwinek czerwonych
hematological consulation	konsultacja hematologiczna
medical consultation	konsultacja lekarska
specialist advice	konsultacja specjalistyczna
contrast	kontrast
contrast agent	kontrast
checkup	kontrola
orthopedic checkup	kontrola ortopedyczna
cervical spine	kręgosłup szyjny
creatinine	kreatynina
bleeding	krwawienie
hematoma	krwiak
parenchymal hematoma	krwiak śródmiąższowy
wound bleeding	krwotok z rany
main hospital record	ks. gł.
reg. no.	ks. rej.
civil registry books	księgi stanu cywilnego
elbow crutches	kule łokciowe
main hospital record number	l. ks. gł.
postoperative analgesia	leczenie bólu pooperacyjnego
pharmacological treatment	leczenie farmakologiczne
treatment with fluids	leczenie płynami
postoperative analgesia	leczenie przeciwbólowe pooperacyjne
conservative treatment	leczenie zachowawcze
hospital services	lecznictwo szpitalne
treated surgically	leczony operacyjnie
M.D.	lek. med.
duty doctor	lekarz dyżurny
referring physician	lekarz kierujący
general practitioner	lekarz medycyny rodzinnej
attending physician	lekarz prowadzący
medical specialist	lekarz specjalista
house officer (UK)	lekarz stażysta
intern (US)	lekarz stażysta
discharging doctor	lekarz wypisujący
leucocytes	leukocyty
central venous access device placement	linia żylna centralna
peripheral venous access device placement	linia żylna obwodowa
LYMPH [lymphocytes]	LYMPH
thrombocytopenia	małopłytkowość
vascular malformation	malformacja naczyniowa
cardiac massage	masaż serca
cardiac massage	masaż serca
vacuum mattress	materac próżniowy
medical materials	materiały medyczne
non-active medical devices	materiały medyczne
MCH [mean corpuscular hemoglobin]	MCH
MCHC [mean corpuscular hemoglobin concentration]	MCHC
MCV [mean corpuscular volume]	MCV
metal fusion	metalowe zespolenie
chamber method	metoda komorowa
regular heart action	miarowa czynność serca
rhythmic heart activity	miarowa czynność serca
pelvis	miednica
atrial fibrillation	migotanie przedsionków
monitoring	monitorowanie
morphology	morfologia
blood cell morphology	morfologia krwi
MPV [mean platelet volume]	MPV
MXD% [mixed cell count]	MXD
polygonal epithelial cells	nabłonki wielokątne
coating	nalot
tentorium cerebelli	namiot móżdżku
intensification of symptoms	nasilenie dolegliwości
putting back	nastawienie
neurosurgery	neurochirugia
NEUT [neutrophils]	NEUT
National Health Fund	NFZ
hypoacusis	nieżyt trąbek słuchowych
paresis	niedowład
occluded	niedrożny
nonsuppurative otitis media	nieropne zapalenie ucha środkowego
circulatory collapse	niewydolność krążeniowa
circulatory failure	niewydolność krążeniowa
kidney failure	niewydolność nerek
renal failure	niewydolność nerek
respiratory failure	niewydolność oddechowa
lung failure	niewydolność płuc
heart failure	niewydolność serca
NIP [Tax No.]	NIP
non-steroidal anti-inflammatory drugs	NLPZ
hospital record/ward case book no.	nr ks. gł./oddz.
record no.	numer karty
cardiac arrest	NZK
symptoms	objawy
meningism	objawy oponowe
peritoneal signs	objawy otrzewnowe
specialist medical treatment coverage	objęcie leczeniem specjalistycznym
injury	obrażenie
T1-weighted image	obraz T1-zależny
edema	obrzęk
swelling	obrzęk
hypodense area	obszar hypodensyjny
ischemic area	obszar niedokrwienny
peripheral lymph nodes	obwodowe węzły chłonne
pysho-motoric evaluation	ocena psycho-ruchowa
parenteral nutrition	odżywianie pozajelitowe
department	oddział
unit	oddział
short copy	odpis skrócony
withdrawal from medical rescue actions	odstąpienie od medycznych czynność ratunkowych
suction	odsysanie
hyperdense focus	ognisko hyperdensyjne
focal neurological symptoms	ogniskowe objawy neurologiczne
perinatal period	okres okołoporodowy
burn	oparzenie
inhalation burn	oparzenie wziewne
dressing	opatrunek
outpatient care	opieka ambulatoryjna
nursing care	opieka pielęgniarska
chief of the unit	ordynator oddziału
urine sediment	osad moczu
plasma	osocze
ACS [acute coronary syndromes]	OZW
P-LCR [platelet larger cell ratio]	P-LCR
paramagnetic contrast agent	paramagnetyczny środek kontrastowy
hyperdense strand	pasmo hyperdensyjne
cerebral hemisphere	półkula mózgu
coronal plane	płaszczyzna czołowa
transverse plane	płaszczyzna poprzeczna
sagittal plane	płaszczyzna strzałkowa
frontal lobe	płat czołowy
temporal lobe	płat skroniowy
fluid	płyn
body fluid	płyn ustrojowy
platelets	płytki krwi
PDW [platelet distribution width]	PDW
PEA [pulseless electrical activity]	PEA
peristalsis	perystaltyka
PESEL [Personal ID No.]	PESEL
PKWiU [Classification of Products and Services]	PKWiU
PLT [platelets]	PLT
collecting samples	pobranie materiału
collecting samples for testing	pobranie materiału do badań
lower abdomen	pobrzusze
administration	podanie
ecchymosis	podbiegnięcie krwawe
suspicion	podejrzenie
impaired hearing	pogorszenie słuchu
emergency ambulance service	pogotowie ratunkowe
frontoparietal border	pogranicze czołowo-ciemieniowe
polyclinic	poliklinika
paralysis	porażenie
medical advice	porada
outpatient advice	porada ambulatoryjna
medical advice	porada lekarska
specialist advice	porada specjalistyczna
clinic	poradnia
neurological clinic	poradnia neurologiczna
specialty care clinic	poradnia specjalistyczna
trauma and orthopedic clinic	poradnia urazowo-ortopedyczna
labor	poród
patient care	postępowanie z pacjentem
dilated	poszerzony
post-trauma subarachmoid hemorrhage	pourazowy krwotok podpajęczynówkowy
laboratory	pracownia
specialty training	praktyka specjalizacyjna
lump-sum product	produkt ryczałtowy
vascular prosthesis	proteza naczyniowa
conduct specialty trainings	prowadzić specjalizację
course of illness	przebieg choroby
hospitalized	przebywał w oddziale
contraindicated	przeciwwskazany
nasal septum	przegroda nosowa
patient handover	przekazanie pacjenta
displacement	przemieszczenie
subarachnoid spaces	przestrzenie podpajęczynówkowe
pericerebral spaces	przestrzenie przymózgowe
transfusion	przetaczanie
immediate cause	przyczyna bezpośrednia
underlying cause	przyczyna pierwotna
secondary cause	przyczyna wtórna
underlying cause	przyczyna wyjściowa
external cause	przyczyna zewnętrzna
admission	przyjęcie
admitted	przyjęty
obstruction of the ear	przytkanie ucha
surgical radiology	radiologia zabiegowa
temporal horn	róg skroniowy
RBC [red blood cells]	RBC
RDW-SD [red cell distribution width – standard deviation]	RDW-SD
spinal cord	rdzeń kręgowy
motor response	reakcja ruchowa
verbal response	reakcja słowna
prescription	recepta
REGON [Registry of National Economy]	REGON
medical ventilator	respirator
respirator	respirator
resuscitation	resuscytacja
cortical grooves	rowki korowe
cerebral sulci	rowki mózgowe
diagnosis	rozpoznanie
organic solvent	rozpuszczalnik organiczny
pacemaker	rozrusznik
prescription	Rp
RR [blood pressure]	RR
systolic pressure	RR skurczowe
RTS [Revised Trauma Score]	RTS
erythema	rumień
endotracheal tube	rurka intubacyjna
oropharyngeal tube	rurka UG
sinus rhythm	rytm zatokowy
death rattle	rzężenie
operating room	sala operacyjna
recovery room	sala pooperacyjna
independent public health care institution	samodzielny publiczny zakład opieki zdrowotnej
independent public health care unit	samodzielny publiczny zakład opieki zdrowotnej
autopsy	sekcja zwłok
secretary's office	sekretariat
unit reception desk	sekretariat oddziału
cyanosis	sinica
central cyanosis	sinica centralna
peripheral cyanosis	sinica obwodowa
referral	skierowanie
referral	skierowanie
specialty care referral form	skierowanie do poradni specjalistycznej
convexity	sklepitość
cervical and thoracic spine sprain	skręcenie kręgosłupa szyjnego i piersiowego
deviation	skrzywienie
gastric tube	sonda żołądkowa
hospital emergency department	SOR
independent public health care institution	SP ZOZ
independent public health care unit	SP ZOZ
general practitioner	specjalista medycyny rodzinnej
specialty	specjalizacja
specialty examination	specjalizacja
specialty training	specjalizacja
first degree specialty	specjalizacja I stopnia
second degree specialty	specjalizacja II stopnia
state of consciousness	stan świadomości
low-grade fever	stan podgorączkowy
bruise	stłuczenie
head trauma	stłuczenie głowy
brain contusion	stłuczenie mózgu
pulmonary contusion	stłuczenie płuc
muffled heart sounds	stłumione tony serca
brain structures	struktury mózgowia
declaration of death	stwierdzenie zgonu
pronouncing of death	stwierdzenie zgonu
external stimulation	stymulacja zewnętrzna
university hospital	SU
sVES [supraventricular extrasystole]	sVES
SWW [Systematic Nomenclature of Goods]	SWW
murmur	szmer
correct vesicular breath sounds	szmer oddechowy pęcherzykowy
correct vesicular murmur	szmer oddechowy pęcherzykowy
currect murmur	szmer prawidłowy
clinical hospital	szpital kliniczny
country hospital	szpital powiatowy
district hospital	szpital powiatowy
university hospital	szpital uniwersytecki
hospital complex	szpital zespolony
hospital emergency department	szpitalny oddział ratunkowy
artificial ventilation	sztuczna wentylacja
coated tablets	tabletki powlekane
ventricular tachycardia	tachykardia komorowa
supraventricular tachycardia	tachykardia nadkomorowa
pulse	tętno
teletransmission	teletransmisja
CT scan	TK
passive oxygen therapy	tlenoterapia bierna
CT scan without contrast	tomografia bez kontrastu
plain CT scan	tomografia przeglądowa
heart sounds	tony serca
Eustachian tube	trąbka słuchowa
troponin	troponina
atrial flutter	trzepotanie przedsionków
crepitation	trzeszczenie
negative	ujemny
ventricular system	układ komorowy
respiratory system	układ oddechowy
ultrasound scanner	ultrasonograf
immobilization	unieruchomienie
authorized entity	upoważniony podmiot
trauma	uraz
concussion	uraz czaszkowo-mózgowy
cervical spine injury	uraz kręgosłupa szyjnego
multi-organ injury	uraz wielonarządowy
urobilinogen	urobilinogen
civil registry office	urząd stanu cywilnego
ultrasonography	USG
vascular damage	uszkodzenie naczyń
internal organs damage	uszkodzenie narządów wewnętrznych
nerve damage	uszkodzenie nerwów
VES [ventricular extrasystole]	VES
VF/VT [ventricular fibrillation / ventricular tachycardia]	VF/VT
in good condition	w stanie dobrym
morphology	wartości morfotyczne krwi
lymph nodes	węzły chłonne
WBC [white blood cells]	WBC
retracted membrane	wciągnięta błona
ventilation	wentylacja
bag-mask-ventilation	wentylacja workiem
intravenous therapy	wlew kroplowy
military clinical hospital with polyclinic	wojskowy szpital kliniczny z polikliniką
coagulation indicators	wskaźniki krzepnięcia
support of vital functions	wspomaganie czynności życiowych
shock	wstrząs
traumatic shock	wstrząs urazowy
cardiovascularly and respiratorily stable	wydolny oddechowo i krążeniowo
emergency response	wyjazd
vomiting	wymioty
acute blood	wynaczyniona krew
discharge	wypisywać do domu
medical supplies	wyroby medyczne
medical history	wywiad
pathological enhancement	wzmocnienie patologiczne
jaundice	zażółcenie
medical certificate	zaświadczenie lekarskie
surgery	zabieg
surgical procedure	zabieg
surgery	zabieg operacyjny
surgical procedure	zabieg operacyjny
planned surgical procedure	zabieg planowany
reddened throat	zaczerwienione gardło
health care institution	zakład opieki zdrowotnej
health care unit	zakład opieki zdrowotnej
recommendations	zalecenia
mouth odor	zapach z ust
otitis media	zapalenie ucha środkowego
otitis	zapalenie uszu
syncope	zasłabnięcie
administered drugs	zastosowane leki
clogged ears	zatkane uszy
frontal sinuses	zatoki czołowe
sphenoidal sinuses	zatoki klinowe
maxillary sinuses	zatoki szczękowe
cardiac arrest	zatrzymanie krążenia
infarction	zawał
limb fracture	złamanie kończyny
compound fracture	złamanie otwarte
simple fracture	złamanie zamknięte
fractured ribs	złamianie żeber
trimalleolar fracture	złamianie trójkostkowe
Moschcowitz syndrome	zespół Moskowitza
emergency response team	zespół ratownictwa medycznego
thickening	zgrubienie
emergency response order	zlecenie wyjazdu
crush	zmiażdżenie
ischemic charge	zmiana niedokrwienna
hemorrhagic changes	zmiany krwotoczne
pathology	zmiany patologiczne
anesthesia	znieczulenie
regional anesthesia	znieczulenie miejscowe
general anesthesia	znieczulenie ogólne
volatile induction and maintenance anesthesia	znieczulenie ogólne indukowane wziewne
regional anesthesia	znieczulenie przewodowe
regional anesthesia	znieczulenie regionalne
inhalation anesthesia	znieczulenie wziewne
volatile induction and maintenance anesthesia	znieczulenie wziewne
health care institution	ZOZ
health care unit	ZOZ
emergency response team	ZRM
ZUS [Social Insurance Institution]	ZUS
dislocation	zwichnięcie
abdomen	brzuch
abdominal cavity	jama brzuszna
ACS [acute coronary syndromes]	OZW
acute blood	wynaczyniona krew
additional examinations	badania dodatkowe
administered drugs	zastosowane leki
administration	podanie
admission	przyjęcie
admissions	IP
admissions	izba przyjęć
admitted	przyjęty
ambulatory medical record	karta wizyty ambulatoryjnej
anesthesia	znieczulenie
angio-CT	angio-TK
aphasia	afazja
apnea	bezdech
article ... section ... item ...	art. ... ust. ... pkt. ...
artificial ventilation	sztuczna wentylacja
asystole	asystolia
atrial fibrillation	migotanie przedsionków
atrial flutter	trzepotanie przedsionków
atropine	atropina
attending physician	lekarz prowadzący
authorized entity	upoważniony podmiot
autopsy	sekcja zwłok
AV [atrioventricular] block	AV blok
bag-mask-ventilation	wentylacja workiem
bilirubin	bilirubina
bleeding	krwawienie
blood cell morphology	morfologia krwi
blood pressure	ciśnienie tętnicze
blood pressure	ciśnienie tętnicze
body fluid	płyn ustrojowy
BP	CTK
brain contusion	stłuczenie mózgu
brain structures	struktury mózgowia
bruise	stłuczenie
burn	oparzenie
C-section	cesarskie cięcie
C-section	cięcie cesarskie
Caesarean section	cesarskie cięcie
Caesarean section	cięcie cesarskie
cardiac arrest	NZK
cardiac arrest	zatrzymanie krążenia
cardiac massage	masaż serca
cardiac massage	masaż serca
cardiovascularly and respiratorily stable	wydolny oddechowo i krążeniowo
cardoversion	kardiowersja
catheter	cewnik
catheterization	cewnikowanie
central cyanosis	sinica centralna
central venous access device placement	linia żylna centralna
CEO	dyrektor naczelny
cerebral hemisphere	półkula mózgu
cerebral sulci	rowki mózgowe
cervical and thoracic spine sprain	skręcenie kręgosłupa szyjnego i piersiowego
cervical collar	kołnierz szyjny
cervical spine	kręgosłup szyjny
cervical spine injury	uraz kręgosłupa szyjnego
chamber method	metoda komorowa
checkup	kontrola
chest	klatka piersiowa
chief of the unit	ordynator oddziału
chronic illness	choroba przewlekła
circulatory collapse	niewydolność krążeniowa
circulatory failure	niewydolność krążeniowa
civil registry books	księgi stanu cywilnego
civil registry office	urząd stanu cywilnego
clinic	poradnia
clinical hospital	szpital kliniczny
clinical surgery	chirurgia polikliniczna
clogged ears	zatkane uszy
coagulation indicators	wskaźniki krzepnięcia
coated tablets	tabletki powlekane
coating	nalot
collar	kołnierz
collecting samples	pobranie materiału
collecting samples for testing	pobranie materiału do badań
compound fracture	złamanie otwarte
concussion	uraz czaszkowo-mózgowy
conduct specialty trainings	prowadzić specjalizację
conservative treatment	leczenie zachowawcze
contraindicated	przeciwwskazany
contrast	kontrast
contrast agent	kontrast
control examination	badanie kontrolne
convexity	sklepitość
convulsions	drgawki
coronal plane	płaszczyzna czołowa
correct vesicular breath sounds	szmer oddechowy pęcherzykowy
correct vesicular murmur	szmer oddechowy pęcherzykowy
cortical grooves	rowki korowe
country hospital	szpital powiatowy
course of illness	przebieg choroby
creatinine	kreatynina
crepitation	trzeszczenie
crush	zmiażdżenie
CT scan	TK
CT scan without contrast	tomografia bez kontrastu
currect murmur	szmer prawidłowy
cyanosis	sinica
date of appointment	data wizyty
date of registration	data rejestracji
death cerificate	akt zgonu
death rattle	rzężenie
declaration of death	stwierdzenie zgonu
defibrillation	defibrylacja
department	oddział
deviation	skrzywienie
diagnosis	rozpoznanie
diagnostic examinations	badania diagnostyczne
diarrhea	biegunka
digital imaging examinations	badania diagnostyki obrazowej
dilated	poszerzony
discharge	wypisywać do domu
discharge summary	karta informacyjna
discharging doctor	lekarz wypisujący
dislocation	zwichnięcie
displacement	przemieszczenie
district hospital	szpital powiatowy
doctor's office	gabinet lekarski
dopmaine	dopamina
dosage	dawkowanie
dressing	opatrunek
duty doctor	lekarz dyżurny
DWI [Diffusion-Weighted Imaging]	DWI
ecchymosis	podbiegnięcie krwawe
ECG, EKG	EKG
edema	obrzęk
ehmoidal air cells	komórki sitowe
elbow crutches	kule łokciowe
emergency ambulance service	pogotowie ratunkowe
emergency medical services form	karta medycznych czynności ratunkowych
emergency response	wyjazd
emergency response order	zlecenie wyjazdu
emergency response team	ZRM
emergency response team	zespół ratownictwa medycznego
endotracheal tube	rurka intubacyjna
erythema	rumień
erythrocytes	erytrocyty
Eustachian tube	trąbka słuchowa
external cause	przyczyna zewnętrzna
external stimulation	stymulacja zewnętrzna
FFP [fresh frozen plasma]	FFP
first degree specialty	specjalizacja I stopnia
FLAIR [Long Tau IR]	FLAIR
fluid	płyn
focal neurological symptoms	ogniskowe objawy neurologiczne
fractured ribs	złamianie żeber
fresh erythrocytes	erytrocyty świeże
FRFSE [Fast Recovery FSE]	FRFSE
frontal lobe	płat czołowy
frontal sinuses	zatoki czołowe
frontoparietal border	pogranicze czołowo-ciemieniowe
FSE [Fast Spin Echo]	FSE
gastric tube	sonda żołądkowa
GCS [Glasgow Coma Scale]	GCS
general anesthesia	znieczulenie ogólne
general practitioner	lekarz medycyny rodzinnej
general practitioner	specjalista medycyny rodzinnej
general surgery	chirurgia ogólna
general urinalysis	badanie ogólne moczu
glucose	glukoza
HCT [hematocrit]	HCT
head	kierownik
head trauma	stłuczenie głowy
health care institution	ZOZ
health care institution	zakład opieki zdrowotnej
health care service	świadczenie zdrowotne
health care unit	ZOZ
health care unit	zakład opieki zdrowotnej
Health Ministry code	kod resortowy
heart action	czynność serca
heart activity	czynność serca
heart failure	niewydolność serca
heart sounds	tony serca
hematological consulation	konsultacja hematologiczna
hematoma	krwiak
hemodialysis	dializa pozaustrojowa
hemorrhagic changes	zmiany krwotoczne
HGB [hemoglobin]	HGB
hospital complex	szpital zespolony
hospital discharge summary report	karta informacyjna leczenia szpitalnego
hospital discharge summary report	karta informacyjna z leczenia szpitalnego
hospital emergency department	SOR
hospital emergency department	szpitalny oddział ratunkowy
hospital record/ward case book no.	nr ks. gł./oddz.
hospital services	lecznictwo szpitalne
hospitalized	przebywał w oddziale
house officer (UK)	lekarz stażysta
humerus	kość ramieniowa
hyperdense focus	ognisko hyperdensyjne
hyperdense strand	pasmo hyperdensyjne
hypoacusis	nieżyt trąbek słuchowych
hypodense area	obszar hypodensyjny
immediate cause	przyczyna bezpośrednia
immobilization	unieruchomienie
impaired hearing	pogorszenie słuchu
in good condition	w stanie dobrym
independent public health care institution	SP ZOZ
independent public health care institution	samodzielny publiczny zakład opieki zdrowotnej
independent public health care unit	SP ZOZ
independent public health care unit	samodzielny publiczny zakład opieki zdrowotnej
infarction	zawał
infectious disease	choroba zakaźna
inhalation anesthesia	znieczulenie wziewne
inhalation burn	oparzenie wziewne
injury	obrażenie
intensification of symptoms	nasilenie dolegliwości
intensive care	intensywna terapia
intensive care clinic	klinika intensywnej terapii
intern (US)	lekarz stażysta
internal illness	choroba wewnętrzna
internal organs damage	uszkodzenie narządów wewnętrznych
intracerebral	śródmózgowy
intravenous	dożylny
intravenous therapy	wlew kroplowy
intubation	intubacja
ischemic area	obszar niedokrwienny
ischemic charge	zmiana niedokrwienna
jaundice	zażółcenie
ketones	ketony
kidney failure	niewydolność nerek
labor	poród
laboratory	pracownia
laryngological examination	badanie laryngologiczne
leteral sulcus	bruzda boczne
leucocytes	leukocyty
limb amputation	amputacja kończyny
limb fracture	złamanie kończyny
low-grade fever	stan podgorączkowy
lower abdomen	pobrzusze
lower leg	goleń
lower limb	kończyna dolna
lower pole	dolny biegun
lump-sum product	produkt ryczałtowy
lung failure	niewydolność płuc
lymph nodes	węzły chłonne
LYMPH [lymphocytes]	LYMPH
M.D.	lek. med.
main hospital record	ks. gł.
main hospital record number	l. ks. gł.
maxillary sinuses	zatoki szczękowe
maxillary surgery	chirurgia szczękowa
maxillofacial surgery	chirurgia szczękowa
MCH [mean corpuscular hemoglobin]	MCH
MCHC [mean corpuscular hemoglobin concentration]	MCHC
MCV [mean corpuscular volume]	MCV
medical advice	porada
medical advice	porada lekarska
medical certificate	zaświadczenie lekarskie
medical consultation	konsultacja lekarska
medical history	historia choroby
medical history	wywiad
medical history report	epikryza
medical imaging	diagnostyka obrazowa
medical materials	materiały medyczne
medical specialist	lekarz specjalista
medical supplies	wyroby medyczne
medical ventilator	respirator
meningism	objawy oponowe
metal fusion	metalowe zespolenie
military clinical hospital with polyclinic	wojskowy szpital kliniczny z polikliniką
monitoring	monitorowanie
morphology	morfologia
morphology	wartości morfotyczne krwi
Moschcowitz syndrome	zespół Moskowitza
motor artifacts	artefakty ruchowe
motor response	reakcja ruchowa
mouth odor	zapach z ust
MPV [mean platelet volume]	MPV
MR examination	badanie MR
MRI examination	badanie MR
muffled heart sounds	stłumione tony serca
multi-organ injury	uraz wielonarządowy
murmur	szmer
MXD% [mixed cell count]	MXD
nasal septum	przegroda nosowa
National Health Fund	NFZ
negative	ujemny
nerve damage	uszkodzenie nerwów
neurological clinic	poradnia neurologiczna
neurosurgery	neurochirugia
NEUT [neutrophils]	NEUT
NIP [Tax No.]	NIP
nitrites	azotyny
non-active medical devices	materiały medyczne
non-injury pain	ból nieurazowy
non-steroidal anti-inflammatory drugs	NLPZ
nonsuppurative otitis media	nieropne zapalenie ucha środkowego
nursing care	opieka pielęgniarska
obstruction of the ear	przytkanie ucha
occluded	niedrożny
one day surgery	chirurgia jednego dnia
operating room	sala operacyjna
organic solvent	rozpuszczalnik organiczny
oropharyngeal tube	rurka UG
orthopedic checkup	kontrola ortopedyczna
otitis	zapalenie uszu
otitis media	zapalenie ucha środkowego
outpatient advice	porada ambulatoryjna
outpatient care	opieka ambulatoryjna
P-LCR [platelet larger cell ratio]	P-LCR
pacemaker	rozrusznik
packed red blood cells	koncentrat krwinek czerwonych
paralysis	porażenie
paramagnetic contrast agent	paramagnetyczny środek kontrastowy
parenchymal hematoma	krwiak śródmiąższowy
parenteral nutrition	odżywianie pozajelitowe
parenteral nutrition	żywienie pozajelitowe
paresis	niedowład
passive oxygen therapy	tlenoterapia bierna
pathological enhancement	wzmocnienie patologiczne
pathology	zmiany patologiczne
pathology tests	badania diagnostyki laboratoryjnej
patient	świadczeniobiorca
patient care	postępowanie z pacjentem
patient handover	przekazanie pacjenta
PDW [platelet distribution width]	PDW
PEA [pulseless electrical activity]	PEA
pelvis	miednica
pericerebral spaces	przestrzenie przymózgowe
perinatal period	okres okołoporodowy
peripheral cyanosis	sinica obwodowa
peripheral lymph nodes	obwodowe węzły chłonne
peripheral venous access device placement	linia żylna obwodowa
peristalsis	perystaltyka
peritoneal signs	objawy otrzewnowe
PESEL [Personal ID No.]	PESEL
pharmacological treatment	leczenie farmakologiczne
physical examination	badanie przedmiotowe
PKWiU [Classification of Products and Services]	PKWiU
plain CT scan	tomografia przeglądowa
planned surgical procedure	zabieg planowany
plasma	osocze
platelet concentrate	KKP
platelets	płytki krwi
PLT [platelets]	PLT
polyclinic	poliklinika
polygonal epithelial cells	nabłonki wielokątne
post-trauma subarachmoid hemorrhage	pourazowy krwotok podpajęczynówkowy
Postgraduate Medical Education Centre	CMKP
postgraduate medical education centre	centrum medycznego kształcenia podyplomowego
postoperative analgesia	leczenie bólu pooperacyjnego
postoperative analgesia	leczenie przeciwbólowe pooperacyjne
pregnancy	ciąża
prescription	Rp
prescription	recepta
pronouncing of death	stwierdzenie zgonu
protein	białko
proximal dones	kości proksymalne
pulmonary contusion	stłuczenie płuc
pulse	tętno
pupil	źrenica
putting back	nastawienie
pysho-motoric evaluation	ocena psycho-ruchowa
radiological examination	badanie radiologiczne
RBC [red blood cells]	RBC
RDW-SD [red cell distribution width – standard deviation]	RDW-SD
recommendations	zalecenia
record no.	numer karty
recovery room	sala pooperacyjna
reddened throat	zaczerwienione gardło
referral	skierowanie
referral	skierowanie
referring physician	lekarz kierujący
referring unit	jednostka kierująca
reg. no.	ks. rej.
regional anesthesia	znieczulenie miejscowe
regional anesthesia	znieczulenie przewodowe
regional anesthesia	znieczulenie regionalne
REGON [Registry of National Economy]	REGON
regular heart action	miarowa czynność serca
renal failure	niewydolność nerek
respirator	respirator
respiratory failure	niewydolność oddechowa
respiratory rate	częstość oddechów
respiratory system	układ oddechowy
resuscitation	resuscytacja
retracted membrane	wciągnięta błona
rhythmic heart activity	miarowa czynność serca
RPBCs [packed red blood cells]	KKCZ
RR [blood pressure]	RR
RTS [Revised Trauma Score]	RTS
sagittal plane	płaszczyzna strzałkowa
second degree specialty	specjalizacja II stopnia
secondary cause	przyczyna wtórna
secretary's office	sekretariat
service provider	świadczeniodawca
shock	wstrząs
short copy	odpis skrócony
shortness of breath	duszność
simple fracture	złamanie zamknięte
sinus rhythm	rytm zatokowy
specialist advice	konsultacja specjalistyczna
specialist advice	porada specjalistyczna
specialist medical treatment coverage	objęcie leczeniem specjalistycznym
specialty	specjalizacja
specialty care clinic	poradnia specjalistyczna
specialty care referral form	skierowanie do poradni specjalistycznej
specialty examination	specjalizacja
specialty training	praktyka specjalizacyjna
specialty training	specjalizacja
specific gravity	ciężar właściwy
sphenoidal sinuses	zatoki klinowe
spinal board	deska ortopedyczna
spinal cord	rdzeń kręgowy
state of consciousness	stan świadomości
statement of death	karta zgonu
statistical record	karta statystyczna
subarachnoid spaces	przestrzenie podpajęczynówkowe
suction	odsysanie
support of vital functions	wspomaganie czynności życiowych
supraventricular tachycardia	tachykardia nadkomorowa
surgery	zabieg
surgery	zabieg operacyjny
surgery of the stomach and intestines	chirurgia żołądka i jelit
surgical procedure	zabieg
surgical procedure	zabieg operacyjny
surgical radiology	radiologia zabiegowa
suspicion	podejrzenie
sVES [supraventricular extrasystole]	sVES
swelling	obrzęk
SWW [Systematic Nomenclature of Goods]	SWW
symptoms	objawy
syncope	zasłabnięcie
systolic pressure	RR skurczowe
T1-weighted image	obraz T1-zależny
teletransmission	teletransmisja
temporal horn	róg skroniowy
temporal lobe	płat skroniowy
tenderness to palpation	bolesność palpacyjna
tentorium cerebelli	namiot móżdżku
thickening	zgrubienie
thrombocytopenia	małopłytkowość
total CK	CK całkowita
transfusion	przetaczanie
transverse plane	płaszczyzna poprzeczna
trauma	uraz
trauma and orthopedic clinic	poradnia urazowo-ortopedyczna
trauma and orthopedic surgery	chirurgia urazowo-ortopedyczna
traumatic shock	wstrząs urazowy
treated surgically	leczony operacyjnie
treatment with fluids	leczenie płynami
trimalleolar fracture	złamianie trójkostkowe
troponin	troponina
tympanic membrane	błona bębenkowa
ultrasonography	USG
ultrasound scanner	ultrasonograf
underlying cause	przyczyna pierwotna
underlying cause	przyczyna wyjściowa
unit	oddział
unit reception desk	sekretariat oddziału
university hospital	SU
university hospital	szpital uniwersytecki
upper limb	kończyna górna
upper respiratory tract infection	i.g.d.o.
upper respiratory tract infection	infekcja górnych dróg oddechowych
urine sediment	osad moczu
urobilinogen	urobilinogen
vacuum mattress	materac próżniowy
vascular damage	uszkodzenie naczyń
vascular malformation	malformacja naczyniowa
vascular prosthesis	proteza naczyniowa
vascular surgery	chirurgia naczyniowa
ventilation	wentylacja
ventricular system	układ komorowy
ventricular tachycardia	tachykardia komorowa
verbal response	reakcja słowna
VES [ventricular extrasystole]	VES
VF/VT [ventricular fibrillation / ventricular tachycardia]	VF/VT
vital functions	czynności życiowe
volatile induction and maintenance anesthesia	znieczulenie ogólne indukowane wziewne
volatile induction and maintenance anesthesia	znieczulenie wziewne
vomiting	wymioty
way of administration	droga podania
WBC [white blood cells]	WBC
wheezes	świsty
whirrs	furczenie
withdrawal from medical rescue actions	odstąpienie od medycznych czynność ratunkowych
wound bleeding	krwotok z rany
ZUS [Social Insurance Institution]	ZUS
[paid at] 100% [no reimbursement]	100%
group for the regular medical check-up or follow-up groups	grupa dyspanseryna
abdominal surgery	zabieg chirurgiczny jamy brzusznej
Chromosomal abnormality, aberration	Aberracja chromosomowa
Abramson sump drain	dren odciekowy Abramsona
Acetonuria	Acetonuria
Achalasia of cardia	Achalazja wpustu
Achondroplasia	Achondroplazja
adapter	łącznik
Adenoviral encephalitis	Adenowirusowe zapalenie mózgu
Adenoviral meningitis	Adenowirusowe zapalenie opon mózgowych
adhesion formation	powstanie zrostów
aerate	poddać aeracji
aeration	aeracja
Aphasia	Afazja
Aphonia	Afonia (bezgłos)
Agenesis and underdevelopment of nose	Agenezja lub niedorozwój nosa
Renal agenesis, bilateral	Agenezja nerki, obustronna
Agnosia	Agnozja
Agoraphobia	Agorafobia
Agranulocytosis	Agranulocytoza
air vent lumen	kanał odpowietrzający
Acanthamebiasis	Akantameboza
Acromegaly	Akromegalia
Alexia	Aleksja
Allergic contact dermatitis	Alergiczne kontaktowe zapalenie skóry
Allescheriasis	Alleszerioza
Aminoglycosides	Aminoglikozydy
Branched-chain amino-acids	Aminokwasy rozgałęzione
Amnesia	Amnezja (niepamięć)
Dissociative amnesia	Amnezja dysocjacyjna
Anterograde amnesia	Amnezja następowa
Retrograde amnesia	Amnezja wsteczna
Amputation of the limb	Amputacja kończyny
Systemic amyloidosis	Amyloidoza narządowa
Anabolics	Anaboliki
Anagen effluvium	Anagenowe wypadanie włosów (anagen effluvium)
Androgens	Androgeny
Colonic angiodysplasia	Angiodysplazja jelita grubego
Baloon angioplasty	Angioplastyka balonowa
Intestinal angiostrongyliasis	Angiostrogyloza jelitowa
Anisakiasis	Anisakioza (anisakiasis)
Ancylostomiasis	Ankylostomoza (ancylostomiasis)
Mineralocorticoid antagonists (aldosterone antagonists)	Antagoniści mineralokortykosteroidów (antagoniści aldosteronu)
Histamine H2-receptor antagonists	Antagoniści receptorów histaminowych H2
Opioid receptor antagonists	Antagoniści receptorów opioidowych
anti-reflux chamber	komora przeciwzwrotna
anti-relfux valve	zawór przeciwzwrotny
Beta-lactam antibiotics	Antybiotyki beta-laktamowe
Antifungal antibiotics systemically used	Antybiotyki przeciwgrzybicze stosowane ogólnie
Systemic antibiotics	Antybiotyki stosowane ogólnie
Aorta	Aorta (tętnica główna)
Lacrimal apparatus	Aparat łzowy
Apathy	Apatia
Aplasia of testis, testicular aplasia	Aplazja jądra
applicator	aplikator
Apraxia	Apraksja
Approximation	Aproksymacja
Arenaviral hemorrhagic fevers	Arenowirusowe gorączki krwotoczne
Traumatic (arthropathy)	Artropatia (pourazowa)
Crystal arthropathies	Artropatie spowodowane odkładaniem kryształów
Asphyxia	Asfiksja (zamartwica)
Inhalation and ingestion of foreign body	Aspiracja i połknięcie ciała obcego
Aspiration of gastric contents	Aspiracja treści żołądkowej
Facial asymmetry	Asymetria twarzy
Early-onset cerebellar ataxia	Ataksja (bezład) móżdżkowa o wczesnym początku
Congenital nonprogressive ataxia	Ataksja (bezład) wrodzona niepostępująca
Hereditary ataxia	Ataksja (bezład) dziedziczna
Late-onset cerebellar ataxia	Ataksja (bezład) móżdżkowa o późnym początku
Cerebellar ataxia with defective DNA repair	Ataksja (bezład) móżdżkowa z wadliwym systemem naprawy DNA
Ataxic cerebral palsy	Ataktyczne porażenie mózgowe
Atopic dermatitis	Atopowe zapalenie skóry
Atypical bulimia nervosa	Atypowa bulimia (żarłoczność) psychiczna
Audiogram	Audiogram
Australian encephalitis	Australijskie zapalenie mózgu
Cutaneous autosensitization	Autoalergizacja skórna
Atypical autism	Autyzm atypowy
Childhood autism	Autyzm dziecięcy
Sexual aversion/lack of sexual enjoyment	Awersja seksualna/brak przyjemności seksualnej
Joint pain	Ból stawu
Atypical facial pain	Ból twarzy nietypowy
Chest pain on breathing	Ból w klatce piersiowej podczas oddychania
Adventitia	Błona zewnętrzna ściany naczynia (przydanka)
Exocervix	Błona zewnętrzna szyjki macicy
Pupillary membranes	Błony źreniczne
Leukonychia	Bielactwo paznokci
Bilirubin	Bilirubina
Biliuria	Biluria (obecność składników żółci w moczu)
Clicking hip	Biodro trzaskające
Pallor	Bladość
Complicated Plaque	Blaszka miażdżycowa powikłana
Advanced plaque	Blaszka miażdżycowa – zmiany zaawansowane
Pleural plaque	Blaszka opłucnej
Vertebral lamina	Blaszka łuku kręgu
Conjoined twins	Bliźnięta zrośnięte (tzw. zroślaki)
Keloid scar	Blizna keloidowa
Corneal scars and opacities	Blizny i przymglenia (zmętnienia) rogówki
Chorioretinal scars	Blizny naczyniówki i siatkówki
Conjunctival scars	Blizny spojówkowe
Right fascicular block	Blok prawej odnogi
Left anterior fascicular block	Blok przedniej gałęzi lewej odnogi
Atrioventricular block, second degree	Blok przedsionkowo-komorowy drugiego stopnia
Atrioventricular and left bundle-branch block	Blok przedsionkowo-komorowy i lewej odnogi pęczka Hisa
Atrioventricular block, first degree	Blok przedsionkowo-komorowy pierwszego stopnia
Atrioventricular block, complete	Blok przedsionkowo-komorowy zupełny
Trifascicular block	Blok trójgałęziowy
Left posterior fascicular block	Blok tylnej gałęzi lewej odnogi
Calcium-channel blockers	Blokery kanałów wapniowych
Scoliosis	Boczne skrzywienie kręgosłupa (tzw. skolioza)
Headache	Ból głowy
Limb pain	Ból kończyny
Lumbago	Ból ledźwiowo-krzyżowy
Acute pain	Ból ostry
Otalgia, ear pain	Ból ucha
Throat pain	Ból w gardle
Chest pain	Ból w klatce piersiowej
Abdominal and pelvic pain	Ból w okolicy brzucha i miednicy
Perineal pain	Ból w okolicy krocza
Precordial pain	Ból w okolicy przedsercowej
Dorsalgia	Bóle grzbietu
Cervicalgia	Bóle karku
Dysuria	Bolesne lub utrudnione oddawanie moczu (dyzuria)
Dysmenorrhea	Bolesne miesiączkowanie
Vesical tenesmus	Bolesne parcie na mocz
Dyspareunia	Bolesne współżycie płciowe (dyspaurenia)
Metatarsalgia	Bolesność śródstopia
Mastodynia	Bolesność sutka (mastodynia)
Priapism	Bolesny wzwód prącia (priapismus, priapizm)
Skin anesthesia	Brak czucia skórnego
Lack or loss of sexual desire	Brak lub utrata potrzeb seksualnych
Amenorrhea	Brak miesiączki
Anonychia	Brak paznokci
Agalactia	Brak pokarmu
Anhidrosis	Brak potu (anhydrosis)
Amyelia	Brak rdzenia
Failure of genital response	Brak reakcji płciowej
Absence of iris	Brak tęczówki
Achondrogenesis	Brak tkanki chrzęstnej (achondrogenezja)
Absence of eustachian tube	Brak trąbki Eustachiusza
Arhinencephaly	Brak węchomózgowia (zespół arinencephalii)
Anosmia	Brak węchu
Anodontia	Brak zębów
Nonunion of fracture (pseudarthrosis)	Brak zrostu po złamaniu (staw rzekomy)
Duodenal papilla, Ampulla of Vater	Brodawka dwunastnicza (brodawka większa, Vatera)
Nipple and areola	Brodawka i otoczka brodawki sutkowej
Seborrheic keratosis	Brodawka łojotokowa (rogowacenie łojotokowe, seborrheic keratosis)
Anogenital (venereal) warts	Brodawki okolicy odbytowej (płciowe) - kłykciny kończyste
Viral warts	Brodawki wirusowe
Brucellosis	Bruceloza
Brucellosis due to Brucella melitensis	Bruceloza wywołana pałeczką maltańską (Br. melitensis)
Brucellosis due to Brucella canis	Bruceloza wywołana pałeczką psią (Br. canis)
Brucellosis due to Brucella suis	Bruceloza wywołana pałeczką ronienia świń (Br. abortus var.suis)
Border of the tongue	Brzeg języka
Abdomen	Brzuch
Abdominal part of esophagus	Brzuszna część przełyku
Byssinosis	Bysynoza
Endometrium	Błona śluzowa macicy
Endocervix	Błona śluzowa szyjki macicy
Diphtheria	Błonica
Pharyngeal diphtheria	Błonica gardła
Laryngeal diphtheria	Błonica krtani
Nasopharyngeal diphtheria	Błonica nosowo-gardłowa
Cutaneous diphtheria	Błonica skóry
Standard error	Błąd standardowy
Total anomalous pulmonary venous connection	Całkowicie nieprawidłowe ujście żył płucnych
Pervasive developmental disorders	Całościowe zaburzenia rozwojowe
Total lung capacity (TLC)	Calkowita pojemność płuc
Total Intravenous Anesthesia (TIVA)	Całkowite ogólne znieczulenie dożylne
Sickle-cell trait	Cecha sierpowatokrwinkowości
Thalassemia trait	Cecha talasemii
Cefalosporins	Cefalosporyny
Central portion of the breast	Centralna część sutka
Central hemorrhagic necrosis of liver	Centralna krwotoczna martwica wątroby
Central corneal opacity	Centralne przymglenia rogówki
Urethra	Cewka moczowa
Urinary catheterization	Cewnikowanie dróg moczowych
Cardiac catheterization	Cewnikowanie serca
Paralytic gait	Chód paralityczny
Ataxic gait	Chód ataktyczny
Cholera	Cholera
Cholera due to Vibrio cholerae 01, biovar el tor	Cholera wywołana przecinkowcem Vibrio cholerae 01, biotyp El-Tor
Familial chondrocalcinosis	Chondrokalcynoza rodzinna
Chondrocalcinosis	Chondrokalcynozy
Chondrolysis	Chondroliza
Alzheimer's disease	Choroba Alzheimera
Alzheimer's disease with early onset	Choroba Alzheimera o wczesnym początku
Kissing spine	Choroba Baastrupa
Behcet's disease	Choroba Behceta
Chagas' disease	Choroba Chagasa
Creutzfeldt-Jakob disease	Choroba Creutzfeldta-Jacoba
Pituitary-dependent Cushing's disease	Choroba Cushinga pochodzenia przysadkowego
Radial styloid tenosynovitis (de Quervain)	Choroba de Quervaina
Ebstein's anomaly	Choroba Ebsteina
Hemolytic disease of fetus/newborn	Choroba hemolityczna płodu/noworodka
Hirschsprung's disease	Choroba Hirschprunga
Hodgkin's disease	Choroba Hodgkina
Huntington's disease	Choroba Huntingtona
Kienbock's disease of adults	Choroba Kienbocka dorosłych
Cat-scratch disease	Choroba kociego pazura
Hemorrhagic disease of newborn	Choroba krwotoczna płodu/noworodka
Legionnaires' disease	Choroba legionistów
Crohn's disease (regional enteritis)	Choroba Leśniowskiego-Crohna (odcinkowe zapalenie jelita)
Crohn's disease of large intestine	Choroba Leśniowskiego-Crohna jelita grubego
Meniere's disease	Choroba Meniere'a
Hypertensive renal disease	Choroba nadciśnieniowa z zajęciem nerek
Hypertensive heart disease	Choroba nadciśnieniowa z zajęciem serca
Flax-dresser's disease	Choroba obrabiających len
Paget's disease of bone (osteitis deformans)	Choroba Pageta (osteitis deformans)
Paget's disease of skull	Choroba Pageta dotycząca czaszki
Cannabinosis	Choroba palaczy haszyszu
Parkinson's disease	Choroba Parkinsona
GERD Gastroesophageal Reflux Disease	Choroba refluksowa przełyku (refluks żołądkowo-przełykowy)
Refsum's disease	Choroba Refsuma
Reiter's disease	Choroba Reitera
Rheumatic fever with heart involvement	Choroba reumatyczna z zajęciem serca
Rheumatic heart disease	Choroba reumatyczne serca
Atherosclerotic heart disease	Choroba serca w przebiegu miażdżycy
Sezary's disease	Choroba Sezary'ego
Glycogen storage disease	Choroba spichrzeniowa glikogenu
Still's disease	Choroba Stilla
Celiac disease	Choroba trzewna (celiakia)
Diverticular disease of intestine	Choroba uchyłkowa jelit
Von Willebrand's disease	Choroba von Willebranda
Endomyocardial (eosinophilic) disease	Choroba wsierdzia (eozynofilowa)
Chikungunya virus disease	Choroba wywołana przez wirus Chikungunya
Ebola virus disease	Choroba wywołana przez wirus Ebola
Marburg virus disease	Choroba wywołana przez wirus Marburg
Oropouche virus disease	Choroba wywołana przez wirus Oropouche
Rocio virus disease	Choroba wywołana przez wirus Rocio
Lyme disease	Choroba z Lyme
Arthrosis	Choroba zwyrodnieniowa stawów
Coxarthrosis (arthrosis of hip)	Choroba zwyrodnieniowa stawów biodowych (Koksartroza)
Gonarthrosis (arthrosis of knee)	Choroba zwyrodnieniowa stawów kolanowych (Gonartroza)
Disorders of cartilage	Choroby chrząstki
Demyelinating diseases	Choroby demielinizacyjne
Diseases of pharynx	Choroby gardła
Diseases of upper respiratory tract	Choroby górnych dróg oddechowych
Diseases of Bartholin's gland	Choroby gruczołu przedsionkowego większego (Bartholina)
Endocrine diseases	Choroby gruczołów dokrewnych/układu dokrewnego
Intestinal diseases	Choroby jelit
Bursopathies	Choroby kaletek maziowych
Bone disorders	Choroby kości
Spondylopathies	Choroby kręgosłupa
Diseases of the larynx	Choroby krtani
Diseases of blood and blood-forming organs	Choroby krwi i narządów krwiotwórczych
Diseases of pulp and periapical tissues	Choroby miazgi i tkanek okołowierzchołkowych
Follicular disorders	Choroby mieszka włosowego
Muscle disorders	Choroby mięśni
Cerebrovascular diseases	Choroby naczyń mózgowych
Peripheral vascular diseases	Choroby naczyń obwodowych
Diseases of pulmonary vessels	Choroby naczyń płucnych
Diseases of anus and rectum	Choroby odbytu i odbytnicy
Pleural conditions	Choroby opłucnej
Diseases of pericardium	Choroby osierdzia
Disorders of central nervous system	Choroby ośrodkowego układu nerwowego
Nail disorders	Choroby paznokci
Bullous disorders	Choroby pęcherzowe
Gallbladder diseases	Choroby pęcherzyka żółciowego
Alveolar and parietoalveolar conditions	Choroby pęcherzyków płucnych i tkanki okołopęcherzykowej
Sexually transmited diseases (STD)	Choroby przenoszone drogą płciową
Periodontal diseases	Choroby przyzębia
Diseases of the jaws	Choroby szczęk i żuchwy
Thyroid disorders	Choroby tarczycy
Diseases of hard tissues of teeth	Choroby tkanek twardych zębów
Interstitial pulmonary diseases	Choroby tkanki śródmiąższowej płuc
Respiratory disorders	Choroby układu oddechowego
Congenital diseases	Choroby wrodzone
Diseases of the appendix	Choroby wyrostka robaczkowego
Acariasis	Choroby wywołane przez roztocza (akariozy)
Spirochetal infections	Choroby wywołane przez krętki
Inflammatory disorders of scrotum	Choroby zapalne moszny
Inflammatory disorders of seminal vesicle	Choroby zapalne pęcherzyka nasiennego
Inflammatory disorders of penis	Choroby zapalne prącia
Disorders of diminished melanin formation	Choroby ze zmniejszonym tworzeniem melaniny
Diseases of lip and oral mucosa	Choroby śluzówki warg i jamy ustnej
Metabolic diseases	Choroby/zaburzenia przemiany materii
Chromomycosis	Chromomikoza
Cutaneous chromomycosis	Chromomikoza skórna
Cartilage	Chrząstka
Articular cartilage	Chrząstka stawowa
Laryngeal cartilages	Chrząstki krtani
Chyluria	Chyluria (chłonkomocz)
Lymphoepithelioid lymphoma	Chłoniak limfoepitelioidalny
Follicular non-Hodgkin's lymphoma	Chłoniak nieziarniczy guzkowy
Follicular (nodular) non-Hodgkin's lymphoma	Chłoniak nieziarniczy guzkowy (grudkowy)
T-zone lymphoma	Chłoniak strefy T
Atretic follicle	Ciałko (pęcherzyk) atretyczne
Ciliary body	Ciało rzęskowe
Twin pregnancy	Ciąża bliźniacza
Abdominal pregnancy	Ciąża brzuszna
Quadruplet pregnancy	Ciąża czworacza
Ovarian pregnancy	Ciąża jajnikowa
Tubal pregnancy	Ciąża jajowodowa
Multiple pregnancy	Ciąża mnoga
Ectopic pregnancy	Ciąża pozamaciczna
Prolonged pregnancy	Ciąża przenoszona
Triplet pregnancy	Ciąża trojacza
Wedge pressure	Ciśnienie zaklinowania
Extreme obesity with alveolar hypoventilation	Ciężka otyłość z hipowentylacją pęcherzykową
Severe combined immunodeficiency (SCID) with reticular dysgenesis	Ciężki złożony niedobór odporności (SCID) z dysgenezją siateczki
Isthmus uteri	Cieśń macicy
Constant Positive Airway Pressure (CPAP)	Ciągłe dodatnie ciśnienie w drogach oddechowych
Air pressure	Ciśnienie powietrza
Bromhidrosis	Cuchnący (złowonny) pot
Halitosis	Cuchnący oddech
Noninsulin-dependent diabetes mellitus (NIDM)	Cukrzyca insulinoniezależna
Insulin-dependent diabetes mellitus	Cukrzyca insulinozależna
Neonatal diabetes mellitus	Cukrzyca noworodków
Diabetes mellitus in pregnancy	Cukrzyca w ciąży
Malnutrition-related diabetes mellitus	Cukrzyca związana z niedożywieniem
Urea cycle	Cykl mocznikowy
Cyclothymia	Cyklotymia
Synovial cyst of popliteal space (Baker)	Cysta podkolanowa (torbiel Bakera)
Cytomegaloviral disease	Cytomegalia
Cytomegaloviral pneumonitis	Cytomegalowirusowe zapalenie płuc
Cytomegaloviral pancreatitis	Cytomegalowirusowe zapalenie trzustki
Cytomegaloviral hepatitis	Cytomegalowirusowe zapalenie wątroby
Melanoma in situ	Czerniak in situ
Polycythemia vera	Czerwienica prawdziwa
Ventricular tachycardia	Częstoskurcz komorowy
Supraventricular tachycardia	Częstoskurcz nadkomorowy
Paroxysmal tachycardia	Częstoskurcz napadowy
Tachycardia	Częstosturcz
Frequency	Częstotliwość
Cartilaginous portion of the Eustachian tube	Część chrzęstna trąbki słuchowej
Nasopharynx	Część nosowa gardła
Axillary tail of the breast	Część pachowa sutka
Oropharynx	Część ustna gardła
Endocrine pancreas	Część wewnątrzwydzielnicza trzustki
Pars flaccida	Część wiotka
Hiccough, Hiccups	Czkawka
Impacted cerumen	Czop woskowinowy
Tumor necrosis factor (TNF)	Czynnik martwicy nowotworu
Colony stimulating factor (CSF)	Czynnik stymulujący wzrost kolonii
Growth factor	Czynnik wzrostu (wzrostowy)
Hepatocyte growth factor (HGF)	Czynnik wzrostu hepatocytów
Functional residual capacity (FRC)	Czynnościowa pojemność zalegająca
Functional disorders of colon	Czynnościowe zaburzenia jelita grubego
Furuncle	Czyrak
Carbuncle	Czyrak gromadny
Far Eastern tick-borne encephalitis (Russian spring-summer encephalitis)	Dalekowschodnie zapalenie mózgu przenoszone przez kleszcze (rosyjskie wiosenno-letnie zapalenie mózgu)
Cellulocutaneous plague	Dżuma skóry i tkanki podskórnej
Deletion of short arm of the chromosome	Delecja krótkiego ramienia chromosomu
Deletions from the autosomes	Delecje autosomów
Deletions of part of a chromosome	Delecje części chromosomu
Postschizophrenic depression	Depresja poschizofreniczna
Depressive conduct disorder	Depresyjne zaburzenie zachowania
Subcorneal pustular dermatitis	Dermatitis subcornealis pustulosa
Deoxybarbiturates	Dezoksybarbiturany
Dialysis	Dializa
Dicroceliasis	Dikrocelioza (dicrocoeliasis)
Dipylidiasis	Dipylidoza
Gout	Dna moczanowa
Drug-induced gout	Dna moczanowa, polekowa
Floor of the mouth	Dno jamy ustnej
Fundus uteri	Dno macicy
Fundus of the stomach	Dno żołądka
Assistant professor (Reader - W. Bryt.)	Docent
Accessory nipple	Dodatkowa brodawka sutkowa
Accessory lobe of the lung	Dodatkowy płat płuca
Accessory thumb(s)	Dodatkowy(e) kciuk(i)
Accessory finger(s)	Dodatkowy(e) palec(ce) rąk
Accessory toe(s)	Dodatkowy(e) palec(ce) stóp
Finger domain	Domena palca peptydowego
Murine	Dot. gryzoni
double lumen	dwukanałowy
Oral contraceptives	Doustne środki antykoncepcyjne
Tonsillar fossa	Dół migdałkowy
Fossa ovalis	Dół owalny
Fovea centralis retinae	Dołek centralny siatkówki
Facet for tubercle of rib	Dołek żebrowy
drain adapter	przejściówka drenu
drainage bag	woreczek drenażowy
Dracunculiasis	Drakunkuloza (dracuculiasis)
Drug-induced tremor	Drżenie polekowe
Essential tremor	Drżenie samoistne
Irritability	Drażliwość
Dissociative convulsions	Drgawki dysocjacyjne
Febrile convulsions	Drgawki gorączkowe
Convulsions of newborn	Drgawki noworodka
drip irrigation	przepłukiwanie kroplówkowe
Blastomycosis	Drożdżyca (blastomykoza)
Lobomycosis	Drożdżyca Lobo (Lobomycosis)
Pulmonary blastomycosis	Drożdżyca płucna
Disseminated blastomycosis	Drożdżyca rozsiana
Cutaneous blastomycosis	Drożdżyca skórna
Patent ductus arteriosus	Drożny przewód tętniczy (Botalla)
Fasciculation	Drżenie pęczkowe mięśni
Macrostomia	Duża szpara ustna
Typhoid fever	Dur brzuszny
Spotted fever due to Rickettsia australis	Dur plamisty wywołany przez Rickettsia australis
Spotted fever due to Rickettsia siberica	Dur plamisty wywołany przez Rickettsia siberica
Paratyphoid fever	Dur rzekomy
Typhus fever	Dur wysypkowy
Epidemic louse-borne typhus fever due to Rickettsia prowazekii	Dur wysypkowy epidemiczny przenoszony przez wszy wywołany przez Rickettsia prowazekii
Recrudescent typhus (Brill's disease)	Dur wysypkowy nawrotowy (Choroba Brilla)
Typhus fever due to Rickettsia tsutsugamushi	Dur wysypkowy wywołany przez Rickettsia tsutsugamushi
Typhus fever due to Rickettsia typhi	Dur wysypkowy wywołany przez Rickettsia typhi
Spotted fevers	Dury plamiste
Angina pectoris	Dusznica bolesna
Unstable angina	Dusznica bolesna niestabilna
Dyspnea	Duszność
Macrocheilia	Duża warga
Double contrast X-Ray	Dwukontrastowe badanie RTG
Duodenum	Dwunastnica
Asthma	Dychawica (astma) oskrzelowa
Mixed asthma	Dychawica oskrzelowa mieszana
Nonallergic asthma	Dychawica oskrzelowa nieuczuleniowa
Diphyllobothriasis	Dyfilobotrioza
Dysarthria and anarthria	Dysartria i anartria
Familial dysautonomia (Riley-Day)	Dysautonomia rodzinna (Riley-Daya)
Dysphagia	Dysfagia
Sideropenic dysphagia	Dysfagia syderopeniczna
Dysphasia	Dysfazja
Dysphonia	Dysfonia
Segmental and somatic dysfunction	Dysfunkcja segmentarna i somatyczna
Sexual dysfunction	Dysfunkcja seksualna
Dyskinetic cerebral palsy	Dyskinetyczne porażenie mózgowe
Dyskinesia of esophagus	Dyskineza przełyku
Dyslexia	Dysleksja
Dissociative motor disorders	Dysocjacyjne zaburzenia ruchu
Nonorganic dyspareunia	Dyspareunia nieorganiczna
Dyspepsia	Dyspepsja
Dysplastic coxarthrosis	Dysplastyczne koksartrozy
Chondroectodermal dysplasia	Dysplazja chondro-ektodermalna
Ectodermal dysplasia (anhidrotic)	Dysplazja ektodermalna
Spondyloepiphyseal dysplasia	Dysplazja kręgowo-przynasadowa
Renal dysplasia	Dysplazja nerek
Metaphyseal dysplasia	Dysplazja przynasadowa
Vulvar dysplasia	Dysplazja sromu
Dysplasia of the cervix	Dysplazja szyjki macicy
Fibrous dysplasia (monostotic)	Dysplazja włóknista (pojedynczej kości)
Arterial fibromuscular dysplasia	Dysplazja włóknisto-mięśniowa tętnic
Dystonia	Dystonia
Idiopathic nonfamilial dystonia	Dystonia samoistna niedziedziczna
Idiopathic familial dystonia	Dystonia samoistna rodzinna
Drug-induced dystonia	Dystonia wywołana przez leki
Muscular dystrophy	Dystrofia mięśniowa
Nail dystrophy	Dystrofia paznokcia
Dysthymia	Dystymia
Dysmorphism due to warfarin	Dyzmorfia spowodowana warfaryną
Craniofacial dysostosis	Dyzostoza czaszkowo-twarzowa
Oculomandibular dysostosis	Dyzostoza oczno-żuchwowa
Mandibulofacial dysostosis	Dyzostoza żuchwowo-twarzowa
Upper gum	Dziąsło górne
Childhood disintegrative disorder	Dziecięce zaburzenia dezintegracyjne
Infantile cerebral palsy	Dziecięce porażenie mózgowe
Hereditary hypogammaglobulinemia	Dziedziczna hipogammaglobulinemia
Hereditary motor and sensory neuropathy	Dziedziczna neuropatia ruchowa i czuciowa
Hereditary sideroblastic anemia	Dziedziczna niedokrwistość syderoblastyczna
Hereditary spastic paraplegia	Dziedziczne kurczowe porażenie kończyn dolnych
Hereditary hemolytic anemias	Dziedziczne niedokrwistości hemolityczne
Inherited spinal muscular atrophy	Dziedziczne zaniki mięśni pochodzenia rdzeniowego
Hereditary choroidal dystrophy	Dziedziczne zwyrodnienia błony naczyniowej
Hereditary corneal dystrophies	Dziedziczne zwyrodnienia rogówki
Hereditary factor IX, VII, XI deficiency	Dziedziczny niedobór czynnika IX, VII, XI
Hereditary non-polyposis colorectal cancer	Dziedziczny rak jelita grubego bez polipowatości
Bizarre personal appearance	Dziwaczna powierzchowność
Strange and inexplicable behavior	Dziwne i niekreślone zachowania
Lower gum	Dziąsło dolne
Tinnitus	Dzwonienie (szum) w uszach
Dolichocephaly	Długogłowie (dolichocephalia)
Plague	Dżuma
Bubonic plague	Dżuma dymienicza
Septicemic plague	Dżuma posocznicowa
Pneumonic plague	Dżuma płucna
edge	krawędź
Teeth exfoliation	Eksfoliacja zębów
Exhibitionism	Ekshibicjonizm
Hereditary elliptocytosis	Eliptocytoza dziedziczna
Hypertensive encephalopathy	Encefalopatia nadciśnieniowa
Toxic encephalopathy	Encefalopatia toksyczna
Wernicke's encephalopathy	Encefalopatia Wernickiego
Enteroviral vesicular pharyngitis	Enterowirusowe pęcherzykowe zapalenie gardła
Enteroviral vesicular stomatitis with exanthem	Enterowirusowe pęcherzykowe zapalenie jamy ustnej z wypryskiem
Enteroviral encephalitis	Enterowirusowe zapalenie mózgu
Enteroviral meningitis	Enterowirusowe zapalenie opon mózgowych
Eosinophilia	Eozynofilia
Depressive episode	Epizod depresyjny
Manic episode	Epizod maniakalny
Familial erythrocytosis	Erytrocytoza rodzinna
Estrogens and progestogens	Estrogeny i środki o działaniu progesteronu
Eumycetoma	Eumycetoma
Fasciolopsiasis	Fasciolopsoza (fasciolopsidosis)
Fascioliasis	Fascioloza (fasciolosis)
Rugae	Fałdy żołądkowe
False-positive serological syphilism test	Fałszywie dodatni kiłowy test serologiczny
Phenylketonuria, classical	Fenyloketonuria klasyczna
Pheomycotic brain abscess	Feomykotyczny ropień mózgu
Fetishism	Fetyszyzm
Filariasis	Filarioza (filariasis)
Filariasis due to Brugia malayi	Filarioza wywołana przez Brugia malayi
Filariasis due to Brugia timori	Filarioza wywołana przez Brugia timori
Filariasis due to Wuchereria bancrofti	Filarioza wywołana przez Wuchereria bancrofti
Skeletal fluorosis	Fluoroza kośćca
Phobia	Fobia
Free fluid	wolny płyn
Dissociative fugue	Fuga dysocjacyjna
Galactose	Galaktoza
Monoclonal gammopathy	Gammopatia monoklonalna
Ganglion	Ganglion
Gangliosidosis	Gangliozydozy
Gangosa	Gangoza
Pharynx	Gardło
Sensorineural hearing loss	Głuchota czuciowo-nerwowa
Ototoxic hearing loss	Głuchota ototoksyczna
Genetic anomalies of leukocytes	Genetyczne nieprawidłowości leukocytów
Geotrichosis	Geotrychoza
Bone density	Gęstość kości
Giardiasis (lambliasis)	Giardiaza (lamblioza)
Pituitary gigantism	Gigantyzm przysadkowy
Glucocorticoids, glucocorticosteroids	Glikokortykosteroidy
Glycosuria	Glikozuria
Ascariasis	Glistnica (askaridoza)
Gnathostomiasis	Gnatostomoza (gnathostomatosis)
Skorbut	Gnilec (szkorbut)
Fever	Gorączka
Persistent fever	Gorączka ciągła
Dengue fever (classical dengue)	Gorączka denga (denga klasyczna)
Rift Valley fever	Gorączka Doliny Riftu
Colorado tick fever	Gorączka kleszczowa Colorado
Dengue hemorrhagic fever	Gorączka krwotoczna denga
Junin hemorrhagic fever	Gorączka krwotoczna Junin
Crimean-Congo hemorrhagic fever	Gorączka krwotoczna krymsko-kongijska
Machupo hemorrhagic fever	Gorączka krwotoczna Machupo
Omsk hemorrhagic fever	Gorączka krwotoczna omska
Arenaviral hemorrhagic fever	Gorączka krwotoczna wywołana przez arenawirusy
Hemorrhagic fever with renal syndrome	Gorączka krwotoczna z zespołem nerkowym
Lassa fever	Gorączka Lassa
Fever of unknown origin	Gorączka o nieznanej przyczynie
O'nyong-nyong fever	Gorączka o`nyong-nyong
Brazilian purpuric fever	Gorączka plamicowa brazylijska
Spotted fever due to Rickettsia conorii	Gorączka plamista wywołana przez Rickettsia conorii
Spotted fever due to Rickettsia rickettsii	Gorączka plamista wywołana przez Rickettsia rickettsii
Relapsing fevers	Gorączka powrotna (nawrotowa)
Tick-borne relapsing fever	Gorączka powrotna przenoszona przez kleszcze
Louse-borne relapsing fever	Gorączka powrotna przenoszona przez wszy
Q fever	Gorączka Q
Rat-bite fevers	Gorączka szczurza (choroba od ukąszenia przez szczura)
Trench fever	Gorączka wołyńska (okopowa)
Sandfly fever	Gorączka wywołana przez muchę piaskową Phlebotomus
Fever with chills	Gorączka z dreszczami
West Nile fever	Gorączka Zachodniego Nilu
Water-mineral balance	Gospodarka wodno-elektrolitowa
Chalazion	Gradówka
Thymus	Grasica
Staphylococcal pneumonia	Gronkowcowe zapalenie płuc
Staphylococcus aureus	Gronkowiec złocisty
Tuberculosis of skin and subcutaneous tissue	Gruźlica skóry i tkanki podskórnej
Tuberculous peripheral lymphadenopathy	Gruźlicza obwodowa limfadenopatia
Tuberculous meningitis	Gruźlicze zapalenie opon mózgowych
Fibroadenosis of breast	Gruczlokowłókniakowatość sutka
Bartholin's gland	Gruczoł przedsionkowy większy
Endometriosis of ovary	Gruczolistość jajnika
Endometriosis	Gruczolistość (endometrioza)
Endometriosis of fallopian tube	Gruczolistość jajowodu
Endometriosis of intestine	Gruczolistość jelita
Endometriosis of uterus	Gruczolistość macicy (endometriosis)
Endometriosis of pelvic peritoneum	Gruczolistość otrzewnej miednicy mniejszej
Endometriosis of rectovaginal septum	Gruczolistość przegrody odbytniczo-pochwowej
Endometriosis in cutaneous scar	Gruczolistość w bliźnie skórnej
Lacrimal gland and duct	Gruczoł i drogi łzowe
Prostate	Gruczoł krokowy (stercz, prostata)
Bulbouterthral gland	Gruczoł opuszkowo-cewkowy
Parathyroid gland	Gruczoł przytarczowy, przytarczyca
Accessory breast	Gruczoł sutkowy dodatkowy
Lacrimal gland	Gruczoł łzowy
Paraurethral glands	Gruczoły cewki moczowej
Salivary glands	Gruczoły ślinowe
Gottron's papules	Grudki Gottrona
Tuberculosis	Gruźlica
Tuberculosis of bones and joints	Gruźlica kości i stawów
Tuberculosis of the spine	Gruźlica kręgosłupa
Tuberculosis of adrenal glands	Gruźlica nadnerczy
Tuberculosis of eye	Gruźlica oka
Miliary tuberculosis	Gruźlica prosówkowa
Tuberculosis of ear	Gruźlica ucha
Tuberculosis of the genitourinary system	Gruźlica układu moczowo-płciowego
Tuberculosis of the nervous system	Gruźlica układu nerwowego
Meningeal tuberculoma	Gruźliczak oponowy
Urethral crest	Grzebień cewki moczowej
Tinea corporis	Grzybica ciała
Tinea nigra	Grzybica czarna (tinea nigra)
Tinea cruris	Grzybica goleni
Aspergillosis	Grzybica kropidlakowa (Aspergiloza)
Tonsillar aspergillosis	Grzybica kropidlakowa migdałków
Pulmonary aspergillosis	Grzybica kropidlakowa płuc
Disseminated aspergillosis	Grzybica kropidlakowa rozsiana
Actinomycetoma	Grzybica madurska promienicza
Tinea barbae and tinea capitis	Grzybica owłosionej skóry głowy i brody
Tinea unguium	Grzybica paznokci
Tinea manuum	Grzybica rąk
Tinea pedis	Grzybica stóp
Tinea imbricata	Grzybica łuskowata (tinea imbricata)
Dermatophytoses	Grzybice
Superficial mycoses	Grzybice powierzchowne
Dermatophytosis	Grzybice skóry (dermatofitozy)
Opportunistic mycoses	Grzybice tzw. oportunistyczne
Burkitt's tumor	Guz (chłoniak) Burkitta
Tumor of the spinal column	Guz nowotworowy kręgosłupa
Rheumatoid nodule	Guzek reumatoidalny
Nontoxic single thyroid nodule	Guzek tarczycy pojedynczy, nietoksyczny
Bouchard's nodes (with arthropathy)	Guzki Boucharda (z artropatią)
Heberden's nodes (with arthropathy)	Guzki Heberdena (z artropatią)
Hemorrhoids	Guzki krwawicze (krwawnice)
Knuckle pads	Guzki na knykciach palców ręki
Schmorl's nodes	Guzki Schmorla
Nodules of vocal cords	Guzki strun głosowych
Polyarteritis nodosa	Guzkowe zapalenie naczyń
Nodular fasciitis	Guzkowe zapalenie powięzi
Tumors of the spinal cord	Guzy rdzenia kręgowego
Malignant mast cell tumor	Guzy złośliwe z komórek tucznych
Head of malleus	Głowa młoteczka
Head of pancreas	Głowa trzustki
Glottis	Głośnia
Conductive hearing loss, bilateral	Głuchota przewodzeniowa obustronna
Presbycusis	Głuchota starcza
hernia	przepuklina
hub	kielich (np. drenu)
irrigation	irygacja, przepłukiwanie
irrigation bag	worek z płynem irygacyjnym
irrigation fluid	płyn irygacyjny
irrigation port	port irygacyjny
irrigation syringe	strzykawka do przepłukiwania
irrigation tubing	przewód irygacyjny
irrigator	irygator
jakość życia niezależna od stanu zdrowia	non health related quality of life
jakość życia zależna od stanu zdrowia	health related quality of life
lecturoscope	wziernik dodatkowy
muscular (septal) shelf	wystep/fald miesniowy (przegrody)
Needle Guide [name] Stereotactic Table 4.0mm	Prowadnica igły, fragment (wyposażenia) stołu stereotaktycznego
parvovirus	parwowirus
Philadelphia chromosome positive ALL	ostra białaczka limfatyczna z dodatnim chromosomem Philadelphia
pulse generator	stymulator
put into service	oddać do eksploatacji
reproductive history	wywiad położniczy
Rp.	Rp.
sizer	przymiar
water trap	skraplacz, pułapka wodna
Attention Deficit Hyperactivity Disorder(ADHD)	ADHD -  nadpobudliwosc psychomotoryczna (znaczna)
ALL , AML , CLL , CML : Four main types of leukaemia	ALL ,AML , CLL , CML : cztery glowne rodzaje bialaczek
Benign Prostatic Hyperplasia (BPH)	BPH -  przerost  gruczolu krokowego/prostata
blood   dyscrasia	zaburzenia  obrazu   krwi
calcium  score	wynik  testu  wapniowego
cartham  oil	olej z krokosza barwierskiego
Chronic Lymphocytic Leukaemia (CLL)	CLL -  Przewlekla Bialaczka Limfocytowa
CoDA - Co-dependents  anonymous	wspolnota  anonimowych  wspoluzaleznionych
DDDR , Affinity(R) DR	stymulator  serca (dwukomorowy)
DSA	digital Seldingers'  angiography , cyfrowa angiografia subtrakcyjna , angiografia metoda  Seldinger'a
GPA - gastro protective agents	leki  gastroprotekcyjne( leki oslonowe zoladka)
hypochromatic  anaemia	niedokrwistosc   niedobarwliwa
Multiple Myeloma (MM)	MM -  Szpiczak  Mnogi
MRI - Magnetic Resonance Imaging	Diagnostyka obrazkowa z zastosowaniem pola magnetycznego
needle	igla
Non-Hodgkin's  Lymphoma (NHL)	NHL -  Chloniak Nieziarniczy
pitting edema of the lower legs	obrzeki ciastowate podudzi
inflammatory reaction in adjacent diploe of both vertebrae	odczyn zapalny w przylegajacym srodkosciu obu kregow
PD  line.	Peritoneal Dialysis  Line - cewnik do  dializy  otrzewnowej.
percutaneously  or  via  cutdown  through  subclavian  vein	(wprowadzenie)przezskorne  lub  droga  kaniulacji(dotyczy : cewnikowania)  zyly  podobojczykowej
plaque  burden	stopien zwapnienia  tetnic  wiencowych
regular  sinus  rhytm / normal sinus rhytm	rytm  zatokowy  miarowy
SSIR , integrity(TM)SR	stymulator serca(jednokomorowy)
vena  contracta  6mm	talia niedomykalnosci  6mm
TENS-transcutaneous nerve stimulation	nieinwazyjna stymulacja nerwow
than the living will envy the dead	wtedy zywi beda zazdroscic umarlym
TMJD - temporomandibular  joints dysfunction	TMJD - szczekoscisk
Transurethral Incision of the Prostate (TUIP)	TUIP -  Przezcewkowe Naciecie Prostaty
Transurethral Resection of the Prostate (TURP)	TURP -  Przezcewkowe Usuniecie Prostaty
VDDR	stymulator serca (jednokomorowy)
nasal / inferior  colliculi  located in the midbrain	wzgorki  donosowe  srodmozgowia
solid  hypoechoic  lesions	zmiany  lite  hypoechogeniczne
inflamatory  infiltrates  consistent   with  bronchopneumonia	zmiany  zapalne  o  charakterze  odoskrzelowego  zapalenia  pluc
acid phosphatase	fosfataza kwaśna
adrenal cortex	kora nadnercza
adrenal gland	nadnercze
adrenall medulla	rdzeń nadnerczy
adrenocorticotropic hormone	hormon adrenokortykotropowy
afterimage	powidok
alkaline phosphatase	fosfataza zasadowa
ampules	ampułki
anatomopathologic diagnosis	rozpoznanie anatomopatologiczne
anti-fever medicine	lek przeciwgorączkowy
appendix	wyrostek
artery	tętnica
atrophy	zanik
atrophy of thymus	zanik grasicy
baseline values	wartości wyjściowe
basophilic	zasadowy
bladder	pęcherz
bleeding	krwawiący
bleeding disorder	zaburzenia krzepliwości
blood culture	posiew
blood pressure	ciśnienie krwi
blood smear	rozmaz
blood type	grupa krwi
blood vessel	naczynie krwionośne
bloodstream	krwioobieg
bowels	jelita
brain	mózg
broken	złamany
bruise	siniak, krwiak
burned	oparzony
capillary	włośniczka
cardiac output	pojemność minutowa serca
cast	gips
catheter	cewnik
closed brain injury	zamknięty uraz głowy
cold sore	opryszczka
congestive heart failure	niewydolność zastoinowa serca
corticoid	kortykoid
culture	posiew
cut	przecięty, skaleczony
dressing	opatrunek
ear nose and throat department	otolaryngologia
ear nose and throat specialist	otolaryngolog
emotional numbness	odrętwienie emocjonalne
end points	wartości końcowe
endoprosthesis	endoproteza
enrollment	włączanie do badania
ENT specialist	laryngolog
epidermis	naskórek
erythrocyte	krwinka czerwona, erytrocyt
ESB	patrz BSE
femur, thigh bone	kość udowa
fever	gorączka
free fatty acids	wolne kwasy tłuszczowe
full blood	pełna krew
full blown disease	choroba pełnoobjawowa
gauze	gaza
granulocyte	krwinka biała ziarnista, granulocyt
haematoma	krwiak
haemorrhage	krwotok
haemorrhagic diathesis	skaza krwotoczna
heart	serce
high blood pressure	wysokie ciśnienie
histopathologic diagnosis	rozpoznanie histopatologiczne
hit	uderzony
I.V.	wenflon, kroplówka
I.V. pole	stojak na kroplówkę
immobilizer	usztywniacz
in shock	w szoku
inflammation	zapalenie
injection	zastrzyk
intestines	jelita
intravenous drip	kroplówka
ischial nerve	nerw kulszowy
kidney	nerka
shin bone	kość podudzia
leukocyte	krwinka biała, leukocyt
liver	wątroba
lon-term care	opieka długoterminowa
lungs	płuca
lymphatic nodes	węzły chłonne
major depressive disorder	depresja duża
mastectomy	mastektomia
melasma	melanoderma
mens rea	zdolność rozpoznawania czynu
minute heart volume	pojemność minutowa serca
musculoskeletal diseases	choroby układu mięśniowo-szkieletowego
not breathing	nie oddychający
otorrhagia	krwotok z ucha
painkillers	leki przeciwbólowe
pharyngitis (inflammationof the throat)	zapalenie gardła
pharynx	gardło
philic	chłonny
pill	tabletka
pills	tabletki
placenta previa	łożysko przodujące
plasma	osocze
plaster	gips
platelet	płytka
preliminary diagnosis	rozpoznanie wstępne
psychological examination	badanie psychologiczne
psychosocial	psychospołeczny
randomisation	randomizacja
red blood cell	krwinka czerwona
retinitis pigmentosa	zwyrodnienie barwnikowe siatkówki
run-in phase	faza początkowa, faza wpowadzająca
screening	badania przesiewowe
screening period	okres przesiewowy
screening visit	badanie przesiewowe
secrete	wydzielać
sedatives	leki uspokajające
serum	surowica
shin	goleń
short-term study	krótkofalowe badanie
sirrup	syrop
slide	szkiełko podstawkowe
smashed	zmiażdżony
social situation	sytuacja społeczna
stazis	staza
stomach	żołądek
sty or stye	jęczmień, jęczmyk
syringe	strzykawka
county hospital, district hospital	szpital powiatowy
test articles	badany produkt
thymus	grasica
to cup sb	stawiać komuś bańki
to elutriate	uzyskiwać, oczyszczać za pomocą elutriacji
to have a fratured femur	mieć złamaną kość udową
to jave ones tonsils surgically removed	przejść zabieg usunięcia migdałków
tonsils	migdałki
tourniquet	opaska uciskowa
twisted	wykręcony, wykręcone
unconscious	nieprzytomny
vascular	naczyniowy
vein	żyła
verbal stimuli	bodźce słowne
white blood cell	krwinka biała
with no heart action	niewyczuwalna akcja serca
wound	rana
2,4,6-trinitrophenol, picric acid, carbazotic acid, nitroxanthic acid, peric acid	2,4,6-trinitrofenol, kwas pikrynowy
2,4,6-trinitroresorcinol, styphnic acid	2,4,6-trinitrorezorcyna, kwas styfninowy
acetamide	acetamid, amid kwasu octowego
acetonitrile, methyl cyanide	acetonitryl, nitryl kwasu octowego, cyjanek metylu
ethyl acetoacetate, acetoacetic ester	acetylooctan etylu, ester etylowy kwasu acetylooctowego
adiponitrile	adyponitryl, dinitryl kwasu adypinowego
acrylate, acrylic ester	akrylan, ester kwasu akrylowego
acrylamide	akryloamid, amid kwasu akrylowego
acrylonitrile, vinyl cyanide	akrylonitryl, nitryl kwasu akrylowego, cyjanek winylu
aldehyde acid	aldehydokwas
elaidamide	amid kwasu elaidynowego
erucamide	amid kwasu erukowego
crotonamide	amid kwasu krotonowego
lactamide	amid kwasu mlekowego
formamide, methanamide	amid kwasu mrówkowego, formamid
oxaluramide, oxalan	amid kwasu oksalurowego, oksalan
niacinamide, nicotinamide, nicotinic acid amide	amid niacyny, amid kwasu nikotynowego
amino acid	aminokwas
essential amino acid	aminokwas egzogenny, aminokwas podstawowy
phenyl formamide, formanilide	anilid kwasu mrówkowego, formanilid
azoimide	azydek wodoru, kwas azotowodorowy
resinate	żywiczan, sól kwasu żywicznego
acidulant	środek zakwaszający
antacid	środek zobojętniający kwasy
barbital, barbitone, diethylbarbituric acid, diethylmalonylurea	barbital, kwas dietylobarbiturowy, dietylomalonylomocznik
chrome dye	barwnik chromowy, barwnik kwasowo-chromowy
benzamide, benzoylamide	benzamid, amid kwasu benzoesowego
benzanilide, benzoylanilide	benzanilid, anilid kwasu benzoesowego
benzene sulfonyl chloride	benzenosulfochlorek, chlorek kwasu benzenosulfonowego
benzoylglycin, benzoylglycine, benzoylglycocoll, hippuric acid	benzoiloglicyna, kwas hipurowy
benzonitrile, phenyl cyanide	benzonitryl, nitryl kwasu benzoesowego
benzoic anhydride	bezwodnik kwasu benzoesowego
hexahydrophthalic anhydride, HHPA	bezwodnik kwasu heksawodoroftalowego
butyric anhydride	bezwodnik kwasu masłowego
benzene sulfonyl butylamide	butyloamid kwasu benzenosulfonowego
acetyl chloride	chlorek acetylu, chlorek kwasu octowego
acryloyl chloride	chlorek akryloilu, chlorek kwasu akrylowego
benzoyl chloride	chlorek benzoilu, chlorek kwasu benzoesowego
chloroacetyl chloride	chlorek chloroacetylu, chlorek kwasu chlorooctowego
acyl chloride	chlorek kwasu karboksylowego
sulfonyl chloride	chlorek kwasu sulfonowego, sulfochlorek
methacryloyl chloride	chlorek metakryloilu, chlorek kwasu metakrylowego
oxalyl chloride	chlorek oksalilu, chlorek kwasu szczawiowego
chlorobenzamide	chlorobenzamid, amid kwasu chlorobenzoesowego
benzyl cyanide	cyjanek benzylu, nitryl kwasu fenylooctowego
acetone cyanohydrin, acetone cyanhydrin	cyjanohydryna acetonu, nitryl kwasu dimetylohydroksyoctowego
acetaldehyde cyanohydrin, lactonitrile	cyjanohydryna aldehydu octowego, nitryl kwasu mlekowego
lipoamide dehydrogenase, diaphorase	dehydrogenaza amidu kwasu liponowego
adipamide	diamid kwasu adypinowego
succinamide	diamid kwasu bursztynowego, sukcynamid
malamide	diamid kwasu hydroksybutanodiowego, diamid kwasu jabłkowego
N,N-diethylnicotinamide, nikethamide	dietyloamid kwasu nikotynowego
dinitrosoterephthalamide	dinitrozoamid kwasu tereftalowego
2,2'-azobis(isobutyronitrile), AZBN	dinitryl kwasu azobis(2-metylopropanowego), 2,2'-azodiizobutyronitryl
dithio acid	ditiokwas
dithiooxamide, rubeanic acid	ditiooksamid, kwas rubeanowy
behenic acid ester	dokozanian, ester kwasu behenowego, behenian
cyanurate	ester kwasu cyjanurowego
lauryl gallate	ester laurylowy kwasu galusowego
diethylpyrocarbonate	eter dietylowy kwasu pirowęglowego
ferron, loretin	ferron, kwas 7-jodo-8-hydroksychinolino-5-sulfonowy
halogen acid, haloid acid	fluorowcokwas
phthalamide	ftalamid, diamid kwasu ftalowego
phthalimide	ftalimid, imid kwasu ftalowego
fumigacin, helvolic acid	fumigacyna, kwas helwolinowy
acidity H function	funkcja kwasowa Hammetta
gallamide	galamid, amid kwasu galusowego
glycylglycine	glicyloglicyna, kwas aminoacetyloaminooctowy
glycin, glycine, glycocoll, aminoacetic acid {NH2CH2COOH}	glicyna, glikokol, kwas aminooctowy
photoglycin {HOC6H4NHCH2COOH}	glicyna, kwas p-hydroksyfenyloaminooctowy
heteroauxin, 3-indoleacetic acid	heteroauksyna, kwas [beta]-indolilooctowy, kwas 3-indolilooctowy
heteropolyacid	heteropolikwas
homoserine	homoseryna, kwas 2-amino-4-hydroksybutanowy
benzene sulfonyl hydrazine	hydrazyd kwasu benzenosulfonowego
isonicotinic acid hydrazide, INAH	hydrazyd kwasu izonikotynowego
maleic hydrazide	hydrazyd kwasu maleinowego
hydroxylysine	hydroksylizyna, kwas 2,6-diamino-5-hydroksyheksanowy
o-sulfobenzoic imide, benzosulfimide, saccharin, gluside	imid kwasu o-sulfobenzoesowego, sacharyna
isopolyacid	izopolikwas
isoserine	izoseryna, kwas 2-hydroksy-3-aminopropanowy
monoacid	jednokwasowy
cantharidin	kantarydyna, lakton kwasu kantarydowego
carmine, carminic acid	karmin, kwas karminowy
acid-base catalysis	kataliza kwasowo-zasadowa
keto acid, ketone acid, ketocarboxylic acid	ketonokwas, oksokwas, kwas ketonokarboksylowy
acid coagulation	koagulacja kwasem
acescent	kwaśniejący, kwaskowy
silicofluoric acid, fluosilicic acid	kwas (heksa)fluorokrzemowy
tetraboric acid, pyroboric acid	kwas (heptaokso)tetraborowy, kwas piroborowy
tetraoxoarsenic(V) acid	kwas (tetraokso)arsenowy(V), kwas arsenowy
tetraoxochromic(VI) acid, chromic acid	kwas (tetraokso)chromowy(VI), kwas chromowy(VI), kwas chromowy
tetraoxophosphoric(V) acid	kwas (tetraokso)fosforowy(V), kwas fosforowy
tetraoxomanganic(VI) acid	kwas (tetraokso)manganowy(VI), kwas manganowy
tetraoxomanganic(VII) acid, permanganic acid	kwas (tetraokso)manganowy(VII), kwas nadmanganowy
tetraoxotungstic(VI) acid, tungstic acid	kwas (tetraokso)wolframowy(VI), kwas wolframowy
trioxonitric(V) acid	kwas (triokso)azotowy(V), kwas azotowy
undecenoic acid, undecylenic acid	kwas 10-undecenowy, kwas undecylenowy
2,3,5-triiodobenzoic acid, TIBA	kwas 2,3,5-trijodobenzoesowy
uvinic acid	kwas 2,5-dimetylofurano-3-karboksylowy
2-amino-3-methylbutyric acid, [alfa]-aminoisovaleric acid, valine	kwas 2-amino-3-metylobutanowy, walina
2-amino-4-methylpentanoic acid, [alfa]-aminoisocaproic acid, leucine	kwas 2-amino-4-metylopentanowy, leucyna
2-aminohexanoic acid, [alfa]-aminocaproic acid, norleucine	kwas 2-aminoheksanowy, norleucyna
[alfa]-aminopropionic acid, alanine	kwas 2-aminopropanowy, kwas [alfa]-aminopropionowy, alanina
2-ethylbutanoic acid, 2-ethylbutyric acid	kwas 2-etylobutanowy, kwas [alfa]-etylomasłowy, kwas dietylooctowy
2-phenylacrylic acid, atropic acid	kwas 2-fenyloakrylowy, kwas [alfa]-fenyloakrylowy, kwas 2-fenylopropenowy, kwas atropowy
cinchophen	kwas 2-fenylocynchoninowy
2-methyl acrylic acid, crotonic acid	kwas 2-metyloakrylowy, kwas but-2-enowy, kwas trans-2-butenowy kwas krotonowy
3-phenylacrylic acid	kwas 3-fenyloakrylowy, kwas cynamonowy
3-ketoglutaric acid	kwas 3-ketoglutarowy, kwas 3-oksopentanodiowy
phenylethylbarbituric acid	kwas 5-fenylo-5-etylobarbiturowy
[alfa]-naphthaleneacetic acid, 1-naphthylacetic acid	kwas a-naftalenooctowy
abietinic acid, abietic acid, arachidic acid, sylvic acid	kwas abietynowy, kwas eikosanowy, kwas arachidowy, kwas arachidynowy
aceturic acid	kwas aceturowy, kwas N-acetyloaminooctowy
acetoacetic acid, acetylacetic acid, diacetic acid	kwas acetylooctowy
adipic acid, hexanedioic acid	kwas adypinowy, kwas heksanodiowy
acrylic acid, acroleic acid, propenoic acid, vinylformic acid	kwas akrylowy, kwas propenowy
alginic acid, algic acid	kwas alginowy
alkyl sulfonic acid, alkanesulfonic acid	kwas alkilosulfonowy
allophanic acid	kwas alofanowy, kwas ureidokarboksylowy, kwas allotanowy
amidosulfuric acid, sulfamic acid	kwas amidosulfonowy
amino-G acid, amido-G acid	kwas amino G
naphthylaminedisulfonic acid	kwas aminonaftalenodisulfonowy
naphthylaminesulfonic acid	kwas aminonaftalenosulfonowy
nitrilotriacetic acid, NTA	kwas aminotrioctowy, kwas nitrylotrioctowy
angelic acid	kwas angelikowy, kwas [alfa]-metylokrotonowy
anthraquinonesulfonic acid	kwas antrachinonosulfonowy, sulfoantrachinon
anthranilic acid	kwas antranilowy, kwas o-aminobenzoesowy
eicosanoic acid	kwas arachidynowy, kwas eikozanowy
arsanilic acid	kwas arsanilowy, kwas 4-aminobenzenoarsonowy
asparagine, aminosuccinamic acid, asparagine monohydrate, aspartic acid, aspartate	kwas asparaginowy, asparagina, kwas aminobursztynowy, monoamid kwasu asparaginowego, kwas 2-aminobutanodiowy, monoamid kwasu bursztynowego
azelaic acid, nonanedioic acid	kwas azelainowy, kwas nonanodiowy
hyponitrous acid	kwas azotowy(I), kwas podazotawy
dioxonitric(III) acid	kwas azotowy(III), kwas azotawy
aqua fortis	kwas azotowy(V) stężony
mucic acid	kwas śluzowy
barbituric acid, malonylurea	kwas barbiturowy, malonylomocznik
benzene diazoic acid	kwas benzenodiazowy
benzene disulfonic acid	kwas benzenodisulfonowy
benzene sulfonic acid, benzene monosulfonic acid	kwas benzenosulfonowy
benzoic acid, benzene carboxylic acid	kwas benzoesowy
hydracid, binary acid	kwas beztlenowy
brassic acid, brassidic acid	kwas brasydynowy, kwas trans-dokoza-13-enowy
bromobutyric acid	kwas bromobutanowy, kwas bromomasłowy
hypobromous acid	kwas bromowy(I), kwas podbromawy
bromic acid, trioxobromic(V) acid	kwas bromowy, kwas (triokso)bromowy(V)
ethylenedicarboxylic acid, succinic acid	kwas butanodiowy, kwas etano-1,2-dikarboksylowy, kwas bursztynowy
Caro's acid, peroxomonosulfuric acid, peroxymonosulfuric acid	kwas Caro, kwas nadtlenomonosiarkowy(VI), kwas peroksomonosiarkowy(VI)
cerotic acid	kwas cerotynowy, kwas heksakozanowy
chaulmoogric acid, hydnocarpyl acetic acid	kwas chaulmugrowy, kwas uśpianowy
quinic acid, chinic acid	kwas chinowy
chloroplatinous acid	kwas chloroplatynowy(II), kwas tetrachloroplatynowy
chloroplatinic acid	kwas chloroplatynowy(IV), kwas heksachloroplatynowy
hydrochloric acid, muriatic acid	kwas chlorowodorowy, kwas solny
hypochlorous acid	kwas chlorowy(I), kwas podchlorawy
dioxochloric(III) acid, chlorous acid	kwas chlorowy(III), kwas chlorawy
tetraoxochloric(VII) acid, perchloric acid	kwas chlorowy(VII), kwas (tetraokso)chlorowy(VII), kwas nadchlorowy
trioxochloric(V) acid	kwas chlorowy, kwas (triokso)chlorowy(V)
cholanic acid	kwas cholanowy
cholic acid, cholalic acid, colalin	kwas cholowy
saccharic acid	kwas cukrowy
hydrocyanic acid, hydrogen cyanide, prussic acid	kwas cyjanowodorowy, cyjanowodór, kwas pruski
cyanic acid, hydrogen cyanate	kwas cyjanowy
cyanuric acid, tricyanic acid	kwas cyjanurowy
cyclohexanecarboxylic acid, hexahydrobenzoic acid	kwas cykloheksanokarboksylowy
citraconic acid	kwas cytrakonowy, kwas metylomaleinowy
citric acid	kwas cytrynowy, kwas 2-hydroksy-1,2,3-propanotrikarboksylowy
decanoic acid, decoic acid, capric acid	kwas dekanowy, kwas nonanokarboksylowy, kwas kaprynowy
deoxyribonucleic acid	kwas dezoksyrybonukleinowy
dialuric acid	kwas dialurowy, kwas 5-hydroksybarbiturowy
dimethylarsanic acid, dimethylarsinic acid, cacodylic acid	kwas dimetyloarsanowy, kwas kakodylowy
hexaoxodisulfuric acid, dithionic acid, hyposulfuric acid	kwas disiarkowy(V), kwas ditionowy(V), kwas podsiarkowy
disulfuric acid, pyrosulfuric acid	kwas disiarkowy(VI), kwas pirosiarkowy
dodecylbenzenesulfonic acid, DBSA	kwas dodecylobenzenosulfonowy, kwas alkilobenzenosulfonowy, kwas ABS
dodecanoic acid, lauric acid	kwas dodekanowy, kwas laurynowy
phospho-12-tungstic acid	kwas dodekawolframianofosforowy
docosanoic acid, behenic acid	kwas dokozanowy, kwas behenowy
fuming acid	kwas dymiący
arachidonic acid	kwas eikosatetraenowy, kwas arachidonowy
ellagic acid, hexaoxodiphenic acid	kwas elagowy, kwas heksaoksodifenowy, kwas heksahydroksydifenowy
elaidic acid	kwas elaidynowy, kwas trans-oktadeka-9-enowy
enanthic acid, oenanthic acid, n-heptanoic acid, n-heptylic acid	kwas enantowy, kwas heptanowy
erucic acid	kwas erukowy, kwas cis-13-dokozenowy
ethylenediaminetetraacetic acid, ethylenedinitrilotetraacetic acid	kwas etylenodiaminotetraoctowy, kwas wersenowy
sulfethylic acid, ethylsulfuric acid, acid ethyl sulfate	kwas etylosiarkowy(VI), wodorosiarczan etylu
phenolsulfonic acid	kwas fenolosulfonowy, kwas hydroksybenzenosulfonowy
phytic acid	kwas fitynowy, kwas inozytoheksafosforowy
fluosulfonic acid, fluorosulfuric acid, fluosulfuric acid	kwas fluorosulfonowy
folic acid, folacin, pteroylglutamic acid, PGA	kwas foliowy, kwas pteroiloglutaminowy
phosphoenol pyruvic acid	kwas fosfoenolopirogronowy
hypophosphorous acid, phosphinic acid	kwas fosforowy(I), kwas podfosforawy, kwas fosfinowy
hypophosphoric acid	kwas fosforowy(IV), kwas podfosforowy
phthalic acid	kwas ftalowy, kwas benzeno-1,2-dikarboksylowy
fumaric acid, boletic acid, lichenic acid	kwas fumarowy, kwas transbutenodiowy, kwas trans-eteno-1,2-dikarboksylowy
furancarboxylic acid	kwas furanokarboksylowy, kwas furanowy
furylacrylic acid, furacrylic acid	kwas furyloakrylowy, kwas furanoetenokarboksylowy
gallic acid	kwas galusowy, kwas 3,4,5-trihydroksybenzoesowy
tannic acid, tannin	kwas garbnikowy, tanina
gentisic acid	kwas gentyzynowy, kwas 2,5-dihydroksybenzoesowy
glycerol phosphoric acid, glycerinophosphoric acid	kwas glicerynofosforowy
glyceric acid	kwas glicerynowy, kwas 2,3-dihydroksypropanowy
glycolic acid, glycollic acid, hydroxyacetic acid	kwas glikolowy, kwas hydroksyoctowy
glyoxylic acid, glyoxalic acid	kwas glioksylowy, kwas formylokarboksylowy
gluconic acid, glyconic acid	kwas glukonowy
glutamic acid, glutaminic acid	kwas glutaminowy, kwas [alfa]-aminoglutarowy, kwas 2-aminopentanodiowy
glutaric acid	kwas glutarowy, kwas pentanodiowy
hexanoic acid, caproic acid	kwas heksanowy, kwas kapronowy
hexahydrophthalic acid, cyclohexane-1,2-dicarboxylic acid	kwas heksawodoroftalowy, kwas cykloheksano-1,2-dikarboksylowy
n-heptadecanoic acid, margaric acid	kwas heptadekanowy, kwas margarynowy
homogentisic acid	kwas homogentyzynowy, kwas 3,5-dihydroksyfenylooctowy
ureidoacetic acid	kwas hydantoinowy
hydracrylic acid	kwas hydrakrylowy, kwas 3-hydroksypropanowy
hydrocinnamic acid	kwas hydrocynamonowy, kwas 3-fenylopropanowy
hydroxysuccinic acid, apple acid, malic acid	kwas hydroksybursztynowy, kwas 2-hydroksybutanodiowy, kwas jabłkowy
hydroxycarboxylic acid, hydroxyacid, alcohol acid	kwas hydroksykarboksylowy, hydroksykwas
naphtholdisulfonic acid	kwas hydroksynaftalenodisulfonowy
naphtholsulfonic acid	kwas hydroksynaftalenosulfonowy
isophthalic acid, IPA	kwas izoftalowy, kwas benzeno-1,3-dikarboksylowy
isobutyric acid	kwas izomasłowy, kwas metylopropionowy
isonicotinic acid	kwas izonikotynowy, kwas pirydyno-4-karboksylowy
isopentanoic acid, isovaleric acid	kwas izopentanowy
monobasic acid, monoprotic acid	kwas jednozasadowy
iodogorgonic acid, 3,5-diiodotyrosine	kwas jodogorgonowy, 3,5-dijodotyrozyna
hydriodic acid	kwas jodowodorowy
hypoiodous acid	kwas jodowy(I), kwas podjodawy
tetraoxoiodic(VII) acid, periodic acid	kwas jodowy(VII), kwas (tetraokso)jodowy, kwas nadjodowy
trioxoiodic(V) acid	kwas jodowy, kwas (triokso)jodowy(V)
carbamic acid	kwas karbamowy, kwas karbaminowy
cresotinic acid, cresotic acid	kwas krezotynowy, kwas hydroksytoluilowy
crocein acid	kwas kroceinowy, kwas 2-hydroksynaftaleno-8-sulfonowy
silicic acid	kwas krzemowy
xanthic acid, xanthogenic acid	kwas ksantogenowy
levulinic acid	kwas lewulinowy, kwas 4-oksopentanowy
linolenic acid	kwas linolenowy, kwas oktadeka-9-12-15-trienowy
linolic acid	kwas linolowy, kwas oktadeka-9,12-dienowy
lipoic acid	kwas liponowy, kwas 6,8-ditiooktanowy
maleic acid, toxilic acid	kwas maleinowy, kwas cis-butenodiowy
malonic acid	kwas malonowy, kwas propanodiowy
butyric acid, butanoic acid	kwas masłowy, kwas butanowy
meconic acid	kwas mekonowy, kwas 3-hydroksy-[gamma]-pirono-2,6-dikarboksylowy
melissic acid	kwas melisowy, kwas triakontanowy
mellitic acid	kwas melitowy, kwas benzenoheksakarboksylowy
metaphosphoric acid, glacial phosphoric acid	kwas metafosforowy(V)
methacrylic acid	kwas metakrylowy, kwas 2-metylopropenowy
metanilic acid	kwas metanilowy, kwas 1-aminobenzeno-3-sulfonowy
methane sulfonic acid	kwas metanosulfonowy
methionic acid	kwas metionowy, kwas metanodisulfonowy
methylenesuccinic acid, itaconic acid	kwas metylenobursztynowy, kwas itakonowy
methylsuccinic acid, pyrotartaric acid	kwas metylobursztynowy, kwas pirowinowy
methylfumaric acid, mesaconic acid	kwas metylofumarowy, kwas mezakonowy
methylpropiolic acid	kwas metylopropiolowy, kwas but-3-ynowy
methylsulfuric acid	kwas metylosiarkowy, wodorosiarczan metylu
mevalonic acid	kwas mewalonowy, kwas 3-metylo-3,5-dihydroksypentanowy
mesoxalic acid	kwas mezoksalowy, kwas dihydroksymalonowy
mandelic acid	kwas migdałowy, kwas fenylohydroksyoctowy
mineral acid	kwas mineralny, kwas nieorganiczny
myristic acid, tetradecanoic acid	kwas mirystynowy, kwas tetradekanowy
lactic acid	kwas mlekowy, kwas 2-hydroksypropanowy
uric acid	kwas moczowy, 2,6,8-trihydroksypuryna
molybdenum(VI) acid, molybdic acid	kwas molibdenowy(VI)
montanic acid	kwas montanowy, kwas oktakozanowy
formic acid, hydrogen carboxylic acid	kwas mrówkowy, kwas metanowy
perbenzoic acid, peroxybenzoic acid	kwas nadbenzoesowy, kwas peroksobenzoesowy
perchromic acid	kwas nadchromowy, kwas nadtlenochromowy, kwas peroksochromowy(VI)
peracetic acid, peroxyacetic acid	kwas nadoctowy, kwas peroksooctowy
persulfuric acid, peroxodisulfuric acid	kwas nadtlenodisiarkowy, kwas nadsiarkowy, kwas peroksodisiarkowy(VI)
naphthoic acid	kwas naftoesowy, kwas naftalenokarboksylowy
nervonic acid	kwas nerwonowy, kwas tetrakozan-15-enowy
violet acid	kwas niebieski, kwas nitrozisulfonowy
niobic acid	kwas niobowy(V)
nitrosylsulfuric acid, nitrylsulfuric acid, chamber crystals	kwas nitrozylosiarkowy(VI)
nonanoic acid, n-nonoic acid, pelargonic acid	kwas nonanowy, kwas pelargonowy
glacial acetic acid	kwas octowy lodowaty
acetic acid, ethanoic acid, methanecarboxylic acid	kwas octowy, kwas etanowy, kwas metanokarboksylowy
oxamid acid	kwas oksaminowy, monoamid kwasu szczawiowego
oxanilic acid	kwas oksanilowy, monoanilid kwasu szczawiowego
oxochloric(I) acid	kwas oksochlorowy(I), kwas podchlorowy
octadeca-9,11,13-trienoic acid	kwas oktadeka-9,11,13-trienowy, kwas oleostearynowy
octanoic acid, caprylic acid	kwas oktanowy
oleic acid	kwas oleinowy
orotic acid, OA	kwas orotowy
orthanilic acid	kwas ortanilowy, kwas 1-aminobenzeno-2-sulfonowy
arsenic(III) acid, trioxoarsenic(III) acid	kwas ortoarsenowy(III), kwas (triokso)arsenowy(III), kwas arsenawy
orthoarsenic acid	kwas ortoarsenowy, kwas ortoarsenowy(V)
orthoboric acid, boric acid, boracic acid	kwas ortoborowy
orthophosphorous acid, trioxophosphoric(III) acid, phosphonic acid	kwas ortofosforowy(III), kwas (triokso)fosforowy(III), kwas fosforawy, kwas ortofosforawy, kwas fosfonowy
orthophosphoric acid, phosphoric acid	kwas ortofosforowy(V), kwas ortofosforowy
telluric acid, (hexaoxo)telluric(VI) acid	kwas ortotellurowy, kwas (heksaokso)tellurowy(VI)
orthovanadic acid	kwas ortowanadowy, kwas ortowanadowy(V)
p-aminobenzoic acid	kwas p-aminobenzoesowy
naphthionic acid	kwas p-naftionowy, kwas 1-aminonaftaleno-4-sulfonowy
palmitic acid, cetyl acid, cetylic acid	kwas palmitynowy, kwas heksadekanowy
parabanic acid, oxalylurea	kwas parabanowy, oksalilomocznik
pectic acid, polygalacturonic acid	kwas pektowy, kwas poligalakturonowy
pentanoic acid, valeric acid, valerianic acid	kwas pentanowy, kwas walerianowy, kwas n-walerianowy
peri acid	kwas peri
picolinic acid	kwas pikolinowy, kwas pirydyno-2-karboksylowy
picramic acid	kwas pikraminowy, 1-hydroksy-2-amino-4,6-dinitrobenzen
pimelic acid	kwas pimelinowy, kwas pentano-1,5-dikarboksylowy
fulminic acid	kwas piorunowy
pyromucic acid, 2-furoic acid	kwas pirośluzowy, kwas furano-2-karboksylowy
pyrophosphoric acid	kwas pirofosforowy, kwas difosforowy(V)
pyruvic acid, pyroracemic acid	kwas pirogronowy
pivalic acid	kwas piwalinowy, kwas trimetylooctowy
propiolic acid	kwas propiolowy, kwas etynokarboksylowy
propanoic acid, propionic acid	kwas propionowy, kwas propanowy
protocatechuic acid	kwas protokatechusowy, kwas 3,4-dihydroksybenzoesowy
protonic acid	kwas protonowy
rosolic acid	kwas rozolowy, metyloauryna
thiobenzoic acid	kwas S-tiobenzoesowy
thioacetic acid	kwas S-tiooctowy
salicylic acid	kwas salicylowy, kwas 2-hydroksybenzoesowy
weak acid	kwas słaby
sebacic acid	kwas sebacynowy, kwas dekanodiowy
selenous acid, trioxoselenium(IV) acid	kwas selenawy, kwas trioksoselenowy(IV)
sulfurous acid	kwas siarkawy, kwas (triokso)siarkowy(IV)
fuming sulfuric acid, oleum, Nordhausen acid, Nordhausen sulfuric acid	kwas siarkowy dymiący, oleum
tower acid	kwas siarkowy glowerowy
contact acid	kwas siarkowy kontaktowy
dipping acid	kwas siarkowy stężony
commercial sulfuric acid	kwas siarkowy techniczny
brimstone acid	kwas siarkowy z siarki rodzimej
sulfuric acid, tetraoxosulfuric(VI) acid	kwas siarkowy, kwas (tetraokso)siarkowy(VI)
sorbic acid	kwas sorbinowy, kwas heksa-2,4-dienodiowy
stearolic acid	kwas stearolowy, kwas 9-oktadecynowy
stearic acid	kwas stearynowy, kwas oktadekanowy
suberic acid	kwas suberynowy, kwas korkowy, kwas oktanodiowy
sulfanilic acid, aminobenzenesulfonic acid	kwas sulfanilowy, kwas aminobenzenosulfonowy
mercaptoacetic acid	kwas sulfanylooctowy, kwas merkaptooctowy
sulfonic acid	kwas sulfonowy
fatty acid	kwas tłuszczowy
terephthalic acid	kwas tereftalowy, kwas benzeno-1,4-dikarboksylowy
tetrabromoauric(III) acid, bromoauric acid	kwas tetrabromozłotowy(III)
cyanoplatinous acid	kwas tetracyjanoplatynowy(II)
cyanoauric acid	kwas tetracyjanozłotowy(III)
hyposulfurous acid	kwas tetraoksodisiarkowy(III), kwas podsiarkawy
tetraoxoselenic(VI) acid, selenic acid	kwas tetraoksoselenowy(VI), kwas selenowy
uranic acid	kwas tetraoksouranowy(VI)
tetrolic acid	kwas tetrolowy, kwas but-2-ynowy
thiosulfuric acid	kwas tio(II)siarkowy(VI)
thioglycolic acid	kwas tioglikolowy, kwas tiolooctowy
thiosalicylic acid, o-sulfhydrylbenzoic acid	kwas tiosalicylowy, kwas p-sulfanylobenzoesowy
oxoacid, oxy-acid	kwas tlenowy
toluic acid	kwas tolilowy, kwas toluilowy, kwas metylobenzoesowy
trioxotelluric(IV) acid, tellurous acid	kwas trioksotellurowy(IV), kwas tellurawy
trioxotitanic(IV) acid, titanic acid	kwas trioksotytanowy(IV), kwas tytanowy
tiglic acid	kwas tyglinowy, kwas 2-metylobut-2-enowy
undecanoic acid, undecylic acid	kwas undekanowy
acid cooking liquor	kwas warzelny
veratric acid	kwas weratrowy, kwas 3,4-dimetoksybenzoesowy
polythionic acid	kwas wielotionowy
polybasic acid, polyprotic acid	kwas wielozasadowy
tartaric acid	kwas winowy, kwas dihydroksybutanodiowy
[beta]-resorcylic acid	kwas [beta]-rezorcylowy, kwas 2,4-dihydroksybenzoesowy
acidulous, sourish	kwaskowaty
acidimeter	kwasomierz
acid-resistant, acid resisting, acidproof	kwasoodporny
acid-forming, acidic	kwasotwórczy
acidity	kwasowość
acidic	kwasowy
acid-mordant dye	kwasowy barwnik zaprawowy
acid	kwasowy, kwaśny
bile acids	kwasy żółciowe
acid number, acid value	liczba kwasowa
lysine	lizyna, kwas 1,5-diaminoheksanowy
melamine	melamina, triamid kwasu cyjanurowego
methacrylate, methacrylate ester, methacrylic ester	metakrylan, ester kwasu metakrylowego
methacrylamide	metakryloamid, amid kwasu metakrylowego
methionine	metionina, kwas 2-amino-4-metylotiobutanowy
standard acid	mianowany roztwór kwasu
spent acid	mieszanina ponitracyjna, mieszanka ponitracyjna, kwas ponitracyjny
N-chlorosuccinimide	N-chloroimid kwasu bursztynowego
overacidity, superacidity	nadkwasowość
niacin, nicotinic acid	niacyna, kwas nikotynowy, kwas pirydyno-3-karboksylowy
succinonitrile	nitryl kwasu bursztynowego
glutaronitrile	nitryl kwasu glutarowego, pentanodinytryl
butyronitrile	nitryl kwasu masłowego, cyjanek propylu
propionitrile, ethyl cyanide	nitryl kwasu propionowego, propiononitryl, cyjanek etylu
norvaline	norwalina, kwas 2-aminopentanowy
ethanethiolic acid	O-kwas tiooctowy
deacidify	odkwaszać
deacidification	odkwaszanie
aci form	odmiana aci, odmiana kwasowa
oxamide, oxalamide, ethanediamide	oksamid, (di)amid kwasu szczawiowego
oxanilide	oksanilid, (di)anilid kwasu szczawiowego
oximide, oxalimide	oksimid, imid kwasu szczawiowego
amino-acid oxidase	oksydaza aminokwasowa
parchment paper	pergamin roślinny, papier pergaminowy, pergamin kwasowy
per-acid	peroksokwas, nadtlenokwas, kwas nadtlenowy
polyamide acid, polyamic acid	poliamidokwas
polyacid	polikwas
polyacrylic acid, PAA	polikwas akrylowy
polyphosphoric acid	polikwas fosforowy
proline	prolina, kwas pirolidyno-2-karboksylowy
acidify	przeprowadzać w kwas
acid egg, blow case, blowing egg, montejus	przetłaczarka kwasowa, przetłoczka, montejus
pseudoacid	pseudokwas
alkali-refined	rafinowany ługiem, odkwaszany ługiem
acid radical	reszta kwasowa
acid hydrolysis, acidolysis	rozpad kwasowy, hydroliza kwasowa, rozszczepienie kwasowe, acydoliza
acid solubility	rozpuszczalność w kwasach
ethanethiolic acid	S-kwas tiooctowy
sarcosine, N-methylglicine	sarkozyna, N-metyloglicyna, kwas N-metyloaminooctowy
per-salt	sól kwasu nadtlenowego
lead(II) linoleate, lead plaster	sól ołowiu(II) kwasu linolowego
weakly acidified, acidulated	słabo zakwaszony
serine	seryna, kwas 2-amino-3-hydroksypropionowy
succinimide, butanimide	sukcynimid, sukcynoimid, imid kwasu bursztynowego
sulfonamide	sulfonoamid, amid kwasu sulfonowego
taurine	tauryna, kwas 2-aminoetanosulfonowy
red oil	techniczny kwas oleinowy
acidic oxide	tlenek kwasowy
hexamethylphosphoric triamide	triamid kwasu heksametylofosforowego(V)
cyanuric azide	triazydek kwasu cyjanurowego
acid-extractable	ulegający ekstrakcji kwasami
acidifiable	ulegający zakwaszeniu
uramil, murexan	uramil, kwas 5-aminobarbiturowy
polyunsaturated fatty acid	wielonienasycony kwas tłuszczowy
alkyl hydrogen sulfate, alkyl sulfuric acid	wodorosiarczan alkilu, kwas alkilosiarkowy
acid-sensitive	wrażliwy na działanie kwasów
acid-base indicator	wskaźnik pH, wskaźnik kwasowo-zasadowy, wskaźnik alkacymetryczny
backwash	wypłukiwać, przepłukiwać
leaven	zakwas chlebowy
starter	zakwas mleczarski
acidify	zakwaszać, zadawać kwasem
acidification	zakwaszanie
souring {spożywcze}	zakwaszanie, kwaszenie
polyacid base	zasada wielokwasowa
kill an acid	zobojętniać kwas
[epsilon]-caprolactam, aminocaprolactam	[epsilon]-kaprolaktam, laktam kwasu 6-aminoheksanowego
Chronic Obstructive Pulmonary Disease, COPD	Przewlekła Obturacyjna Choroba Płuc, POChP
ENT/Ear, Nose and Throat disease	zachorowanie ORL/otorynolaryngologiczne
hemorragia subaracnoidea	krwotok podpajęczynówkowy, krwawienie podpajęczynówkowe
Obstructive Sleep Apnea/Apnoea Syndrome, OSAS	Zespół Obturacyjnych Bezdechów Sennych / Zespół obturacyjnych zaburzeń oddychania podczas snu
pulmonary emphysema	rozedma płuc
Restless Legs Syndrome, RLS	Zespół Niespokojnych Nóg, ZNN
egg drop syndrome	syndrom spadku nieśności
thrombophlebitis	zakrzepowe zapalenie żył / zakrzepica
tonsillar herniation	wgłobienie w otwór wielki, wgłobienie/przemieszczenie migdałków móżdzku
abscess	ropień
abutment crown	korona filarowa mostu
abutment post	filar wszczepu
alveolar ridge	grzbiet wyrostka zębodołowego
analog	replika
angioma	naczyniak
aspiration tip	końcówka ssaka
barrier membrane	błona zaporowa
trabecula	beleczki kostne
blunt diamond bur	tępy frez diamentowy
body of mandible	trzon żuchwy
bone allograft	kość allogenna
bone collector	filtr kostny
bone stumps	odłamy kostne
bony lid	dekielek kostny
buccal retractor	odciągacz policzków
buccal shelf	blaszka policzkowa
buccinator	mięsień policzkowy
bundle bone	blaszka zbita wyrostka zębodołowego
burnisher	gładzik
calcigerous cell	osteoblast
calculus	kamień nazębny
canine fossa	dół nadkłowy
cauterization	przyżeganie
CEJ cemento-enamo junction	granica szkliwno-zębinowa
cell viability	przeżywalność komórek
ischaemic heart disease (IHD)	choroba niedokrwienna serca
clasp	klamra
coarse-grained diamond bur	gruboziarniste wiertło diamentowe
core	sztyft korzeniowy zęba
cortex	istota korowa
cortical plate	płytka korowa; blaszka zbita wyrostka zębodołowego
cortical walls	ściany blaszki zbitej
counter-die	patryca
countersink	pogłębiacz
counterstain	barwnik kontrastowy
cross-cut carbide bur	frez naprzemianskośny
debridement	oczyszczenie
dental lamina	listewka zębowa
dentinocyte	komórka zębinowa
digastric fossa	dół dwubrzuścowy
ductility	ciągliwość
endocultivation	odbudowa własna tkanki
engraftment	przyjęcie się przeszczepu
epithelial attachment	przyczep nabłonkowy
ethmoid bone	kość sitowa
excursion	ruch żuchwy
explantation drill	wiertło poszerzające
exudate	płyn wysiękowy
fibrin sealant	klej fibrynowy
filings	opiłki porcelanowe
flange	podcienie
free end saddle	brak skrzydłowy
freeze-dried	liofilozowane
GBR guided bone regeneration	sterowana regeneracja kostna
gingival margin	rąbek dziąsłowy
gingival sulcus	rowek dziąsłowy
rheumatoid arthritis	gościec stawowy postępujący
gomphiasis	rozchwianie zębów
gomphosis	wklinowanie, staw klinowy
GTR guided tissue regeneration	sterowana regeneracja tkankowa
handpiece	prostnica
healing abutment	łącznik gojący
holding key	klucz transferowy
implant coping	replika implantu
implant shoulder	stopień implantu
impression caps	czapeczki wyciskowe
impression coping	transfer wyciskowy
impression coping tapered	przenośnik wyciskowy stożkowy
impression material	masa wyciskowa
impression tray	łyżka wyciskowa
inferior dental canal	kanał żuchwowy
infrabony pocket	kieszonka śródkostna
interalveolar septa	przegrody międzyzębodołowe
ITI narrow-neck implant	Implant ITI o wąskiej platformie
jeziorko żółciowe	bile lake
synovial bursa	kaletka maziowa
light-cured varnish	lakier światłoutwardzalny
low complication rate	niski współczynnik powikłań
mandibular joint	staw skroniowo-żuchwowy
masseter	żwacz
masseteric tuberosity	guzowatość żwaczowa
masticatory surface	powierzchnia żująca, okluzalna
maxillofacial surgery	chirurgia szczękowa
mental foramen	otwór bródkowy
mental spine	kolec bródkowy
mental symphysis	spojenie żuchwy
metastasis	przerzut nowotworowy
atherosclerosis	miażdżyca tętnic
renal pelvis	miedniczka nerkowa
mucoperiosteal flap	płat śluzówkowo-okostnowy
mylohyoid groove	bruzda żuchwowo-gnykowa
nail, pin, dowel, tenon	ćwiek
needle forceps	igłotrzymacz
non-resorbable GBR barriers	nieresorbowalne błony zaporowe
bone turnover	obrót kostny
bone turnover	obrót kostny
bone turnover	obrót kostny
orthograde endodontics	endodoncja w przednich odcinkach łuku
osteoconductivity	przewodnictwo kostne
osteophyte	narośl kostna
papilla preservation debridement	oczyszczenie oszczędzające brodawkę
paradental/periodontal cyst	torbiel przyzębna
parodontium	przyzębie
pendulous palate	podniebienie miękkie
periapical radiograph	radiogram przywierzchołkowy
pericementum	ozębna
periodontal flap	płat tkanek przyzębia
periodontal pack	opatrunek naddziąsłowy
periodontal regeneration	regeneracja przyzębia
periosteum	okostna
piezoelectric osteotome	osteotom, dłuto kostne
pontic	dowieszka zęba (na przęśle mostu)
post	sztyft
post cap	czapeczka na wkład
post hoc testing	testy wielokrotnych porównań
fascia	powięź
prognosis	rokowanie
extensor	prostownik
PRP (platelet-rich plasma)	bogatopłytkowe osocze krwi
bone remodel(l)ing	przebudowa kostna
chronic heart failure	przewlekła niewydolność serca
contracture	przykurcz
pituitary gland / hypophysis	przysadka mózgowa
pulp chamber	komora zęba
pulp extractor	miazgociąg
punch	dziurkacz
ramus of the mandible	gałąź żuchwy
reamer	poszerzacz
recurrence, relapse	nawrót
releasing incision	naciecie odbarczające
restorative dentistry	stomatologia odtwórcza
retromolar fossa	dół zatrzonowy
retromolar pad	trójkąt zatrzonowcowy
retromolar region	obszar zatrzonowcowy
root preparation	opracowanie korzenia
round bur	różyczka diamentowa (wiertło)
round condenser	upychadło kulkowe
rubber dam punch	dziurkacz koferdamu
scoop	łyżeczkować
seat of a cavity	dno ubytku
snap cap	czapeczka
snap-on	plastikowy przenośnik nasadzany
staged approach	procedura dwuetapowa
stem cells	komórki macierzyste
stomach teeth	dolne kły
subgingival concrement removal	poddziąsłowe usuwanie kamienia
articular space	szpara stawowa
temporary crown	prowizorium
thrush	drożdżyca
tissue pliers	pinceta tkankowa
tweezers	szczypczyki
undercuts	podcienia
volumetric stability	stabilność objętościowa
wax-up	ustawienie zębów w wosku
wide-body implant	implant o szerokiej platformie
Colles' fracture	złamanie bagnetowate kości promieniowej
air puffer	gruszka (do przedmuchiwania)
arterial line	cewnik dotętniczy
aspat vs. alat	Aminotransferazy  (asparginowa i alaninowa)
augmented labor	poród przyspieszony
hydrolipid barrier	bariera hydrolipidowa
blinded to	nieświadoma, nie znająca szczegółów (badania)
cattle hyena disease	przedwczesne zamknięcie chrząstki wzrostowej/nasadowej u bydła
cattle hyena disease	przedwczesne zamknięcie chrząstki wzrostowej/nasadowej u bydła
Ceiling Mounted Hoist	(szynowy) podnośnik montowany do sufitu
child assent	przyzwolenie (małoletniego)
zoonotic diseases	choroby odzwierzęce
periodontium diseases	choroby przyzębia
consultation report	wynik konsultacji
contact lens lathe	obróbka mechaniczna soczewek kontaktowych
derepression	derepresja / inaktywacja represora
peritoneal dialysis	dializa otrzewnowa
digestive nutrients	składniki odżywcze ułatwiające/wspomagające trawienie
disenrollment / disenrolment	rozwiązanie umowy ubezpieczenia
oxygenate	dotleniać
drug treatment	leczenie farmakologiczne
empyema	ropniak
ENG	szczepionka Engerix-B
Engerix-B vaccine	ENG
Epidural lysis (of adhesions)	uwolnienie zrostów z przestrzeni nadtwardówkowej
epispasm	rekonstrukcja/plastyka napletka
ethylene diamine tetra-acetic acid (EDTA)	kwas etylenodiaminotetraoctowy
fetal heart rate	czynność serca płodu
fetus in breech presentation	płód w położeniu pośladkowym
fetus in transverse presentation	płód w położeniu poprzecznym
fetus in vertex presentation	płód w położeniu wierzchołkowym
flush urostomy	płaska urostomia/przetoka moczowo-skórna
followed in clinic	pod opieką poradni
smooth domes of the diaphragm	gładko zarysowane kopuły
Cx	GO
He's still taching at 140.	Wciąż ma częstoskurcz 140/min.
high palatal vault	wysoko sklepione/wysklepione podniebienie / podniebienie gotyckie
home health aide	pracownik domowej opieki zdrowotnej
hypo-thyroidism	niedoczynność tarczycy
intramuscular bleeding with compartment syndrome	wylew wewnątrzmięśniowy z zespołem ciasnoty międzypowięziowej
irrigation lumen	kanał irygacyjny / światło kanału irygacyjnego
nephrolithiasis and ureterolithiasis	kamica nerki i moczowodu
(ingrown) nail corrective brace	klamra korygująca wrastający pazokieć
knee orthotic	orteza stawu kolanowego
downturned tip of the nose / nasal tip	koniuszek nosa opuszczony
labor and delivery suite	sala porodowa
laking	wypłukiwanie hemoglobiny z krwinek
lavender-top tube	probówka z fioletową/jasnofioletową zatyczką
mandibular impression	wycisk żuchwowy
maternal serum alpha-fetoprotein (MSAFP) test	badanie stężenia alfa-fetoproteiny w surowicy matki
medial and lateral fasciotomy	przyśrodkowe i boczne nacięcie powięzi
neural tube defects	wady cewy nerwowej
non-drug treatment	leczenie niefarmakologiczne
Nuclear Stress Test	próba wysiłkowa z obrazowaniem izotopowym
nutrition	procesy odżywcze
open neural tube defects	otwarte wady cewy nerwowej
acute tubulointerstitial nephritis	ostre cewkowo-śródmiąższowe zapalenie nerek
wrinkle/skin filler injections	ostrzykiwanie zmarszczek
Surgery Schedule	panel
parathyroid gland	gruczoł przytarczyczny
(urinary) urgency	parcie na mocz
community nurse / health visitor	pielęgniarka środowiskowa
placenta accreta	łożysko przyrośnięte
placenta previa	łożysko przodujące
placental abruption	oddzielenie się łożyska
plantar	odruch podeszwowy
diagnostic/therapeutic clinic licensed as public health care facility	poradnia diagnostyczno-terapeutyczna posiadająca uprawnienia placówki publicznej
posterior facet joint	tylny staw międzywyrostkowy
Thymol turbidity test	Pr.  tyml
preimplantation genetic diagnosis (PGD)	diagnostyka preimplantacyjna
Preservation I trial	badanie Preservation I
progress notes	uwagi o stanie pacjenta
gamete intrafallopian transfer	przenoszenie gamet śródjajowodowe
common bile duct	przewód żółciowy wspólny (PŻW)
anteromedial surface of humeral shaft	przyśrodkowo-przednia powierzchnia trzonu kości ramiennej
basal iridectomy	przypodstawna irydektomia
undercast sleeve	rękaw podgipsowy
vocational rehabilitation	rehabilitacja zawodowa
Relapse prevention drill	ćwiczenie/trening (umiejętności) zapobiegania nawrotom choroby
relapsing-remitting multiple sclerosis	rzutowo-remisyjna postać stwardnienia rozsianego
chest x-ray	roentgen klatki piersiowej
sciatic neuralgia / sciatica / ischialgia	rwa kulszowa
sagital and coronal reformation	rekonstrukcja/rzut (obrazu) w płaszczyźnie strzałkowej i czołowej
operating room and recovery room	sala operacyjna i sala pooperacyjna
skeletal survey	badanie radiograficzne szkieletu
mobility aids and assistive devices/equipment	sprzęt wspomagający pracę mięśni
submicroscopic deletion	delecja submikroskopowa
suppressor	czynnik/gen epistatyczny / supresor
surgical site	rana operacyjna
surgical site	rana pooperacyjna
perineal / leg strap	taśma kroczna
thromboembolic disease	choroba zatorowo-zakrzepowa
TIA : transient ischaemic attack	przejściowy atak niedokrwienny
well/normally aerated lung tissue	tkanka prawidłowo powietrzna
impaired coherent communication	trudny kontakt rzeczowy
fine crackles/fine bubbling rales	trzeszczenia drobnobańkowe
to place stoma	ustawic stomie
vesical	pęcherzowy
wellness	zdrowie fizyczne
intravesical prostatic protrusion / the prostate gland was/is protruding into the bladder	wpuklenie prostaty do pęcherza
to implant a (heart) pacemaker	wszczepić układ stymulujący
X-ray film processor	wywoływarka do błon RTG
airborne	wziewny
increase in/progression of the degenerative changes of the subchondral bone sclerosis	wzmożona zwyrodnieniowo sklerotyzacja podchrzęstna
x-ray report	badanie rentgenowskie (radiologiczne)
impair psychomotor function / (adversely) affect psychomotor function	zaburzać sprawność psychomotoryczną
uterovesical/vesicouterine pouch/recess	zagłębienie pęcherzowo-maciczne
splenic flexure	zagięcie śledzionowe
atrial septal defect and patent foramen ovale closure	zamykanie otworów w przegrodach
concrements	złogi
cystic lesions	zmiany torbielkowate
zoonotic infection	infekcja odzwierzęca
adenomatoid hyperplasia	rozrost gruczolakowaty
Cath Lab Log Report	wyniki badań przeprowadzonych w pracowni badań inwazyjnych
hyperemic effect	efekt przekrwienny
LL (left leg)	NL
non small cell carcinoma of the lung	niedrobnokomórkowy rak płuca
RL (right leg)	NP
RA (right arm)	RP
anthraquinones	antrachinony
antimicrobial agent	środek przeciwdrobnoustrojowy
apulotics	leki zabliźniające
polybrachygeny	polybrachygenesis (polybrachygeneza)
pencil-in-cup deformities	obraz zaostrzonego ołówka
abnormal turnover of bone	nieprawidłowy obrót kostny
accommodation is relaxed	akomodacja jest porażona/zniesiona
adverse events reported terms	terminy stosowane przy zgłaszaniu zdarzeń niepożądanych
aerobic target heart rate	docelowa częstość czynności serca dla ćwiczeń aerobowych
alu-alu blister strip	blister Alu/Alu
antacid	lek zobojętniający
anular mucosal lesion	obrączkowa zmiana błony śluzowej
aortic valve was tricuspid	zastawka aorty była trzypłatkowa
attachment	przyssanie
transparent pupil	źrenica przezierna
minimal (R waves)	śladowe (załamki R)
Balloon Inflation Device	urządzenie do napełniania balonu
Bettering the Evaluation and Care of Health, BEACH	Poprawianie Oceny i Opieki Zdrowotnej
blinded/unblinded staff	personel niepoinformowany/poinformowany o leczeniu otrzymywanym przez pacjenta
bony healing	zrastanie się kości
bulking agents	środki zwiększające objętość stolca
Can I have a feel ? (of your stomach)	Czy mogę zbadać Pana/Pani brzuch?
cavitating lesions	zmiany powodujące tworzenie się jam
cervical hardware	implant szyjny
thyroid isthmus	ciesn tarczycy
Circulating marker sampling, Active fraction sampling	pobieranie próbek do oznaczenia markerów krążących, pobieranie próbek do oznaczenia frakcji czynnej
Clear!	Odsunąć się!
clinical and regulatory affairs	Zagadnienia kliniczne i prawne
clinical period of a study	kliniczny etap badania
comfortable to palpation	bez tkliwości przy badaniu palpacyjnym
commenced on remoblization	tu: rozpoczęto ponowne uruchamianie
confirmed by culture	potwierdzona wynikiem posiewu
cough tenderness	bolesność przy kaszlu
cut-off	punkt odcięcia
deflectable catheter delivery system	system wprowadzający cewnik odginany
distal shaft	dystalna część trzonu
distribution	dermatom
due to bone development	wpływa na rozwój kości
Duplication therapy warnings	tu: ostrzeżenia przed dublowaniem się leków
early breakthrough disease	nawrót choroby na wczesnym etapie leczenia
early termination visit	wizyta związana z przedwczesnym zakończeniem udziału w badaniu
exploratory and mating behaviors	zachowania eksploracyjne i płciowe
failure risks	ryzyko niepowodzenia
feeling of fullness over the bladder	uczucie pełnego pęcherza
fibrocystic change	zmiany włóknisto-torbielowate
fixed curve catheter	cewnik o ustalonej krzywiźnie
flipped superior to	przemieszczony nad
forced duction test	test biernej ruchomości gałki ocznej
gastric band	opaska żołądkowa
gastric bypass	ominięcie żołądkowo-jelitowe
glare	poświata
grading	ocena zaawansowania
hepatocellular insufficiency	niewydolność wątroby
herniated nucleus polposus	przepuklina jądra miażdżystego
hub	nasadka
Immunochemical identification of neuroendocrine markers	identyfikacja immunochemiczna markerów neuroendokrynologicznych
instrumental perforation	perforacja narzędziem
intra- and inter-assay coefficients of variation	współczynnik zmienności wewnątrzseryjnej i międzyseryjnej
intraretinal	śródsiatkówkowy
intratumor cavitation	powstawanie jamy wewnątrz guza
isolated sensitive neuropathy	izolowana neuropatia włókien czuciowych
joint aspiration	aspiracja płynu stawowego
Department of Craniomaxillofacial and Oral Surgery with Implantology	Klinika Chirurgii Czaszkowo-Szczękowo-Twarzowej, Chirurgii Jamy Ustnej i Implantologii
Latent tuberculosis	utajona gruźlica
later line therapy	terapia dalszego rzutu
left coronary perfusion	perfuzja mięśnia sercowego w obszarze ukrwienia przez lewą tętnicę wieńcową
legal blindness	praktyczna ślepota
Lens Opacities Classification System	System Klasyfikacji Zmętnień Soczewki
life-long	podawane do końca życia/przez czas nieokreślony
light-headedness	uczucie oszołomienia
lobar consolidative pneumonia	zlewne płatowe zapalenie płuc
log cell killing	niszczenie stałej proporcji komórek
lt. pericallosal artery	lewa tętnica okołospoidłowa
main stem ostium	miejsce odejścia pnia głównego lewej tętnicy wieńcowej
major abscess	duży ropień
maternal-fetal specialist	perinatolog
mean aortic pressure	średnie ciśnienie w aorcie
mediated by photoperiod	tu: na który wpływa czas ekspozycji na światło
mobile blood sample collection	pobieranie krwi za pomocą przenośnego zestawu
mucosal folds	fałdy błony śluzowej
myeloproliferative disorder	schorzenie mieloproliferacyjne
nephrostomy track	przetoka nefrostomijna
few round epithelial cells	okr.poj (badanie ogólne moczu)
older paternal age	starszy wiek ojca
operative dictations	uwagi dyktowane podczas zabiegu przez lekarza
oral substitution	doustna suplementacja
organized hard exudate plaques	twarde uorganizowane blaszki wysiękowe
palpable haematoma	krwiak wyczuwalny palpacyjnie
pathology staging	klasyfikacja stopnia zaawansowania nowotworów złośliwych
pelvic tenderness	tkliwość miednicy
perfused vessel	naczynie, przez które przepływa krew
Peripheral Nerve Stimulation	stymulacja nerwów obwodowych
pin sites	miejsca umieszczenia drutów
positioning system	system do wprowadzenia we właściwe położenie
posterior horn	róg tylny
sectoral ducts dilatation	poszerzenie przewodów sektorowych
above the upper margin of	powyżej górnego brzegu
presentation	obraz kliniczny
problem-prone indicators	wskaźniki wysokiego prawdopodobieństwa wystąpienia problemów/powikłań
protocol	standardy postępowania
coronary artery bypass grafting (CABG)	przęsłowanie naczyń wieńcowych
Psychiatric Emergency Room	psychiatryczny szpitalny oddział ratunkowy
ready-to-use syringe	ampułkostrzykawka
Rebound tenderness	objaw Blumberga
recent conversion	osoby, u których niedawno nastąpiła konwersja odczynu tuberkulinowego (z ujemnego na dodatni)
recreational drugs	substancje psychoaktywne używane w celach nieleczniczych
releasable stitch	szew regulowany
renal milestone	najważniejsze (ew. kluczowe) zdarzenia z przebiegu choroby nerek pacjenta
renal toxicity	toksyczny wpływ (leczenia) na nerki
residual impairment	tu: utrzymujące się upośledzenie
right cervical side flexion	boczne zgięcie szyi w prawo
separately submitted	przesłany oddzielnie
septic physiology	wstrząs septyczny
serum trough concentration	najniższe stężenie w surowicy
signs	objawy przedmiotowe
spinal tenderness	tkliwość kręgosłupa
stable dose and regimen	stała dawka i schemat podawania leku
statement of assent	wyrażenie zgody
steam-flush pressure-pulse parameters	parametry impulsów podciśnienia i wstrzyknięć pary wodnej
stent the plaque	założyć stent w zmianie miażdżycowej
study reached its conclusion	badanie zakończyło się/dobiegło końca
subject of your application	tu: stanowiących przedmiot zgłoszenia
submucosal fatty infiltrate	podśluzówkowe nacieczenia tłuszczowe
sucking chest wound	rana klatki piersiowej z zasysaniem powietrza
suctioning and irrigation	odsysanie i przepłukiwanie
sustained viral response	trwała odpowiedź wirusologiczna
symptom burden	obciążenie wieloma objawami
symptoms	objawy podmiotowe
the primary and secondary leads	odprowadzenia podstawowe i dodatkowe
timing	moment/czas wystąpienia
to be monitored for worsening of glucose control	być monitorowanym pod kątem pogorszenia kontroli glikemii
to determine the optimal approach	aby określić optymalne postępowanie
to reproduce	powodować ponowne wystąpienie (bólu)
tracheostomy direct connection	bezpośredni łącznik do rurki tracheostomijnej
Transient Ischemic Dilation	przejściowe rozszerzenie niedokrwienne
unrefreshing or nonrestorative sleep	sen nieregenerujący
vaginal sack	ślepo zakończona pochwa
viral negative	ujemny wynik badań pod kątem obecności wirusów
wave ''a''	fala a
whoop	pianie
lymph node involvement	zająć/zajęcie węzłów chłonnych
(pain) not elswhere classified	(bol) nieklasyfikowany gdzie indziej (ICD))
(pain) radiates/shoots down to the lower limb	(bol) promieniuje do konczyny dolnej
(changes) at the level of (L4 S1)	(zmiany) na poziomie (L4 S1)
peribursal abrasion	abrazja przytorebkowa
muscular anatomy of lower limbs	anatomia miesni konczyn dolnych
trochlea tali (of the talus)	bloczek (kosci skokowej)
synovial membrane	blona maziowa
bone dowel	bolec kostny (przy stabilizacji ALIF)
chondromalacia	chondromalacja
mobilising exercises vs fitness exercises	cwiczenia ruchowe vs usprawniajace
popliteal fossa	dół podkolanowy
intercondylar notch (knee)	dol miedzyklykciowy (kolano)
(nasal) airway patency	droznosc (nosa)
patellofemoral plica	fald rzepkowo-udowy (kolano)
fibrillation	fibrylacja
lond head (of biceps)	glowa dluga (bicepsa)
lesser tubercle	guzek mniejszy (kosci ramiennej)
greater tubercle (of humerus)	guzek wiekszy (kosci ramiennej)
Schmorl's nodes	guzki Schmorla
hemiepiphysiodesis	hemiepifizjodeza
first dorsal interosseus muscle (of the hand)	I miesien miedzykostny (dloni)
trochanteric bursa	kaletka kretarzowa
subacromial-subdeltoid bursa	kaletka podbarkowo podnaramienna
vertebral foramen	kanal kregowy
kuphotic deformity	kifotyzacja
corporectomy / corpectomy	korporektomia
valgus deformity or knock-elbow	koslawosc
valgus knees/knock knees	koslawosc (kolana do srodka)
(fibial) lateral malleolus	kostka boczna (strzalki)
medial tibial malleolar	kostka przysrodkowa piszczeli
(bridging) callus	kostnina
titanium cage	kosz tytanowy (przy korporektomii)
medial meniscus	lakotka przysrodkowa (kolano)
lumbar spine	ledzwie
lordosis (inward curvature of the spine)	lordoza (wygiecie kregoslupa ku przodowi)
aseptic necrosis	martwica jalowa (kosci)
transverse friction massage	masaz poprzeczny
thenar eminence/muscles	mięśnie kłębu
gastrocnemius muscle	miesien brzuchaty (lydki)
supraspinatus (muscle)	miesien nadgrzebieniowy
soleus muscle	miesien plaszczkowaty (lydki)
subscapularis muscle	miesien podlopatkowy
gracilis muscle	miesien smukly
vertebral haemangioma	naczyniak kregu
lateral epicondyle	nadklykiec boczny (kosci ramiennej)
proximal epiphysis	nasada blizsza (kosci)
filum terminale	nić końcowa
irregularities of the end plates	nierownosci blaszek granicznych
mild degenerative changes	niewielkie zmiany zwyrodnieniowe
vacuum phenomenon	objaw prozniowy
cervical radiculopathy	objawy korzeniowe szyjne
acetabular labrum	obrabek stawowy (biodro)
acetabular labrum	obrabek stawowy (biodro)
glenoid labrum	obrabek stawowy (ramie)
segmental thickening	odcinkowe pogrubienie
recurrence rate	odsetek nawrotow
(pull-on) wrap	opaska uciskowa (usztywniajaca chory staw)
lower/short leg plaster cast	opatrunek gipsowy stopowo-podudziowy
circular plaster cast	opatrunek okrezny
periarticular	otaczajacy staw (okolostawowy)
syndactyly (syndactaly)	palcozrost
lumbar support	pas ledzwiowy
anteromedial band	pęczek przednio-przyśrodkowy (czesc ACL)
posterolateral band	pęczek tylko-boczny (czesc ACL)
anteromedial bundle	peczek przednio-przysrodkowy (ACL kolano)
posterolateral bundle	peczek tylko-boczny (ACL kolano)
meniscus tear with migration of meniscular fragment	pekniecie lakotki z przemieszczeniem fragmentu
annulus fibrosus	pierscien wloknisty
tendon sheath	pochewka sciegnista
sublabral (cyst)	podobrabkowa (tu: torbiel)
base of the thumb	podstawa kciuka
sub-ligamentous (bulge)	podwiezadlowa (wypuklina)
thoracolumbar junction	pogranicze piersiowo-ledzwiowe
constrained posture	pozycja wymuszona
galvanic current therapy	prady galwaniczne
interferential current therapy	prady sredniej czestotliwosci
right convex (scoliosis)	prawowypukla (skolioza)
hinge orthosis	proteza zawiasowa
subacromial space	przestrzen podbarkowa
full thickness skin graft	przeszczep skory pelnej grubosci
chronic (pain)	przewlekly (bol)
inversion	przywiedzenie (stopy, zwrocenie do wewnatrz)
radiocarpal joint	nadgarstek
land PT	rehabilitacja (fizjoterapia)
double-bundle (ACL) reconstruction	rekonstrukcja (ACL) metoda dwupeczkowa
posterior horn of medial meniscus	rog tylny lakotki przysrodkowej
rolimetr	rolimeter
kneecap / patella	rzepka (kolanowa)
extensor muscles tendons (of the hand)	sciegna miesni prostownikow (dlon)
supraspinatus tendon	sciegno miesnia nadgrzebieniowego
tendon of extensor pollicus longus	sciegno prostownika kciuka
livid	siny
sella turcica	siodlo / siodelko tureckie
the calvaria / sullcap	sklepienie czaski
rotational scoliosis	skolioza rotacyjna
(foot) inversion	skrecenie (stopy) do wewnatrz
(foot) eversion	skrecenie stopy (na zewnatrz)
metacarpus	srodrecze
metatarsus	srodstopie
ALIF surgery (anterior lumbar interbody fusion)	Stabilizacja ALIF
(wrist) stabilizer/brace	stabilizator (np. nadgarstka)
acromioclavicular joint (AC joint)	staw barkowo-obojczykowy
radiocarpal joint	staw promieniowo-nadgarstkowy
talocrural joint	staw skokowo-goleniowy
temporomandibular joint	staw skroniow-zuchwowy
metacarpophalangeal joints	stawy srodreczno-paliczkowe (klykcie)
tarsus	stęp
red/white zone (of the meniscus)	strefa czerwono-biala (lakotki)
weight-bearing surface (of the condyle)	strefa obciazenia (klykcia)
dorsal side (of the wrist/radiocarpal joint)	strona grzbietowa (tu: nadgarstka)
rozdzielenie palcozrostu	syndactaly release
scapular neck	szyjka lopatki
adjunct (noun) / andjunctive therapy	terapia uzupelniajaca
drawer test	test szuflady
tenderness	tkliwosc (wrazliwosc na dotyk)
fat supression (in MRI scan)	tlumienie tluszczu (typ badania MR)
ganglion / ganglion cyst	torbiel galaretowata (ganglion)
synovial membrane	torebka stawowa
translation of the tibia (relative to)	translacja piszczeli (wzgledem kosci)
patellar retinacula (sng. retinaculum)	troczki rzepki kolanowej
(metatarsal) bone shaft	trzon kosci (srodstopia)
locomotor system	uklad ruchu
persistent pain	utrzymujacy sie bol
annular bulge	uwypuklenie pierscienia wloknistego
cortical bone	warstwa korowa (kosci)
slice thickness (MRI)	warstwa o grubosci (MR)
non ossifying fibroma	włókniak niekostniejący
fibrous cortical defect	włóknisty ubytek korowy
anterior cruciate ligament (ACL)	wiezadlo krzyzowe przednie
collateral fibular ligament	wiezadlo poboczne strzalkowe
posterior longitudinal ligament	wiezadlo podluzne tylne
tibiofibular syndesmosis	wiezozrost piszczelowo-strzalkowy
glenoid cavity (shoulder joint)	wydrazenie stawowe (staw barkowy)
misaligned	wykoslawiony
acromion	wyrostek barkowy
olecranon	wyrostek lokciowy
closed loop (ACL reconstruction)	zaknieta petla (rekonstrukcja ACL)
zalamania blaszek granicznych	fissured/cleft endplates
tendonitis	zapalenie sciegna
inveterate	zastarzaly
intraligamentary injection	zastrzyk miedzywiezadlowy
blurred outlines/contour	zatarte obrysy (stawu)
zdjecie czynnosciowe (rentgen)	functional X-ray
carpal tunnel syndrome	zespol ciesni kanalu nadgarstka
dorsiflexion	zgięcie grzbietowe (stopy)
plantar flexion	zgięcie podeszwowe
reperative granuloma	ziarniniaki naprawcze
compression fracture	zlamanie kompresyjne
intra-articular fracture	zlamanie przezstawowe
depressed fracture (cartilage)	zlamanie wgnieceniowe (chrzastki)
functional changes	zmiany czynnosciowe (kregoslupa)
automated injector	strzykawka automatyczna
electronystagmography	badanie ENG
without referral	bez skierowania
temporal pole	biegun skroniowy
algesia	bolesnosc / czucie bolu
urethra	cewka moczowa
trauma surgery	chirurgia urazowa
prioproceptive sensation	czucie glebokie
Rh factor	czynnik Rh
dBeHL (estimated behavioural hearing level)	szacunkowy poziom slyszalnosci w behawioralnym badaniu sluchu
intramuscular (injection)	domiesniowy (zastrzyk)
thigmesthesia	dotyk (czucie)
fasciculation (of muscles, neurological symptom)	drzenie (miesni, objaw neurologiczny)
dyspnoea	dusznosc
nasolabial folds	faldy nosowo-wargowe
autonomic (involuntary) functions	funkcje odruchowe
generalized anxiety disorder	zaburzenia lekowe uogolnione
fibroadenoma	Gruczolakowłókniak (FA)
hypoechoic	hypoechogenny (np. guzek)
indirect immunofluorescence	immunofluorescencja posrednia
abdominal cavity	jama brzuszna
uvula	jezyczek
nephrolithiasis	kamica nerkowa
palpitation	kolatanie (serca)
hemidiaphragm	kopula (przepony)
ADC (Apparent Diffusion Coefficient) mapping	mapa ADC
necrotic cyst	martwiak
Morgagni hydatid, testicular appendix	przydatek Morgagniego
at the ...... position (breast ultrasound report)	na godzinie.... (przy opisie USG piersi)
perihiral vessels	naczynie odwnekowe
hypermetropia, hyperopia	Nadwzroczność
recurrent furunculosis	nawracajace czyraki
cranial nerve: olfactory (I)	nerw czaszkowy: wechowy (I)
fecal incontinence	nietrzymanie kalu
urinary incontinence	nietrzymanie moczu
Medical practitioner's number	numer statystyczny / PWZ (lekarza)
ESR	OB (w badaniu krwi)
meningeal signs	objawy oponowe
nodular area	obszar guzkowaty
laryngeal reflex	odruch gardlowy
patellar reflex	odruch kolanowy
cremasteric reflex	odruch mosznowy
plantar reflex	odruch podeszwowy
palatal reflex	odruch podniebienny
corneal reflex	odruch rogowkowy
conjunctival reflex	odruch spojowkowy
gag reflex	odruch wymiotny
jaw jerk reflex	odruch zuchwowy
periosteal reflexes	odruchy okostnowe
auscultation	osluch (osluchiwanie)
acute (adverse) drug reaction	ostra reakcja polekowa
visual acuity	ostrość widzenia
alert-pathogens	patogeny alarmowe
audible peristalsis	perystaltyka slyszalna
phaeochromocytoma	guz chromochlonny, feochromocytoma
sub-cortical	podkorowo
soft palate	podniebienie miekkie
deterioration of vision	pogorszenie wzroku
cortical subcortical border zone	pogranicze korowo-podkorowe
ischaemic test for tetany	Proba tezyczkowa
resolved disease	przebyta choroba
turbidity	przejrzystosc (plynu w wynikach badan)
oblique plane (MRI)	przekroj skosny (MR)
retained infantile swallowing	przetrwaly niemowlecy typ polykania
lumbar puncture/spinal tap	punkcja ledzwiowa
diagnostic radiology	radiodiagnostyka
superficial laceration	rana powierzchowna (z naruszeniem skory)
contused wound	rana tluczona
filling the prescription	realizacja recepty
diffuse hepatic steatosis	rozlane sltuszczenie watroby
diffuse hepatic steatosis	rozlane stluszczenie watroby
natural birth	SN silami natury
medical administrator	statystyk medyczny
make diagnosis	stawiac diagnoze
cerebellar fissures	szczeliny mozdzku
bruits/hums	szmery (glowowe)
nuchal rigidity (meningeal sign)	sztywnosc karku (objaw oponowy)
tetany	tężyczka
epidural lipomatosis	tluszczakowatosc nadtwardowkowa
TOF (Time of flight) MRA	TOF Angio RM
tonic labyrinthine reflex (TLR)	toniczny odruch blednikowy (TOB)
gastric contents	tresc pokarmowa
bpm (beats pre minute - unit of heart rate)	u/min (jednostka tetna)
attached	ufiksowana (o nici koncowej)
auditory system	uklad sluchowy
URSL (ureteroscopic lithotripsy)	ureterorenoskopowa litotrypsja
carotid ultrasound imaging/scan	USG tetnic szyjnych
borderline values	wartosci graniczne (np. cisnienia)
to be taken as instructed	wedlug podanego schematu (przyjmowanie leku)
lymph node	wezel chlonny
PT Quick value	wskaznik protrombinowy (w %)
replacement (surgery/procedure)	wszczepienie protezy (zabieg)
exudative oedematous	wysiekowo-obrzekowy
medical history	wywiad epidemiologiczny (na karcie leczenia szpitalnego)
sleep disorder/somnipathy	zaburzenia snu
aspiration	zachlysniecie
vertigo	zawroty glowy
Diagnostic Laboratory	ZDL (Zaklad Diagnostyki Laboratoryjnej)
cystic change/lesion	zmiana torbielowata
barking cough	szczekający kaszel
abscess	ropien
acid reflux	ponowny napływ kwasów żołądkowych
acute care	opieka dorazna
adenoid	migdałek gardłowy / (pot.) trzeci migdał
adrenal gland disorder	zaburzenia nadnercza
air embolism / aeroembolism / gas embolism	zator powietrzny
Ambulatory Care Services Department	ambulatorium
Amniocentesis	Amniopunkcja
Amniocentesis	Amniopunkcja
amniotic fluid	wody plodowe
ankylosing spondylitis	zesztywniające zapalenie stawów kręgosłupa
Antenatal Area	oddział przedporodowy
apnea	bezdech
Are you clammy?	Czy się Pan/Pani poci?
Ściana jamy brzusznej	Abdominal wall
Astigmatism	Astygmatyzm
Atherosclerosis (also known as arteriosclerotic vascular disease or ASVD)	miazdzyca
Attention deficit hyperactivity disorder / ADHD	zespół nadpobudliwości psychoruchowej z deficytem uwagi/ADHD
Autoimmune disease	Choroby autoimmunologiczne
axial (muscular) hypotonia	obniżone napięcie mię�niowe na osi głowa tułów
Bacterial vaginosis	Bakteryjne zapalenie pochwy
bacterial vaginosis	Bakteryjne zapalenie pochwy
BCG - a TB vaccine.	BCG (szczepionka przeciwgruzlicza)
bed sores/pressure sores	odlezyny
benign tumor	lagodny nowotwor
biopolar disorder	Zaburzenia afektywne dwubiegunowe (choroba afektywna dwubiegunowa, ChAD, cyklofrenia.
bone marrow	szpik kostny
Bone Marrow Aspiration	aspiracja szpiku kostnego
brain hemorrhage	wylew krwi do mozgu
breech pregnancy	Położenie miednicowe płodu
Bronchoscopy	Bronchoskopia
bursitis	zapalenie kaletki
C-5 vertebra	kręg c5
Cardiac catheterization	Cewnikowanie serca
Cellulitis	Zapalenie tkanki łącznej
centile	centyl
cervical vertebrae	kregi szyjne
Cholecystitis	Zapalenie pęcherzyka żółciowego
Choroba Kawasakiego	Kawasaki disease, also known as Kawasaki syndrome, lymph node syndrome
Cirrhosis	marskosc watroby
clicky hip	rozwojowa dysplazja stawu biodrowego
cognitive-behavioral therapy (CBT)	terapia poznawczo-behawioralna
colostomy	kolostomia
colostomy	Kolostomia
compression stockings	pończochy przeciwżylakowe
COPD (Chronic Obstructive Pulmonary Disease)	przewlekła obturacyjna choroba płuc
cornea	rogowka
Coronary artery disease	Choroba niedokrwienna serca
cranial nerve	nerw czaszkowy
CT scan	tomografia komputerowa
Curettage	Łyżeczkowanie macicy
cystic fibrosis	zwłóknienie torbielowate, mukowiscydoza
cystitis	zapalenie pęcherza
Disfigurement	zniekształcenie ciała
Diverticulitis	choroba uchylkowa jelit/zapalenie uchylkow
diverticulitis	Zapalenie uchyłków
Diverticulosis	Choroba uchyłkowa jelit
dizzy or lightheaded	masz zawroty głowy lub uczucia omdlenia
Do you have any caps or crowns?	Czy ma/nosi Pan/i koronki na zębach?
duodenal ulcer	wrzód dwunastnicy
duodenal ulcer	wrzód dwunastnicy
tightness in my throat (and chest)	dusi mnie
duty social worker	Dyżurny Pracownik Socjalny
ectopic pregnancy	ciaza pozamaciczna
eczema	egzema
Efekt białego fartucha	White coat hypertension
elastic band	elastyczna taśma
Electroencephalography	Elektroencefalografia
Electroencephalography (EEG)	Elektroencefalografia
Electroencephalography (EEG)	Elektroencefalografia (EEG)
Embolism	zator
emotional wellbeing	dobre samopoczucie psychiczne
exudative pleuritis, pleurisy with effusion	wysiękowe zapalenie opłucnej
Fatty liver	Alkoholowe stłuszczenie wątroby
fecal coliform bacteria	bakterie koli pochodzenia kałowego
flushed	rozpalony
flushed	rozpalony, zarumieniony
folic acid	kwas foliowy
frank gout	pełnoobjawowa dna moczanowa
gallbladder	pęcherzyk żółciowy
Gastroenteritis	Wirusowe zakażenia przewodu pokarmowego
gastroesophageal reflux disease (GERD)	choroba refluksowa przełyku; refluks/odpływ żołądkowo-przełykowy
gastroesophageal reflux disease (GERD)	choroba refluksowa przełyku; refluks/odpływ żołądkowo-przełykowy
Genetic counseling	Poradnictwo genetyczne
gestational diabetes	cukrzyca ciezarnych
Gestational diabetes	Cukrzyca ciężarnych
giddiness	oszolomienie/zawroty glowy
glycemic index	Indeks glikemiczny
GPA - gastro protective agents	leki gastroprotekcyjne( leki oslonowe zoladka)
GTN spray	nitrogliceryna w aerozolu
gullet	przelyk
haemoptysis	krwioplucie
health check	badanie kontrolne
Health Insurance Portability and Accountability Act	Ustawa o przenośności i odpowiedzialności w ubezpieczeniach zdrowotnych
heart murmur	szmer sercowy
heart tracing	EKG
heartburn	zgaga
hematology	hematologia
hiatus hernia or hiatal hernia	Przepuklina rozworu przełykowego
histerografia	histerografia
HPV virus	wirus brodawczaka ludzkiego
Human papillomavirus (HPV)	Wirus brodawczaka ludzkiego
Hysterectomy	Histerektomia
Hysterosalpingography (HSG)	Histerosalpingografia
Ileus	Niedrożność jelit
imminent myocardial infarction/unstable angina /preinfarction angina	stan przedzawalowy
ingrown nail	wrosniety paznokiec
Inguinal hernia	Przepuklina pachwinowa
insulin pen	Pen (wstrzykiwacz insuliny)
Irritable Bowel Syndrome	zespół jelita wrażliwego
labia	wargi sromowe
lipoma	tluszczak
blister	listek ( np. tabletek)
lumpectomy	lumpektomia
lyme disease	bolejroza
Lyme disease	bolejroza
lymph nodes	węzły chłonne
Lymphoma is a type of blood cancer	Chłoniaki
mammography	mammografia
membrane sweep	masaz (szyjki)macicy
meningitis C (vaccination against)	szczepionka przeciwko meningokokom typu C
Metastasis	Przerzut nowotworowy
Mirena coil	wkładka Mirena
motility	motoryka
multiple sclerosis	stwardnienie rozsiane
muscle spasm	skurcz mięśnia
Myoma	Mięśniak
nebulizer	nebulizator / rozpylacz
Neoplasm	nowotwor
nerve conduction study	badanie przewodnictwa newowego/nerwow
nerve conduction study	Elektroneurografia/badanie przewodnictw nerwow
nervous disorder	zaburzenie nerwowe
neuroma	nerwiak
nhs trust	rejonowy zarząd NHS
Nieżyt nosa	Rhinitis /raɪˈnaɪtɪs/
nuchal translucency, NT	Przezierność fałdu karkowego
nystagmus	oczopląs
Nystagmus	Oczopląs
Nystagmus	Oczopląs
obstruction (of the airways)	niedrożność dróg oddechowych
occupational therapist	terapeuta zajęciowy
orthotherapy	ortoterapia
Osteoarthritis	Choroba zwyrodnieniowa stawów
Osteoarthritis	Choroba zwyrodnieniowa stawów
Osteomyelitis	Zapalenie kości i szpiku
Osteoporosis	Osteoporoza
out toeing	rotacja zewnętrzna palców stóp podczas chodu
ovarian cancer	rak jajnika
panendoscopy	panendoskopia
Pectus excavatum (a Latin term meaning hollowed chest)	szewska klatka piersiowa
pediatrician/ paediatrician	pediatra
peptic ulcer	wrzód trawienny
perineum	krocze
ph reading	odczyt ph
Physician-Patient Privilege	Tajemnica lekarska
Plantar Fasciitis	zapalenie powiezi podeszwowej
podiatrist	podiatra
Polycystic kidney disease (PKD or PCKD, also known as polycystic kidney syndrome	Wielotorbielowatość nerek (zwyrodnienie torbielowate nerek,
Polycythemia	Nadkrwistość
pre-eclampsia	stan przedrzucawkowy
primary health condition	schorzenie podstawowe
pulmonary emphysema	rozedma płuc
puncture	punkcja/ naklucie w celach medycznych
rabies	wścieklizna
rabies	wścieklizna
Radiofrequency ablation (RFA)	Ablacja przezskórna
radiograph	radiogram
radiographer	technik rentgenowski
radiographer	technik rentgenowski
respiratory arrest	zatrzymanie akcji oddechowej
Rheumatoid arthritis	Reumatoidalne zapalenie stawów
Rheumatoid arthritis (RA)	Reumatoidalne zapalenie stawów
Rosacea	tradzik rozowaty
safety questions	(podstawowe) pytania mające na celu wyjaśnienie stanu pacjenta
Sarcoidosis	Sarkoidoza, choroba Besniera-Boecka-Schaumanna
sclera/also known as the white of the eye	twardowka
Scleroderma	Twardzina, sklerodermia
sebborheic dermatitis	łojotokowe zapalenie skóry
seizure	wszelkiego rodzaju napady, niekonieczne padaczkowe, mogą być np. objawowe lub w przebiegu gorączki, generalnie po prostu drgawki.
septicemia / blood poisoning	posocznica / septicemia / (pot.) sepsa..
Sickle-cell disease	anemia sierpowata
Sigmoid colon	Esica, okrężnica esowata
Sigmoidoscopy	Sigmoidoskopia
Sigmoidoskopia	Sigmoidoscopy
sinusitis / infection of the nasal sinuses	zapalenie zatok
Sleep apnoea	Zespół bezdechu śródsennego
sleep apnoea	Zespół bezdechu śródsennego
snuffle	sapać
speculum	wziernik
spirometry	spirometria
Spirometry	Spirometria
stent	stent/niewielka sprężynka
Stillbirth	Wewnątrzmaciczne obumarcie płodu
stoma	stomia
stress incontinence	wysiłkowe nietrzymanie moczu
supplement drink	napoj uzupelniajacy diete
swine flu	wirus grypy pochodzacy od swin
szkarlatyna	Scarlet fever (also called scarlatina in older literature)
wing of ilium	talerz biodrowy
tetanus	tezec
The trigeminal nerve	Nerw trójdzielny (twarzY)
Thromboangiitis obliterans (Buerger's disease, Buerger disease [English /bʌrɡər/	Choroba Bürgera, zakrzepowo-zarostowe zapalenie naczyń
thromboembolic disease	zapalenie kosci i szpiku
thromboembolic disease	choroba zatorowo-zakrzepowa
thymus	Grasica
Tinnitus	szum uszny
total parenteral nutrition (TPN)	całkowite żywienie pozajelitowe
toxoplasmosis	toksoplazmoza
Tracheal intubation	Intubacja
tranquilizer	środek odprężający
tremor	Drgawki (konwulsje)
Triage	Triage
trigeminal facial muscle	miesien trojdzielny twarzy
Ulcerative colitis	zapalenie okreznicy jelita grubego
umbilical hernia	PRZEPUKLINA PĘPKOWA
umbilical hernia	PRZEPUKLINA PĘPKOWA
urethra	Cewka moczowa
urticaria	pokrzywka
Uterine atony	Niedowład macicy, atonia (hipotonia) macicy
vaginal speculum	wziernik ginekologiczny
ventricular hypertrophy	przerost ścian komory serca
wheezing	swisty
whooping cough/pertussis	krztusiec
viral myelitis	wirusowe zapalenia rdzenia
wodniak jadra	hydrocele testis
Sensory Processing Disorder	zaburzenia z zakresu integracji sensorycznej bodzcow
stinger	nerwoból/kłucie w barku
Well connected	partnerstwo w zdrowiu
(crossover to) treatment arm	przejście do grupy pacjentów otrzymujacych dany lek
partial denture, (tooth and) gum supported	(Proteza częściowa) osiadająca
(to administer) psychological measures	stosować środki psychologiczne
1. max cordon 2. min cordon	górny (nadciśnienie skurczowe)/dolny (nadciśnienie rozkurczowe) limit ostrzegawczy
accordion manoeuvre	przemienna kompresja i dystrakcja (dociskanie i rozciąganie) ruchomego segmentu
acetylation	acetylacja
Acidosis	zakwaszenie organizmu
Activated B-cell Type Diffuse Large B-cell Lymphoma	DLBCL z aktywowanych komórek B
active carry over prevention management	aktywne zarządzanie zapobieganiem przenoszenia
acute active kidney failure	(podczas ataku) ostrej niewydolności nerek
ACUTE CARE VS CONTINUING CARE	opieka krótkoterminowa/doraźna vs opieka długoterminowa/stała
acute phase inflammation proteins	białka ostrej fazy stanu zapalnego
adherence	przestrzeganie
air helmet	hełm powietrzny
air/water/balloon feeding valve	zawór woda/powietrze do endoskopów
altacet (aluminium acetotartrate )	altacet
altacet (aluminium acetotartrate )	altacet
Alternate Study Phase	alternatywna faza badania /alternatywny etap badania
aluminum based type reaction	niepożadane działania, wywołane przez aluminium (glin)
ambos	kowadełko
amended duty note	orzeczenie zmiany stanowiska pracy/orzeczenie lekarskie o konieczności ...
Amperage Rating	prąd znamionowy/maksymalne natężenie prądu
amplification	wiek pierwszego użycia aparatu słuchowego
an few mobilizations	i dostarczają paliwa do procesów mobilizacji (organizmu)
an increase of 5.5 letters	poprawa ostrości wzroku of 5.5 litery
antibody mediated immunity	odporność z udziałem przeciwciał/humoralna
wide-arch braces	aparaty grubołukowe
Approved Mental Health Professional (AMHP)	uznany przez rząd/licencjonowany pracownik w zakresie zdrowia psychicznego
Are you feeling violent?	Czy posiada Pan/Pani skłonności do zachowań gwałtownych?
Are you on suicide watch?	monitorowanie/obserwacja pacjenta pod kątem myśli i tendencji samobójczych
arterial system	cewnik dotętniczy
attachment system	systemy mocowania protez zębowych
authorisation to test letter	list upoważniający do przystąpienia do egzaminu
autocrine signaling	sygnalizacja autokrynna
patient autonomy	autonomia woli
deblistering machine	łuskarka
righting reflex balance exercises	ćwiczenia wywołujące odruchy równoważne
reinforcing post	ćwiek wzmacniający
muted breath sounds	ściszenie
renal interstitium	śródmiąższ
semi-finished products	śródprodukcja
narcotics/opioid substitutes///narcotic replacement drugs	środki zastępcze
periperal screws	śruby obwodowe
bills for services (rendered) eligible for joint submittal	świadczenia dopuszczone do wspólnego rozliczania
background count	wartość/wielkość tła
backup support / deep-seating	sposób zapobiegania cofaniu się cewnika/głebokie umiejscowenie
bacteria (bacterial) viability microscopy	bakterioskopia przeżyciowa
Ballon	zewnętrzna średnica balonu endoskopowego
shows a barely visible fissure directed/running towards	Bardzo słabo widoczna szczelina, kierująca się do
very weakly delineated	bardzo slabo odgraniczona
base case analysis	analiza podstawowa
base cells	komórki zewnętrzne/otaczające
benefit	świadczenie z tytułu ubezpieczenia zdrowotnego
benefit	korzystny wpływ
bereavement morbidity	ryzyko zachorowania towarzyszące  żałobie
best buys	najbardziej efektywna alokacja zasobow
echo-free interior	bezechowe wnętrze
temporopolar	biegunowo-skroniowy
biology	układ biologiczny
full thickness biopsy (propozycja do weryfikacji w kontekście)	biopsja pełnościenna
blinded observer	obserwator nieświadomy szczegółów badania
blood suction unit	aparat/ssak do odsysania krwi
blood-borne disease	choroby przenoszone przez krew
Blue Print Reading	czytanie rysunków technicznych/szczegółowych planów technicznych
Bodoc sealing washer	pierścień uszczelniający typu Bodok do urządzeń gazowych
Body Substance Isolation procedures	procedury izolacji materiałów biologicznych pochodzenia ludzkiego
body-ecology diet	dieta ekologii ciała
boil	ropień /ropniak
bone orchestrating hormone	hormon wspomagajacy budowę kości
bougie	pręciki
Brain's default mode (network)	standardowy tryb pracy mózgu (sieć )
breast cancer outcome	wynik procesu leczena/postępu choroby raka piersi
breathing (check) valve	(improwizowany) zawór (zwrotny) oddechowy
with cobbly appearance	brukowany
abdomen (belly) firm (to palpation)	brzuch twardy
Bulk density assignment	wyznaczenie wartości gęstości objętościowej
C&S tube	próbka do posiewu moczu i antybiogramu
Cadaver trials	badania na zwłokach
Calamine lotion	płyn kalaminowy/maść kalaminowa
Calcium - calcium and vitamin nutritional powder meal/mix	Calcivit. Wapniowo-witaminowa mączka odżywcza
call point	potencjalny klient/osoba do kontaktu
calorie conversion	przemiana materii/metabolism
calviola mediated endocytosis	endycytoza z udziałem kaweoli
cannabidiol carboxylic acid	kwas kannabidiolowy/kannabidiol karboksylowy
CD 57 positive NK-cells absolute	bezwzględna liczba komórek NK (naturalni zabójcy) z markerem CD57
cell strata	warstwy komórkowe/komórek
center for training in and popularizing method xxxx	centrum rekomendacyjne
Cereblon knockout	pozbawienie genu kodującego białko CBRN (Cereblon)
Charley horse	skurcz mięśni
chaser	(bezpośrednie) przedłużenie schematu dawkowania z fidaksomycyną
chelator-specific orientation range	zakres orientacyjny uwzględniający specyficzną zdolność wiązania (danego) chelatu
chemical cautery	kauteryzacja chemiczna
maintenance chemotherapy	Chemioterapia podtrzymująca
chief resident officer	Dyrektor Administracyjny Szpitala
chip of the bone	pobranie fragmentu kości
I am walking all bent up/bent over.	chodze krzywo
chronic	narażenie długoterminowe było związane z faktem, że
dissociated sensory loss	cięte zaburzenia (czucia)
catheter's shadow projects upon	cień rzutuj się
circulating tumor DNA	krążące DNA nowotworowe
Clean contaminated wound	rana czysta skażona
clicky hip	rozwojowa dysplazja stawu biodrowego
clinical review teaching	wykłady przeglądów klinicznych
clinician	lekarz praktyk
coated on a polyester support	powleczony na poliestrowym podłożu
colonization pressure	częstość/wskaźnik występowania kolonizacji
Color flow jet area	pole/powierzchnia strumienia fali zwrotnej w kolorowym doplerze
communication temptations	„pokusy komunikacyjne
community study of the introduction	badanie środowiskowe wprowadzenia
comparator	procedura porównawcza
complement	dopełniacz
compression vs. compacted vs. pressed tablet	tabletka kompresowana/kompaktowana/sprasowana
conform	zgodny z wymaganiami
Consecutive case series	seria kolejnych przypadków
consiliator	mediator
Contact Patient	skontaktować się z pacjentem
contemporaneous imaging	równoczesne obrazowanie
Control-arm	grupa kontrolna
couche  basale	warstwa podstawna
couche granuleuse	warstwa ziarnista
CP medical	badania lekarskie ws. ochrony dziecka
crippling polio	prowadzące do kalectwa/do niepełnosprawnośc ipolio
cross	przekroczyć
cross-talk between cancer cells	komunikacja (wzajemna) między komórkami nowotworowymi i mikrośrodowiskiem
crushing	przygniatający ból w klatce piersiowej
cryodepleted plasma	osocze z usuniętym krioprecypitatem
cup seating height	wysokość osadzenia panewki
cigarillo	cygarlos cygaretka
cytokine expression pattern	wzór ekspresji cytokiny
the place and time of death/the time and location the body was discovered	czas i miejsce zgonu/znalezienia zwłok
mucus plug	czop ciazowy
support quadrilateral of the feet	czworobok podparcia
denervation	czynność odnerwienna
cooperates in attending to personal hygiene (needs)	czynnosci higieniczne
directions for use (1 tablet a day)	D.S (1x1)
roof of the right atrium	dach przedsionka
the deep reach of the examination	daleki zasięg badania
damage control	ograniczenie ujemnych skutków
Day Surgery Unit	oddział chirurgii jednego dnia
daycase admission	przyjęcie na oddział dzienny
dead volume	objętość martwa
decapitation	oddzielenie główki plemnika od wici
decerebrate movement	odruch wyprostowania, sugerujący odmóżdżenie/reakcje motoryczne wyprostne (objaw  „odmóżdżenia)
definite mitochondrial respiratory chain disorder	wyraźne zaburzenie mitochondrialnego łańcucha oddechowego
deformation in the thigh bone	deformacja w kości udowej
dehiscent wound	rana z rozchodzącymi się brzegami
dental and rx claims	roszczenia refundacji kosztów świadczenia dentystycznego i kosztów leków
disinfection with liquid chemicals	dezynfekcja chemiczna mokra
diagnostic box	kategoria diagnostyczna
nursing diagnosis	diagnoza pielęgniarska
Diffusional Kurtosis Imaging	obrazowanie kurtozy (tensora rozkładu prawdopodobieństwa) dyfuzji
digital infrared camera	cyfrowa kamera termograficzna
discharged under the psychiatric team	został wypisany ze szpitala i przekazany / skierowany pod opiekę psychiatryczną
dizzy or lightheaded	masz zawroty głowy lub uczucia omdlenia
DNA contributor	osoba, od której pochodzi DNA w mieszaninie
below the threshold of pain/up to the threshold of pain	do granicy bólu
positive end-expiratory pressure	dodatnie ciśnienie końcowo-wydechowe
dogged drug resistance	uporczywa oporność na leki
the lower apex of the post-operative wound	dolny biegun (rany pooperacyjnej)
intraforaminal disc protrusion	dootworowa protruzja
ulnar vascularization	dorzecze łokciowe
step-up in oxygen saturation	dorzut tlenowy
double passage of cross-polymerization	podwójny proces polimeryzacji krzyżowej
double skin	podwójna warstwa
double up with pain	zwijać się z bólu
I have an itchy throat/My throat itches.	drapie mnie w gardle/drapanie w gardle
channel drain	dren rynienkowy
secondary pathway	droga poboczna
drug-elutable beads	rozpuszczalny//zdolny do eluowania/eluacji
Drugs midwife	położna ds. ciężarnych narkomanek/położna sprawująca opiekę nad kobietami ciężarnymi uzależnionymi od środków psychoaktywnych
ductus	przewód tętniczy
dull red	ciemnoczerwony
dummy	Próbka ślepa /kontrolna
tightness in my throat (and chest)	dusi mnie
biphasic MRI	dwufazowy (RM)
has beneficial effects on the respiratory system	działanie inhalujące
Parkinson's disease  home diary/Hauser patient diary	dzienniczek Hausera
early stopping for success	wczesne zakończenie badania w wypadku osiągnięcia pozytywnych wyników
echo information	informacja zawarta w odbitych falach ultradźwiękowych
echo at the boundary between	echo na granicy
transthoracic echo procedure peformed outside laboratory setting	echo wyjazdowe przezklatkowe
standardized estimated glomerular filtration rate, using the Schwartz formula (coefficient 0.550)	eGFR stand. wg Schwartza (wsp. 0.550)
Electrode patch	elektroda samoprzylepna
electrographic seizures	napady potwierdzone elektroencefalograficznie bez równoczesnych objawów klinicznych
Embolization area	Nazwa firmy sprzętu stosowanego do embolizacji wewnątrznaczyniowej
Emergency Q-Card	zbiór wskazówek dotyczących postępowania w sytuacjach awaryjnych i bezpośredniego zagrożenia życia
emollient cream	krem nawilżająco-zmiękczający
emotional wellbeing	dobre samopoczucie psychiczne
encephalitic scream	krzyk mózgowy (nieutulony płacz)
endogenous depression	depresja endogenna (ang. endogenous depression)
Endometrial ablation	ablacja endometrium
Endothelium-Derived Nitric Oxide	tlenek azotu pochodzący ze śródbłonka
Enriched Housing	opieka w domowej atmosferze
environmental and social compliance	przestrzeganie norm środowiskowych i spolecznych
S-shaped scoliosis	Esowata skolioza
essay	próbka
eugenics protocol	program eugeniczny/polityka eugeniczna
apparent/visible	ewidentny
exclusion manifold	system zapobiegający jednoczesnemu podawaniu kilku środków znieczulających
excursion studies	badania stabilności od odchyleń/dewiacji
explicit blind	inwentaryzacja podjęta bez dostępu do elektronicznych systemów magazynowych
extended illness bank	bank dotacji  i wypłat dni chorobowych w przypadku chorób długotrwałych
extra-fine	ekstra drobny
extras	no i mamy dodatkowe cząsteczki
face congestion	przekrwienie skóry twarzy
fact-sensitive	uzależnione od faktów
fair hearing line	obsługa telefoniczna do sprawiedliwego rozpatrzenia sprawy
False labor	poród rzekomy/fałszywy
familial clustering	rodzinne występowanie
fascial defect	ubytek powięziowy
phasicity	fazowość
FcγR polymorphisms	polimorfizm FcyR/receptora Fcy
feasibility batch	partia leku przeznaczona na badanie wykonalności
feedback interactions	sprzężenia zwrotne
fibroscan	pomiar stopnia włóknienia wątroby za pomocą urządzenia Fibroscan®
file claims	złożyć wniosek o zwrot kosztów świadczenia medycznego/opieki zdrowotnej
FISH reflex testing	testowanie fluorescencyjnej hybrydyzacji In situ
fixed angle	pod kątem prostym
flexing fatigue point	granica wytrzymałości zmęczeniowej na zginanie
flextion and extension position	pozycja zgięta, pozycja wyprostowana
floppiness of muscles	hipotonia/stan zmniejszonego napięcia mięśni
focal radiation	radioterapia za pomocą zogniskowanej wiązki promieniowania
focused radiotherapy	radioterapia za pomocą zogniskowanej wiązki promieniowania
follow-up	prowadzić działania następcze w odniesieniu do
force-feeding effect	wpychanie na siłę powietrza /nadmierne doładowanie powietrza/
Forceps channel	kanał roboczy do wprowadzania kleszczy endoskopowych
formulary officials	urzędnicy instytucji sporządzających listę leków refundowanych
formulation	preparat
freestanding birthing center	niezależne centrum porodowe/ dom narodzin/ hotel porodowy
mills	frezy
frontline	podatny terapii/leczeniu pierwszej linii
frontline risk-based control	kontrole oparte na wyważeniu/analizie ryzyka w fazie pierwszej
fulfil a vestibular need	potrzeba stymulacji przedsionkowej
functional raw materials	surowce funkcjonalne
functional retraining programme	Program przeszkolenia w zakresie funkcjonowania (fizycznego, psychologicznego, społecznego)
office for medical microscopic diagnostics	Gabinet lekarskiej diagnostyki mikroskopowej
gastric insufflation	żołądkowa insuflacja or żołądkowo-jelitowa insuflacja („wzdęcia żołądka).
gen diet	Dieta ogólna
germinal matrix-intraventricular hemorrhage	krwawienie dokomorowe macierzy zarodkowej
Getting high cholesterol	obniżenie poziomu cholesterolu i opanowanie nadciśnienia
Spine contour gauge	GIBOTORAKOMETR
global health agenda	agenda globalnego zdrowia publicznego
glue ear	wysiękowe zapalenie ucha środkowego
goal-directed sequencing disruption	zaburzenie sekwencjonowania zadań ukierunkowanych na cel (ang. goal-directed sequencing disruption)
gold standard	złoty standard/wzorzec do naśladowania/ najwyższy standard
graded morphogene	morfogen rozmieszczony gradientowo/z gradientem stężenia
graded relationship	stosunek ciągły
graft survival	przeżycie przeszczepu
grain-shaped gauze tampon/tupfer	Groszki
Herpes tonsurans or tinea capitis (hair cropped close down to the skin)	grzybica strzygąca głowy
gut bacteria	flora bakteryjna jelita/mikrobiom
right tibial tuberosity	guzowatość piszczeli prawej
retrograde femoral nail	gwóźdż odkolanowy
haemorrhagic infarction	zawał krwotoczny
hands-on time	czas pracy manualnej
hard  boney  surface	twarda kostna powierzchnia
harshness	ostrość
hatchet flap	płat podskórnie uszypułowany V-Y/płat z wykorzystaniem plastyki V-Y
hydrocodone	HC
heal by secondary intention	gojenie się przez ziarninowanie
healing outcomes research	ocena/badania korzyści zdrowotnych
Health and Human Services Commission	Komisja Zdrowia i Opieki Społecznej
health man doctor	lekarz szarlatan/medycyny naturalnej lub alternatywnej
health reimbursement arrangment	plan zwrotu kosztów medycznych
heel prick test	test Guthriego
height restoration	Przywrócenie wysokości
hemoglobinosis	hemoglobinopatia
high cabinet	szafka wersja wysoka
high tone spasm	hipertonia/nadmierne napięcie o charakterze spastycznym
Highly differentiated flurries	wielce zróżnicowane okresy wysokiej aktywności
hold settings	zachować ustawienia według własnych preferencji
hospital credentialing committee	szpitalny komitet przeglądu i weryfikacji kwalifikacji lekarskich
górnoprzepustowy (ang. high-pass)	HP (skrót na wyniku EEG)
huffing	Natężony wydech
humidification chamber	komora nawilżacza
hyperreactive onchodermatitis	onchocerkozowe zapalenie skóry/sowda
hyperthermia machine/chamber	komora hipertermiczna/urządzenie do terapii hipertermicznej
hypodense region/area	hypodensyjna strefa
ICU	oddział intensywnej terapii/opieki medycznej
immunogenicity (ADA) assessment	ocena (przeciwciała przeciwlekowe) immunogenności
impactor assay	proba udarnosci
implant cases	zabieg implantacji/implantologiczny
implicated in all angles of the cascade	powiązana we wszystkich aspektach/w każdym apekcie kaskady
in keeping	wskazujące na/zgodne z/o charakterze
in other literature	w innych artykułach czasopism naukowych/publikacjach naukowych
in-bleed	wpuszczać/wprowadzać
inboard Viton sleeve o-ring	uszczelka Vitona typu O-ring dla wewnętrznej strony tulei
indefinite survival	długotrwałe przeżycie
Independent Living	oddział  przystosowania do samodzielnego/niezależnego życia
indirect composites	kompozyty pośrednie
induced deflections	poddane różnym ugięciom
inflammatory chemicals	związki chemiczne powodujące stany zapalne
inserts at	przechodzi w danej odległości od
Insulin pump	pompa insulinowa
Insulin pump	pompa insulinowa
insulin receptocides	receptory insuliny
intensive care specialist/doctor  or intensivist	intensywista
internal treatment	brachyterapia
intra abdominal catastrophe	katastrofa brzuszna
inversion and aversion injury	odwracanie i nawracanie w stawie skokowym
Investigations Tests	testy związane z badaniami diagnostycznymi
ischaemic insult to the body	uszkodzenie tkanek dotkniętych procesem niedokrwiennym
roztwór buforowy do płukania pęcherzyków jajnikowych podczas pobierania oocytów	IVF Follicle Flush Buffer
as subsequent therapy	jako kolejna terapia
jet lavage method	płukanie pod strumieniem (wody)
junction of the upper third and the middle two-thirds of the ureter	punkt połączenia/granica górnej i środkowej trzeciej części moczowodu
juxta-cardiac pressure	ciśnienie wewnątrz klatki piersiowej
straitjacket	kaftan bezpieczenstwa
subdeltoid bursa	Kaletka podnaramienna
Clinic X Patient Data (Information) Form/Sheet	karta klienta kliniki X
information repository regarding the location of epidemiological cases/outbreaks/events	kartoteka środowisk epidemiologicznych
specialized medical analyses	katalog badań specjalistycznych
department head/laboratory director	kierownik pracowni vs. kierownik laboratorium
Kinks	zagięcia cewki moczowej
a syringe-body ring/collar//a collar/ring on the syringe barrel	kołnierz korpusu strzykawki
pes valgus	koślawość stóp
agglomeration of intestinal loops	komasacja (pętli jelitowych)
numerous separated (individual) cells	komórki wydzielone
ethics committees	komisje etyczne
with a component of the hernia directed toward the (spinal canal)	komponenta przepukliny skierowanej
radicular-disc conflict	konflikt korzeniowo-tarczowy
M.D. Ph. D. consultation///consultation with a/ medical opinion by a professor of medicine	konsultacja profesorska
high-potency corticosteroid	kortykosteroidy o silnym działaniu
advanced first aid	kwalifikowana pierwsza pomoc
lab dish	in vitro
Label proof	wzór etykiety dla badanego leku
labor support	doula/osoba towarzysząca podczas porodu
medical diagnostics and cytology laboratory	laboratorium analityki medycznej i cytologii
laser point therapy/local laser therapy	laseroterapia punktowa (rehabilitacja)
postural treatment	leczenie ułożeniowe
doctor - inspector in charge of medical certification supervision	lekarz inspektor nadzoru orzecznictwa lekarskiego
lever out moment	(krytyczny) moment siły podważenia/podważającej
numerous osseous defects	liczne ubytki kostne
life therapist	specjalista ds. wsparcia psychicznego dziecka w czasie hospitalizacji
likeability	subiektywne przyjemne efekty/subiektywne pozytywne odczucia
quasisolid or semisolid	lito-płynowy
live period of sickness review	przegląd dotyczący nieprzerwanego okresu choroby
lot-to-lot ranges	zakresy zmienności od partii do partii /zakresy zmienności między partiami
low discriminative power	niska zdolność rozpoznawania
dolnoprzepustowy (ang. low pass)	LP (skrót na wyniku EEG)
loosely cover the field of view	luźno pokrywają pole widzenia
make early connections	tworzyć ważne połączenia synaptyczne we wczesnym dzieciństwie/we wczesnym okresie rozwoju mózgu
manipulation under anesthesia	mobilizacja w znieczuleniu ogólnym
market access specialists	lobbysta na rzecz przyjęcia produktów leczniczych przez krajowe instytycje zdrowia
milliamperes or milliampere-seconds	mAs
ossicular chain	masyw
fatty/greasy stool//steatorrheic stool	mazisty
mechano fusion (surface fusion)	Mechano Fusion (mechaniczna fuzja) (łączenie powierzchniowe)
Meissner's  corpuscle	ciałko dotykowe/Meissnera
memory immunity	pamięć immunologiczna
memory lactocyte	limfocyty pamięci
szczepionka MeNZB	MeNZB vaccine
mercy dollars	dolary na cele charytatywne
metallodrug	lek znany jako metalowiec/lek zawierający nieorganiczne związki platyny i srebra
microbiomes	mikrobiomy
moderately	miernie
non-contact specular microscope	mikroskop sekularny vs. spekularny
with application of microvascular anastomosis	mikrozespolony
mineralized perimeter	stopień zmineralizowania
model gelly head	model głowy z miekkiego plastiku
Vertebral arteries demonstrate/exhibit severe degenerative changes	Modelować się na (nasilonych) zmianach zwyrodnieniowych ( w kont. całego zdania
modular spacer device	modularne urządzenie dystansowe
moulded product	lek uformowany
move along the prescribing continuum	pomoże/pozwoli klientowi zachować ciagłość w przepisywanych lekach
MRCP	Członek Królewskiego Kolegium Lekarskiego (ang. Member of the Royal College of Physicians, MRCP)
Mężczyźni mający kontakty seksualne z mężczyznami	MSM
muscle fires	mięsień się kurczy
muscle gyration	powtarzalne ruchy mięśni
myoephitelial luminal lactocyte	laktocyty luminalne mioepitelialne/nabłonkowe
the stoma should pass through the rectus abdominis muscle	na przebiegu
round epithelial cells	nabłonki kuliste
extramedullary erythropoiesis in cerebellar hemangioblastomas	naczyniak płodowy móżdżku
nutrient vessel/artery	naczynie odżywcze
blood sender	nadawca krwi
supraventricular wandering pacemaker	nadkomorowe wędrowanie rozrusznika
nasty	nieprzyjemnie wyglądająca cera
national health service foundation trust	zespół opieki zdrowotnej o statusie fundacji NHS (Krajowa Służba Zdrowia)
needle crystal	kryształ CsI o strukturze igłowej
the kidneys properly excrete contrasted urine simultaneously	Nerki wydzielają prawidłowo zakonstrastowany mocz jednoczasowo
neuro headbands	opaski stymulujące mózg
neurodevelopmental report	ocena rozwoju neurologicznego
neurodisability paediatrician	N\neurolog dziecięcy i specjalista w zakresie rehabilitacji
neuron loss	utrata komórek nerwowych
neuroscience nurse	pielęgniarka specjalista pielęgniarstwa neurologicznego/pielęgniarka neurologiczna
speech disorders in the type of cognitive aphasia	niedokształcenie mowy o typie afazji percepcyjnej
nipple shield	ochraniacz sutkowy/osłonki laktacyjne/osłonki sutka
low voltage waves	niski woltaż załamków
nitty gritty comb	gęsty grzebień do wyczesywania wszy i gnid Nitty Gritty
no fingernails available for sampling	paznokcie nie zostały udostępnione do analizy
non-syndromic hearing loss	niedosłuch izolowany bez innych współwystępujących objawów
platinum-resistant cancer	nowotwór platyno-oporny
NT control	niedocelowe komórki kontrolne
nutritional deficiency	niedobór witaminy B17 w pożywieniu
NY State of Health	giełda ubezpieczeń zdrowotnych Stanu Nowy Jork
optic disc of well-defined margin against the fundus background	o granicach wyraźnych w poziomie dna
pronounced concave curvature	o pogłębionym łuku
focality/centricity	ośrodkowość
psychological stress factor	Obciążenie psychonerwowe
psychological stress factor	Obciążenie psychonerwowe
skin contours preserved	obrysy skóry zachowane
observational data support switching	dane z badań obserwacyjnych wskazują na zmianę/alternatywny wybór
Observership	staż obserwacyjny
obstruction (of the airways)	niedrożność dróg oddechowych
Acute Spontaneous Epidural Hematoma of the Thoracic Segment of the Spinal Canal	odcinek piersiowy kanału kręgowego
fistula with surrounding inflammatory changes	odczyn przyprzetokowy
densification of vertebral end-plates	odczyny zagęszczające blaszek granicznych trzonów
detachment of stoma/ostomy appliance	odklejenie się sprzętu stomijnego
isolated	odsznurowany
Dehydrated	odwadniany
limited head/neck extension angle	ograniczone odgięcie głowy
limited neck flexion angle	ograniczone przygięcie głowy
limited by pain	ograniczony bólowo
swelling/edema around the ankles	okołokostkowo
prepatellar region	okolica przedrzepkowa
defibrillation recovery time/sensitivity recovery time	okres powrotu czułości
dormant phase	okres wyciszenia
on a continuum	na kontinuum /wzdłuż ciągłej skali
on board	kto jest nosicielem wirusa
on top of standard of care	w dodatku do standardowego leczenia/poza standardowym leczeniem
one cell thick	grubości jednej warstwy komórek nabłonkowych
one hour land	jednogodzinne ćwiczenia na lądzie
Opening in the hair color	zmiana koloru włosów
meningioma of the anterior portion of the craniovertebral junction	oponiak przedniej części pogranicza czaszkowo-szyjnego
orthostatic instability	hipotonia ortostatyczna
orthotherapy	ortoterapia
medical opinion	orzeczenie lekarskie
tunica vaginalis	osłonki jądra
protective inserts	osłony
ellipsoidally-shaped ulceration	oselkowate owrzodzenie
bronchial cough	oskrzelowy kaszel
locked (locked - down) rehabilitation facility	osrodek zamkniety
out of hours doctor	lekarz pracujący w ramach pomocy pozagodzinowej
out of network doctor	lekarz poza siecią firmy ubezpieczeniowej
outcome after treatment	rezultat leczenia
overgrowth	przerost flory bakteryjnej jelita cienkiego/rozrost bakteryjny jelita cienkiego
mutation assessment	oznaczanie
patient under court-ordered treatment	pacjent sądowy
Paddle Lead Elevator	podważka płytki odprowadzenia
pain modulation	modulacja bólu
paired differences between the counts	sparowane różnice pomiędzy liczbami kolonii/różnice pomiędzy sparowanymi liczbami kolonii/
pane in the glass	Gra słów:  pain in the ass - wrzód na tyłku
Papule technique	technika pęcherzykowa
Paramedic	ratownik medyczny
lateral band	pasmo boczne
Szpitalna Skala Niepokoju i Depresji (ang. Hospital Anxiety and Depression Scale)	PASS PSEQ HADS
patent petrochemical medical education	kształcenie medyczne oczywiście promujące chemiczne podejście do leczenia
Patient PMT	płatność  należna od pacjenta
pattern of movements  (of unborn baby)	wzór aktywności ruchowej płodu
a fluid-filled region/a collection of fluid with the dimensions of 10 x 13 x 22 mm	płyn o wymiarach 10 x 13 x 22 mm
platelet-producing megakaryocytes	płytkujący
PBO-subtracted difference	różnica po odjęciu efektu placebo
miednica przeciążeniowa	Pelvis hyperponotica
penetrating trauma	uraz przenikający
penetrating mainly upwards/in upward direction	penetrujące głównie ku górze
Pentose disorder	zaburzenie szlaku pentozofosforanowego
performance model	wersja zaawansowana
peripheral vascular guide wire	prowadnik do naczyń obwodowych
peroxide linkages	wiązania nadtlenkowe
normal bowel sounds	perystaltyka praw.
pharmacokinetic (PK) target attainment	osiągnięcie wymaganych wartości parametrów farmakokinetycznych
phase wrap	zawinięcie fazy
physician executive	lekarz certyfikowany w zarządzaniu podmiotem leczniczym
Physiome	fizjom
PI	numer identyfikacyjny dostawcy usług medycznych//identyfikator lekarza
sandblasting for teeth	piaskowanie zębów
pinch testing	próby ściskania
ping-pong gaze	okresowo zmienne spojrzenie o wysokiej częstotliwości
vertically-integrated pharmaceuticals inspection administration/pharmaceutical inspectorate	pionizacja
pipeline	strumień przetwarzania danych
tylnoboczny (ang. posterolateral, PL)	PL
plasmatic diffusion	dyfuzja do krwi
plastic surgery//Full title: Usage of the pedicled periosteal flap in plastic surgery of the anterior skull base	plastyka
plug	lekko skompresowany czop
mallet	pobijak
atrial pacing	pobudzenia własne użytkownika
respiratory compliance	podatność oddechowa
care recipients	podopieczni stowarzyszenia
therapeutic emergency (room, service) /ambulance	pogotowie terapeutyczne
thickened fluid film	pogrubiały film płynowy
prosthetic area	pole protetyczne
entrance field	pole wlotowe
positive-pressure pump	wolumetryczna pompa infuzyjna
posterior orienting network	sieć orientacyjna
articular surfaces are smooth	powierzchnie stawowe równe
repeats	powtórzenia
gene knockout/inactivation of a gene	pozbawienie genu
lying on the back with all four limbs elevated	pozycja czterokończynowa
Transfusion Medicine Serological Laboratory	Pracownia Serologii Transfuzjologicznej
normal spontaneous vaginal delivery (NSVP)	prawidlowy przebieg (porodu)
emptying flow velocity	prędkość opróżniania
Precipitate delivery	poród przyśpieszony
Preferred provider organization	organizacja ubezpieczeniowa, która podpisała porozumienie z dostawcami usług medycznych na udzielani
premarket submission	złożenie wniosku przed wprowadzeniem na rynek
preparations	preparaty
pressure relief	miękkość siedzenia
presumptive eligibility determinations	ustalenia/oceny domniemanej kwalifikalności/domniemanego spełnienia kryteriów kwalifikacji
primary intention healing	gojenie przez rychłozrost
Procedures of Limited Clinical Effectiveness (PoLCE)	zabiegi o ograniczonej skuteczności klinicznej
progesterone bioidentical	progesteron bio-identyczny
progressive scan playback	odtwarzanie w trybie skanowania progresywnego
projections	wypustki
proliferative advantage	przewaga proliferacyjna
pronator drift	Próba Barre'a- opadanie jednej z rąk podczas badania/niedowład piramidowy
Propulsive Gait	parkinsonowski chód
perpendicular cross-sectional plane	prostopadła płaszczyzna przekroju
Allow patient to bring own food on board.	proszę o własną żywność
diagnostic history	przebieg diagnostyki
the course of anatomical structures	przebieg struktur anatomicznych
intra-articular course	przebieg w zakresie (części śródstawowej)
rebuilt osteons	przebudowane osteony
medial compartment	przedział przyśrodkowy
aerobic metabolism	przemiana tlenowa
boundary flow	przepływ przyścienny
mobile relative to the substrate	przesuwalna względem podłoża
narrowing of the L5-S1 intervertebral/disc space	przewężanie szczeliny
anteflexion / antecurvature	przodozgięcie
public vs. private specificities	społeczna vs. indywidualna specyfika
pulmonary function testing information	informacja z badania czynnościowego płuc
pulse oximetry board	moduł/płytka drukowana dla pulsoksymetrii
push against my finger	wypychaj mój palec
quadruple test	test poczwórny
Risser sign Grade 0	r. 0.
encircling wound	rana okalająca
rasch-built overall disability scale	skala ogólnej niesprawności oparta na podejściu/modelu Rascha
noncontemporaneous/heterochronous	różnoczasowe
re-evacuated	ponownie opróżniony/a
rearrangement	przemieszczanie
recovery time	okres rekonwalescencji
rectal collection device	system odprowadzania kału
reduced carbide	węglik spiekany
reflection period	okres przeznaczony na zastanowienie się
refractory depression	depresja lekooporna /depresja oporna na leczenie
registration censoring rule	reguła wyłączenia z badania z powodu czasu zapisania się na badanie
inpatient rehabilitation	rehabilitacja stacjonarna
physical therapy/(possibly) corrective rehabilitation	Rehabilitacja usprawniająca
medical admissions clerk/receptionist	rejestratorka medyczna
Relapsed breast cancer susceptibility gene (BRCA) Mutated Ovarian Cancer	platynowrażliwy nawrotowy surowiczy rak jajnika z mutacją w genie BRCA podatności na raka piersi
adapter do usuwania implantów	removal adapter
Restorative Dentistry	stomatologia odtwórcza
retail registered dietitian	zarejestrowany dietetyk zatrudniony w sklepie detalicznym
review nurse	pielęgniarka specjalista ds. weryfikacji danych
rim of cervix high up	obwód szyjki macicy wysoko
rod thermometer	termometr pałeczkowy
root pin	wkład/sztyft korzeniowy
mucopyocoele	ropniako-śluzowiak
rough edge	wyszczerbiona krawędź zęba
laxness below the capsule of the knee-joint	rozluźnienie podtorebkowe
family history and clinical analysis/pedigree and clinical analysis	Rozpoznanie rodowodowo-kliniczne
increase in the splanchnic vascular bed size	rozszerzenie trzewnego łożyska naczyniowego
topical solution/topical lotion	roztwór na skórę
intratendinous delamination	rozwarstwienie śródścięgniste
acetabular reamer	rozwiertaki panewkowe
RPA	dyplomowany asystent lekarza/Registered Physician Assistant (RPA)/
patella amenable to medialization procedure	rzepka podatna na próbę medializacji
projection of the apex of lateral malleolus	rzut szczytu kostki bocznej
salk vaccine	szczepionka Salka
sawbone material	modele anatomiczne / modele kości
scalded skin	oparzenia skóry
scar cross-hatching	blizna z krzyżującymi się liniami/składająca się ze skrzyżowanych linii
scarring over liver	bliznowacenie wątroby
staircase deformity	schodkowanie
Schwann cells	komórki Schwanna
scoot/scooting	ślizganie się na pupie/w pozycji siedzącej
wyrównanie poziomu	screeding
Seatability	osadzenie
sedation without mechanical/assisted ventilation	sedacja z zachowaniem własnego oddechu
seeds	SIDS nagła śmierć łóżeczkowa
seek, obtain and consent to all medical procedures	udzielamy X pełnomocnictwo do podejmowania wszelkich decyzji w zakresie opieki medycznej
(spinal) motion segment	segment ruchowy
Senior Pharmacist Production	Starszy Farmaceuta ds. Produkcji
sentinel muscle groups	zespoły mieśni zaatakowane we wstępnej fazie miasteni
sequester	odosobnić/odizolować
serohemorrhagic exudate	surowiczokrwisty wysięk
settings	potencja/stężenie/dawka/proporcja
shearing of the vertebrae	poslizg/przemieszczenie wzgledne
short-ground cannula	kaniula z krótkim skosem
shunt tube	przetoka tętniczo-żylna
fibrous reticulum	siateczki wł.
signalling reward	aktywując/stymulując/pobudzając układ nagrody
Bioresonance Diagnostic Scanner	skaner biorezonansowy
medical records department	składnica akt
skin rolling	wałkowania skóry
skin waves	fałdowanie skóry
Centralized/Consolidated Medical Dispatch Center	Skoncentrowana Dyspozytornia Medyczna
skrót OI	instrukcje operacyjne
sleep apnea machine	aparat CPAP
small gauge wire lead	żyła jednodrutowa o małym przekroju
social boldness	Śmiałość społeczna
social care triage team	zespół klasyfikujący ds. opieki społecznej
specialist in community mental health service	specjalista terapii środowiskowej
spectral fit	dopasowanie charakterystyk spektralnych/dopasowanie widmowe
spiked insulin level	nagły skok poziomu insuliny
splinting	unieruchomienie (kończyny) za pomocą szyny
SplitScreen Cup	pojemnik z automatycznym podziałem pobranych próbek moczu do badań przesiewowych na narkotyki
spongioplasty	spongioplastyka
Sports Lock	mechanizm mocujący Sports Lock
rib springing	sprężynowanie klatki piersiowej
medical residency/ fellowship (U.S)	staż kierunkowy
wheelbarrow exercises for trunk stabilization	stabilizacja tułowia taczka
stacked porcelain	porcelanowa licówka warstwowa
staff physician	lekarz bezpośrednio zatrudniony przez szpital czy klinikę
staghorn stones	kamienie odlewowe
stamp cusp	guzek zęba wchodzący w bruzdę między guzkową
standard of care (SOC) chemotherapy	standardowa chemoterapia/leczenie standardową chemioterapią
hospital station	stanowisko w szpitalu
state effect	wpływ stanu emocjonalnego (ang.  state affect)
place cups on the back	stawiac banki na plecach
stepping status	stopień umiejętności zrobienia kroku
x-ray machine control panel/console	stolik rozdzielczy
strangulated hernia	przepuklina zadzierzgnięta
strength of tablets	zawartość substancji leczniczej w tabletkach/siła tabletek (w mg)
stringy tissue	tkanka o konsystencji włóknistej
sub-optimal implantation	implantacja poniżej optymalnej głębokości
Sublethal cycle	Cykl subletalny
subpapillary network	układ naczyń włosowatych w głębszych warstwach skóry
substrate	podłoże
Sucrose gelatin stabiliser (SGS)	stabilizator sacharozowo-żelatynowy
summation of shadows	sumacja cieni
supranutritional diet	dieta z nadmiarem składników odżywczych
surface induced aggregation	zapobiegania indukowanej powierzchniowo agregacji gelsoliny, powodowanej przez atomizację roztworu
specific IgE food allergy panel	swoiste IgE panel pokarmowy
medical coding for billing purposes	symbolika do rozliczenia
sorrel	szczawa
lateral joint space	szpara boczna
inflexible gastroscope	sztywny wziernik
T-tubule	kanalik T
table clinic	pokaz praktyczny
sedative pills////anti-anxiety pills	tabletki na uspokojenie
wing of ilium	talerz (kości biodrowej)
wing of ilium	talerz biodrowy
tan-grayish	jasnobrązowo-szarawy/szarowaty
ectocervix/vaginal portion of the cervix	tarcza
ectocervix	TARCZA SZYJKI MACICY
basilar tip artery aneurysm//basilar bifurcation aneurism//aneurism at the basilar artery bifurcation	tętniak podziału tętnicy podstawnej
TCB	dzwonić
Pulsed Short Wave Diathermy (PSWD)	terapuls
immunochemiczny test na krew utajoną w kale	Test na spec hem
the doctor Salk polio vaccine	szczepionka doktora Salka/szczepionka doktora Salka przeciw chorobie Heine-Medina
the ductus	przewód tętniczy
Third set of brain circuits	trzeci zestaw obwodów mózgowych
tight-junction proteins	białka budujące złącza typu tight juncton/wchodzące w skład połączeń ścisłych
tip-focused work	umożliwia skupić się na końcówce przyrządu
choristomatous tissue	tkanka odpryskowa
left ventricle posterior wall	TLK
to act out your addiction	nie poddawaj się nałogowi/nie ulegaj nałogom
to be dragged down	(zamiast) wpychać/przepychać (je) na siłę
to be recovered at steady concentrations	stałe stężenia są uzyskiwane/ występują
to come on	Jakie postępy robi Twoje dziecko?
to crown	pojawienie się głowy dziecka w kanale rodnym (ang. crowning)
to deliver the placenta	urodzić łożysko
to express milk	odciągać mleko
to feel bad about yourself	mieć niskie mniemanie o sobie
to hit the nerve	naruszyć nerw
to irritate	podrażniać (ang. irritate)
to leak out	wydzielać
to mouthwash v to gargle	płukanie jamy ustnej vs gardła
to pull into	wciągająć je wewnątrz/do środka
to skew	odchylić/przechylić/skierować w stronę
to take up shop	zadomowiły się
to zip up	przyczepiać się do/łączy się
to zip up	wywołują u noworodka pozytywny stres, przygotowujący go do życia poza macicą.
pattern of breathing	tor oddychania
visual track	tor wizyjny
Total Neuropathy Score nurse [TNSn]	narzędzie do całkowitej oceny neuropatii obwodowej wywołanej przez chemioterapię (ang. TNSn)
tracking	przyśpieszony tryb oceny nowych leków (ang. fast-tracking)
trailing injections	iniekcje podskórne ciągłe z wycofaniem igły
training experiment	technika/metoda seryjnych (wielokrotnych) rozcieńczeń (Listera)
transition	zmiany w otoczeniu/otoczenia//zmiany
treatment algorithm	algorytm postępowania leczniczego
tri-extrusion	rurka trójwarstwowa
truncal hypotonia	hipotonia tułowia
tubular padding	rękaw podgipsowy
tubular protein	białko kanalikowe
tubular thyroidization	obraz tarczycopodobny nerki
twisting of trachea	przesunięcie tchawicy
cavitary defect	ubytek jamisty
tilting bowls	uchylne miski
presses upon/compresses	uciskać
with negative compression sonography	Uciskowo ujemny
capacity for higher-level emotions, higher emotions	uczuciowość wyższa
delayed onset allergy	Uczulenie typu późnego
energy contribution from carbohydrates	udział energii z węglowodanów
Universal Exercise Unit	UGUL, uniwersalny gabinet usprawniania leczniczego
UK Virus Reference Laboratory	Laboratorium Referencyjne UK ( Zjednoczonego Królewstwa) ds. Wirusów/brytyjskie laboratorium referencyjne ds. wirusów
maxillary and mandibular teeth	układ zębowo-zębowy
solid and perivascular systems	układy lite i okołonaczyniowe
under key (anarchy)	anarchia
unhygienic aerosol	aerozol szkodliwy dla zdrowia
Traffic accident	uraz komunikacyjny
multiple injuries to the same organ and injuries to multiple organs	uraz wielomiejscowy i wielonarządowy
urine absorbing aids	środki pomocnicze wchłaniające mocz
urine comby control	dwupoziomowy wzorzec do kontroli testów paskowych moczu Urine Comby Control
removal of lateral recess stenosis	usunięcie cieśni zachyłkowej
removal of a bile duct (gall)stone	usunięcie kaminia z dróg żółciowych
bulging fontanelle	uwypuklenia ciemiączka
early effectiveness of treatment was obtained/achieved	uzyskano wczesną skuteczność zabiegu
Vacuum Break Tool	urządzenie do spowodowania nagłego spadku/nagłej utraty próżni
wersja ekonomiczna	value model
przyczepność do śródbłonka naczyniowego	vascular endothelial adhesiveness
vascular integrity	integralności naczyń krwionośnych
venous bullet embolus/embolism	zator żyłny spowodowany kulą
vial	fiolka
visual organization	organizacja wzrokowa/percepcyjna
visual spatial awareness	orientacja przestrzenno-wzrokowa//wzrokowa orientacja przestrzenna
volume rendered reconstruction	rekonstrukcja objętościowa
Examination revealed pain..	w badaniu
unloaded abduction	w odciążeniu
in retroflexion	w optyce zwrotnej
with slice thickness of 2.5 mm/with 2.5 mm slice thickness	w warstwach
medical advice by a visiting doctor/by a doctor making a house call/community doctor	w warunkach środowiskowych
wall-impinging	uderzające w ścianę
intrinsic /specific variation	wariancja swoista
Wash phosphate buffered solution (WPBS)	czyszczący roztwór buforowany fosforanami
water venturi	zwężka Venturiego zasilana wodą
intrasalivary lymph nodes	węzły chłonne śródśliniankowe
wee and poo	siusiu i kupkę
welfare of the child	formularz odnośnie kwalifikacji pacjenta pod względem zapewnienia dobra przyszłego dziecka
wellness program	program promocji zdrowia w miejscu pracy
Vestibular tipping	westibulotruzje
wet read	wstępna interpretacja wyników
whip arm	pulpit stomatologiczny z ramieniem wychylnym
częstotliwość filtra środkowozaporowego	WI. (skrót na wyniku EEG)
wide-field radiotherapy	radioterapia techniką szerokiego pola
Widening posterior fracture	z rozszerzającym się tylnym złamaniem
apex (apices) of capillaries	wierzchołek włośniczki/naczynia włosowatego
arm and leg whirlpool/whirlpool for arms and legs	wirówki do rąk i nóg
with novel pacing vector	z innowacyjnym wektorem stymulacji
with promotion	umożliwiający rozwój ... zakażeń
root crown insert (post and core)	wkład koronowo-korzeniowy
pulp chamber bleaching agent	wkładki dokomorowe
laryngeal injection	wlewka krtaniowa
penetration of x above the change/lesion	wnikanie nad zmianę
hydrogen arsenate	wodoroarsenowy
working from behind	przyjmując pozycję  z tyłu głowy pacjenta
eliminate/excrete	wydalać
electrocoagulation	wypalanka
disconnecting	Wypięcie
exert mass effect	wywierać efekt masy
urethrocystic speculum	wziernik cewkowo-pęcherzowy
endoscope of Hippocrates	wziernik Hipokratesa
x months of correct age	x miesięcy skorygowanego wieku
yield acid	kwasy żółciowe
Your eyes are flicking.	Twoje oczy/gałki oczne drgają/wahają się rytmicznie.
normal vascular pattern	z prawidłowym rysunkiem naczyniowym
per tooth	za punkt
static disorders of the spine	Zaburzenia statyki kręgosłupa
Sensory Processing Disorder	zaburzenia z zakresu integracji sensorycznej bodzcow
lateral recess of the spinal canal	zachyłek kanału kręgowego
both kidneys concentrate urine simultaneously	zagęszczanie jednoczasowe
suppression/inhibition of the hypothalamic-pituitary-adrenal (HPA) axis activity	zahamowanie czynności osi podwzgórze-przysadka- nadnercza
metastasis to the lungs from the primary prostate cancer	zajęcie organu przez rak
inflammation of the upper duodenal knee	zapalenie kolanka górnego dwunastnicy
resting record	zapis spoczynkowy
prevention of/prevent the life-threatening condition from becoming worse	zapobiegnięcie nasileniu się zagrożenia życia
change management	zarządzanie zmianą
(iliac and) obturator (lymph nodes)	zasłonowe
tilting disc valve	zastawka uchylno-dyskowa
blurred (external) outlines	zatarte zarysy zewnętrzne
Paranasal sinus	zatoka oboczna nosa
cervical stump suspension	Zawieszenie kikuta szyjki
staghorn stone	złóg odlewowy
torn adhesion	zerwany zrost
buccolingual syndrome	zespół policzkowo-językowy
compression anastomosis of shin tibiofibular syndesmosis with a screw	zespolenie dociskowe więzozrostu strzałkowo-piszczelowego goleni wkrętem
combined/cumulative record	zestawienia łączne
External neurological symptoms of a sciatica attack (an attack if sciatica)	zewnętrzne objawy neurologiczne ataku rwy kulszowej
confluent rash	zlewna wysypka
epileptiform abnormalities seen in EEG	zmiany padaczkopodobne w EEG
changes in the plan view of the submandibular salivary glands	zmiany w rzucie ślinianek podżuchwowych
flat rate/lump sum	Zskrót \R\ w zaleceniach leków
stability and compactness	zwartość
capped	zwieczkowany
abduction	odwodzenie
abutment	filar (stomatologiczny)
acetabular	panewkowy
acetabulum	panewka stawu biodrowego
acromioclavicular	barkowo-obojczykowy
adduction	przywodzenie
anterposterior (AP)	[pozycja] przednio-tylna (AP)
apophyseal	odrostkowy [dotyczący odrostka]
appendage	kończyna
articular	stawowy
articular cartillage	chrząstka stawowa
articulation	staw/ połączenie przegubowe
avascular necrosis	jałowa martwica kości
avulsion	wyrwanie/oderwanie
body of sternum	trzon mostka
cancellous bone	kość gąbczasta
carpals	kości nadgarstka
Closed Reduction Internal Fixation	zamknięte nastawienie ze stabilizacją wewnętrzną
comminuted fracture	złamanie drobnoodłamowe kości, złamanie wieloodłamkowe/wieloodłamowe
compression fracture	złamanie kompresyjne
compromise	osłabienie/niewydolność
condylar	kłykciowy
congenital fusion	zrost wrodzony
consent	zgoda
costal cartilage	chrząstka żebrowa
cranial bones	kości czaszki
CRIF	zamknięte nastawienie ze stabilizacją wewnętrzną
cruciate	krzyżowy
cruciate ligament	więzadło krzyżowe
dehiscence	rozstęp rany
depression	opust ramion
diaphysis	trzon kości długiej
distal epiphysis	nasada kości dalsza
dorsal decubitus	[pozycja] leżąca na grzbiecie, projekcja promieniem poziomym
dorsiflexion	zgięcie grzbietowe (prostowanie)
doubling time (of bacteria)	czas podwojenia populacji (bakterii)
edentulous	bezzębny
elevation	wznos ramion
ethmoid bone	kość sitowa
ethmoidal sinuses	zatoki sitowe
eversion	nawracanie (pronacja/ewersja)
exsanguination	wykrwawienie/ skrwawienie/ anemizacja
extension	wyprost
external fixator	stabilizator zewnętrzny
extremity	kończyna
false ribs	żebra rzekome
fixator	stabilizator
flexion	zgięcie
floating ribs	żebra wolne
follow-up	katamneza (badanie katamnestyczne)
frontal sinuses	zatoki czołowe
heterotopic	heterotopowy
HOB	osteoblast ludzki
hospital disinfectant	Środek dezynfekujący
iatrogenic	jatrogenny
in extremis	w obliczu śmierci/na skraju śmierci
informed consent	świadoma zgoda
infra-syndesmotic	podwięzadłowy
internal fixator	stabilizator wewnętrzny
intertrochanteric	międzykrętarzowy
intraluminal filling defect	ubytek/brak zakontrastowania/wypełnienia światła (przewodu)
inversion	odwracanie (supinacja/inwersja)
ipsilateral	po tej samej stronie
ischaemia	niedokrwienie/ (miejscowa) anemizacja
joint	staw/ połączenie przegubowe
lateral	[pozycja] boczna
lateral decubitus	[pozycja] leżąca na boku, projekcja promieniem poziomym
lateral mass screws	śruby do masywów bocznych
left anterior oblique (LAO)	[pozycja] przednia skośna lewa (LAO)
left lateral	[pozycja] lewoboczna
left posterior oblique (LAO)	[pozycja] tylna skośna lewa (LAO)
LISS	małoinwazyjny system stabilizacji
live/dead staining	barwienie przyżyciowe
long leg splint	szyna udowo-podudziowa
malleolus	kostka nogi
manubrium	rękojeść
maxillary sinus	zatoki szczękowe
medulla	jama szpikowa
medullary cavity	jama szpikowa
metacarpals	kości śródręcza
metaphyseal	przynasadowy
metaphysial	przynasadowy
metatarsals	kości śródstopia
midshaft	środkowa część trzonu kości
multiple organ dysfunction syndrome	stan niewydolności wielonarządowej
nasal bones	kości nosowe
nutrient artery	tętnica odżywcza
oblique	[pozycja] skośna
opposition	opozycja
ORIF	otwarte nastawienie ze stabilizacją wewnętrzną
ossification	kostnienie
paranasal sinuses	zatoki przynosowe
parenchymatous	miąższowy
parenchymatous cell	komórka miąższowa
patella alta	rzepka ustawiona wysoko/wysokie ustawienie rzepki
patella baja	rzepka ustawiona nisko/niskie ustawienie rzepki
patellar	rzepkowy
PBS	sól fizjologiczna buforowana fosforanami
pelvic ring	pierścień miedniczny
peri-implant	okołowszczepowy
peri-implant infection	infekcja okołowszczepowa
peri-implantitis	zapalenie tkanki okołowszczepowej
periosteum	okostna
periprosthetic	okołoprotezowy
peroneal	strzałkowy [dotyczący kości strzałkowej]
pertrochanteric	przezkrętarzowy
phalanges	paliczki
phosphate-buffered saline	sól fizjologiczna buforowana fosforanami
placebo therapy	terapia pozorowana/pozorna
plantar flexion	zgięcie podeszwowe (zgięcie)
plating	łączenie odłamów kości płytką
posteroanterior (PA)	[pozycja] tylno-przednia (PA)
pressure sores	odleżyny
pronation	nawracanie
reinforced graft/prosthesis	proteza zbrojona
protrusion (of jaw at temporomandibular joints)	wysuwanie żuchwy w stawach szczękowo-żuchwowych
proximal epiphysis	nasada kości bliższa
radicular	korzeniowy (dot. kręgosłupa)
reposition	repozycja
reticuloendothelial	siateczkowo-śródbłonkowy
reticuloendothelial system	układ siateczkowo-śródbłonkowy
reticuloendothelium	układ siateczkowo-śródbłonkowy
retropatellar	zarzepkowy
retrusion (of jaw at temporomandibular joints)	cofanie żuchwy w stawach szczękowo-żuchwowych
right anterior oblique (RAO)	[pozycja] przednia skośna prawa (RAO)
right lateral	[pozycja] prawoboczna
right posterior oblique (RAO)	[pozycja] tylna skośna prawa (RAO)
rotation	rotacja
sanitizer	środek odkażająco-czyszczący
severe obesity	otyłość kliniczna
sham therapy	terapia pozorowana/pozorna
sphenoid bone	kość klinowa
sphenoidal sinus	zatoki klinowe
splint	szyna
spongy bone	kość gąbczasta
staining	barwienie
subcapital	podgłowowy
subcapital fracture of a metacarpal bone	złamanie podgłowowe kości śródstopia
subtrochanteric	podkrętarzowy
supination	odwracanie
supra-syndesmotic	nadwięzadłowy
symphysis pubis	spojenie łonowe
syndesmosis	więzozrost
syndesmotic	więzadłowy
synostosis	kościozrost
tarsals	kości stępu
thorax	klatka piersiowa
throat packing	pakowanie/tamponowanie gardła
trabecular bone	kość gąbczasta
trans-syndesmotic	przezwięzadłowy
transcervical	przezszyjkowy
true ribs	żebra prawdziwe
tubercle	guzek
tuberosity	guzowatość
uncovertebral joint	staw haczykowato-kręgowy
valgus	koślawy
varus	szpotawy
ventral decubitus	[pozycja] leżąca na brzuchu, projekcja promieniem poziomym
vertebral column	kręgosłup
vital staining	barwienie przyżyciowe
vomer	lemiesz
(nonadhesive) skin traction	wyciąg kamaszkowy
xiphoid	wyrostek mieczykowaty
pusher syndrome	zespół odpychania stronnego
[child] assent	zgoda/przyzwolenie [małoletniego]
