2-dimensional echocardiography	2-dimenziós echocardiographia
2-dimensional echocardiography	2-dimenziós echocardiographia
absorbable sutures	felszívódó varratok
acceptability	elfogadhatóság
active comparator	aktív összehasonlító készítmény
adrenal cortex	mellékvese-kéreg
adrenal glands	mellékvesék
adverse	kedvezőtlen
adverse cardiac effects	nem kívánatos cardialis mellékhatás
adverse event	nem kívánatos esemény
adverse reaction	nem kívánatos esemény
afterload	utóterhelés
agent	hatóanyag, szer
alertness	éberség
all-cause death	bármely okból bekövetkező halál
altered mental status	megváltozott mentális státus
amount of relapse	recidivák száma
analysis	elemzés
ancillary activity	mellékes hatás
antianginal	antianginás
anxiety	szorongás
aphasia	beszédzavar
aqueous humour	csarnokvíz
atelectatic	atelectasiás
atheroma plaque	atheromás plakk
atrial flutter	pitvarlebegés
attenuation	semlegesítés
autonomic instability	vegetatív instabilitás
background therapy	kiegészítő terápia
basal respiration	alaplégzés
basal respiration	alaplégzés
baseline value	alapérték
baseline value	alapérték
beats per minute	ütés/perc
become more expressed	kifejezettebbé válik
benefit	haszon
bid	naponta kétszer
bilateral flap	kétoldali lebeny
bile duct	epeutak
borderline hypertension	határérték hypertonia
both sides	mindkét oldal
broth agar	húsleves agar
candidant genes	kandidáns gének
cannula	kanül
cardiac arrest	szívmegállás
cardiac care unit	coronaria őrző
cardiac output	cardiac output
cardiogenic shock	cardiogen shock
care map	ellátási térkép
case control study	esetkontroll-vizsgálat
case summary	epikrízis
cerebrovascular accident	cerebrovascularis esemény
checkup	kivizsgálás
chronic heart failure	krónikus szívelégtelenség
circulatory failure	keringési elégtelenség
clinical deterioration	klinikai rosszabbodás
clinical practice standard	klinikai gyakorlati standard
clinical relevance	klinikai jelentőség
clinical settings	klinikai elrendezés
clinical status	klinikai állapot
coarse respiration	érdes légzés
cohort study	követéses vizsgálat
colon and rectal cancer	vastag- és végbélrák
community acquired pneumonia	területen szerzett pneumonia
compliance	compliance
complication	szövődmény
component study	résztanulmány
composite end point	kombinált végpont
concentration ability	koncentrálóképesség
conclusion	összefoglalás
concomitant illness	kísérő betegség
concomitant treatment	párhuzamos kezelés
cone light reflex of the eardrum	dobhártya fénykúpreflexe
confidence interval	konfidencia intervallum
congestion	vértolulás
congestive heart failure	szívelégtelenség
connective tissue structure of sg	kötőszövetes struktúrája vminek
contractile performance	kontraktilis teljesítmény
conventional wisdom	általános vélekedés
coronary aretry bypass graft (CABG)	koszorúér bypass műtét
coronary artery disease	koszorúér-betegség
coronary flow	coronaria-áramlás
coronary heart disease	coronaria betegség
corresponding author	levelező szerző
counter-regulation	ellenreguláció
cultivatable bacteria	kitenyészthető baktériumok
cuticle tissue	hámszövet
cuticular border	cuticulaszegély
data on file	belsô adatbázisban megtalálható információ
data point	adatpont
data point	adatpont
decline	hanyatlás
Department of Otorhinolaryngology	Fül-Orr-Gége Osztály
design	elrendezés, felépítés
discharge summary	zárójelentés
discharging fistula	váladékozó sipoly
discontinuation rate	megszakítási arány
discussion	megbeszélés
disease management program	betegségkezelési program
disease stadium	betegség stádiuma
dose range	dózis tartomány
dose-finding study	dóziskereső vizsgálat
dose-ranging study	dózis-hatás összefüggést vizsgáló, dózistartományt meghatározó tanulmány
dose-relatedness	dózisfüggőség
dose-response curve	dózis-hatás görbe
dosing regimen	dozírozási protokoll
earway	hallójárat
echopoor	echoszegény
efficacy	hatásosság
efficiency	hatékonyság
ejection fraction	ejekciós frakció
eliminated unchanged	változatlan formában ürül
emergency care	sürgősségi betegellátás
entry criteria	beválasztási kritériumok
epileptic center	epilepsziás góc
European Medicines Evaluation Agency	Európai Gyógyszerügynökség
event-free survival	eseménymentes túlélés
evidence-based	bizonyítékokon alapuló
fatigue	kimerültség
FDA	Élelmiszerügyi és Gyógyszerügyi Hivatal
filling pressure	telődési nyomás
filling pressure	töltőnyomás
film-coated tablet	filmtabletta
Fisher exact test	Fisher-féle egzakt próba
fixed dose combination	fix dózisú kombináció
fluidised bed	fluidizációs ágy
foam cell	habsejt
follocle	tüsző
follow-up time	követési idő
forced expiratory volume	erőltetett kilégzési térfogat
forgetfulness	feledékenység
formulation	formuláció
general condition	általános állapot
geriatric use	használat idős betegekben
glandular tissue	mirigyállomány
global assessment	általános értékelés
good clinical practice	helyes klinikai gyakorlat
granulation tissue	sarjszövet
half-life	felezési idő
hazard ratio	kockázati arány
heart attack	szívroham
heart failure	szívelégtelenség
heart murmur	szívzörej
heart sounds	szívhangok
heart-diaphragm angle	szív-rekesz szöglet
hemodynamic effect	hemodinamikai hatás
hepatic impairment	májbetegség
hibernating myocardium	hibernált myocardium
high-risk	magas kockázatú
high-risk patient	magas rizikójú beteg
histological cut	szövettani metszet
home nursing	otthoni ápolás
homeostasis model assessment	homeosztázismodell értékelés
hospital admission	kórházi felvétel
hospital setting	kórházi elrendezés
hospital-based	fekvőbeteg ellátáson alapuló
hyperthermic intraperitoneal chemotherapy	hyperthermiás intraperitoneális kemoterápia
iatrogenic	iatrogén
impairment	károsodás
incidence	előfordulás gyakorisága
incipient shock	kezdődő shock
incision direction	metszésvezetés
indices	mérőszám
inflammation ceased	gyulladás megszűnt
inpatient	fekvőbeteg
insertion of muscle	izom tapadása
insulin sensitivity	inzulinérzékenység
intensive care unit	intenzív osztály
intention-to-treat	beválasztás szerinti elv
internist	belgyógyász
irregular meals	rendszeretlen étkezés
ischemic episode	ischaemiás epizód
ischial tuberosity	ülőgumó
juvenile patients	fiatalkorú betegek
lactate	laktát
laryngeal mucosa	gége-nyálkahártya
last observation carried forward (LOCF)	utolsó megfigyelésnél mért adatok
lateral aspect of the thigh	comb oldalsó felszíne
loss of consciousness	eszméletvesztés
low air loss bed	alacsony levegőveszteségű légágy
low air loss bed	alacsony levegőveszteségű légágy
lymph node	nyirokcsomó
lymphatic gland	nyirokcsomó
lysosomal	lizoszomális
major adverse cardiac event	nagy nem kívánatos cardialis esemény
major/minor poliomyelitis	súlyos/enyhe poliomyelitis
mean daily dose	átlagos napi adag
mean plasma clearance	átlagos plazmaclearance
median survival	átlagos túlélés
medical history	anamnézis
medical regimen	kezelési protokoll
metabolic balance	anyagcsere-egyensúly
minute volume	perctérfogat
MRI (magnetic resonance imaging)	MRI (mágneses rezonancia)
mucosal villi	bélbolyhok
mucous membrane	nyálkahártya
muscle rigidity	izommerevség
muscle wound	izomseb
myocardial infarct	myocardialis infarctus
myocardium stunning	kábult myocardium
natural history	természetes lefolyás
nausea	émelygés
nested case-control	csoportosított eset-kontroll
neurohormonal activation	neurohormonális aktiváció
new-onset	újonnan felfedezett
nitric oxide	nitrogén-oxid
non-ischemic	non-ischaemiás
nonfatal	nem fatális
nonspecific minor illness	nem specifikus kisebb betegség
nonspecific minor illness	enyhébb, jellegtelen tünetek
nonsporing bacteria	spórát nem képző baktériumok
observational study	megfigyeléses vizsgálat
od	naponta egyszer
odds ratio	esélyhányados, valószínűségi arányszám
oesophageal cancer	nyelőcső-rák
open-label	nyílt elrendezésű
operating table	műtőasztal
operating time	műtéti idő
oral antidiabetic drug	orális antidiabetikus gyógyszerkészítmény
outpatient	járóbeteg
ovarian cancer	petefészek-rák
pancreatic cancer	hasnyálmirigy rák
parallel-group trial	párhuzamos csoportos vizsgálat
pathologic lesion	patológiás képlet
pathway	folyamat
patient compliance	beteg együttműködése
peak plasma concentration	csúcs plazmakoncentráció
Pearson χ2 test	Pearson-féle χ2-próba
perception problem	érzékzavar
percutaneous transluminal coronary angioplasty	percutan transluminalis coronaria angioplastica
pharyngeal mucosa	garat-nyálkahártya
physicians directions	orvos utasításai
pilot phase	kísérleti fázis
pleuritic	mellhártya-gyulladásra emlékeztető
plot	grafikon
point estimation	pontbecslés
positron emission tomography	pozitron emissziós tomográfia
post hoc	post hoc
posterior sinus	hátsó sinus
predispose	prediszponál
preload	előterhelés
prescribing information	alkalmazási előirat
prevalence	gyakoriság
primary care physician	sürgősségi ellátóorvos
primary diagnosis	elsődleges diagnózis
principal investigator	vizsgálatvezető
private docent	egyetemi magántanár
prone position	hason fekvő helyzet
prospective study	prospektív vizsgálat
pulmonary wedge pressure	pulmonalis éknyomás
pyruvate dehydrogenase	pyruvát dehidrogenáz
qd	naponta
qid	naponta négyszer
qualification	fenntartás
qualify for sick pay	táppénzre jogosít
quantitative	quantitatív
radionuclide ventriculography	radionuclid ventriculographia
randomization	véletlen besorolás
reflected wave	visszavert hullám
regional wall motion	regionális falmozgás
regurgitant jet	regurgitációs \jet\
relapse ratio	recidiva-arány
renal impairment	vesebetegség
renal impairment	vesekárosodás
reperfusion	reperfusio
retard tablets	retard tabletta
right apical lobe of the lung	tüdő jobb csúcslebenye
risk stratification	rizikó stratifikáció
run-in-phase	bevezető fázis
safety	biztonság
safety desk	biztonsági bizottság
sarcoplasmic reticulum	sarcoplasmas reticulum
satisfactory general condition	kielégítő általános állapot
scarring	hegesedés
scientific validity	tudományos érvényesség
screening period	ellenőrző fázis
secunder prevention measure	szekunder prevenciós intézkedés
serous membrane	savóshártya
single-center	egy centrumból származó
skin flap	bőrlebeny
skin grafting	bőrátültetés
skipping meals	étkezések kihagyása
sleep problem	alvászavar
sleepiness	aluszékonyság
slow dissolving	lassú kioldódású
speaking problem	beszédzavar
specialization exam	szakvizsga
spore-building bacteria	spórás baktériumok
stage classification	stádium besorolás
stagnation	pangás
standard of care	ellátási standard
stratification	besorolás
stroke volume	verőtérfogat
study arm	vizsgálati ág
study center	vizsgálati központ
study coordinator	vizsgálati koordinátor
suction drain	szívó drain
sudden death	hirtelen halál
summary of product characteristics	termékjellemzők összefoglalója
supine position	háton fekvő helyzet
surgical indication	műtéti indikáció
surgical plan	műtéti terv
syncope	átmeneti eszméletvesztés
systemic lupus erythematosus (SLE)	systemás lupus erythematodes
testicular cancer	hererák
therapeutic aid	gyógyászati segédeszköz
thoracic CT examination	mellkasi CT vizsgálat
tid	naponta háromszor
TLR (target lesion revascularization)	cél-lézió revaszkularizáció
tongue root	nyelvgyök
treadmill	futópad
treat adequately	adekvát módon ellátni
treatment gap	kezelési hiányosság
treatment rate	kezelési arány
trochanter	tompor
tympanic membrane	dobhártya
under strict medical control	szigorú orvosi ellenőrzés mellett
unilateral flap	egyoldali lebeny
unscheduled visit	váratlan látogatás
usual care	szokásos ellátás
vagal withdrawal	vagushatás megszűnése
vertigo	szédülés
vision problem	látászavar
volume status	folyadékháztartási állapot
volume-depleted	volumenhiányos
vomiting	hányás
wall motion	falmozgás
wall motion score index	falmozgás index
ward physician	osztályos orvos
well-refereed	jól referált
Wilcoxon rank sum test	Wilcoxon rangösszeg próba
with minimal risk involved	minimális kockázattal
withdrawal rate	megszakítási arány
woud dehiscence	sebszétnyílás
wound edge detachment	sebszél szétválás
wound exploration	sebfeltárás
wound healing by secondary intention	másodlagos sebgyógyulás
wound infection	sebfertőzés
written informed consent	írásos beleegyező nyilatkozat
-algia	-fájdalom, -algia, -dynia
-cele	-sérv, -kele
-cyte	-sejt, -cita, -cyta
-dynia	-fájdalom, -algia, -dynia
-ectomy	-ectomia, sebészeti kivágás
-speech	-lália, -beszéd
-speech	-lália, -beszéd
-stones	-lithiasis, -kövek
-stones	-lithiasis, -kövek
-tomy	-metszés, -tómia
-tomy	-metszés, -tómia
-vision	-látás, -opsia
-vision	-látás, -opsia
AAA	abdominal aortic aneurysm,
abarognosis	abarognózis,
abdomen	abdomen,
abdominal	abdominális,
abdominal cavity	hasüreg, cavum abdominis
abdominal typhus	hastífusz, typhus abdominalis
abdominal wall	hasfal
abdominocentesis	abdominocentesis,
abduction	abdukció,
abductor	távolító, abducens
abesence	hiány, valami hiánya
abia	labia, ajkak
ablation	ablatio,
abnormal	rendellenes
abnormal glucose tolerance test	lásd: abnormal, lásd: glucose tolerance test
aboral	aborális,
abortion	vetélés, abortusz
above-	szuper-, super-, felett-
abrasion	abrázió,
absces	abscessus,
absolute neutrophil count	A.N.C., abszolút neutrofil szám
absorption	abszorpció,
abstinence	absztinencia,
abuse	abúzus,
acalculia	számolási képtelenség, acalculia
acantho	tövis, spina akanto-
acanthoma	hámdaganat, acanthoma
acanthosis	acanthosis,
acariasis	acariasis,
acceleration	gyorsulás, akcelerácó
accentuation	accentuatio,
accessory	accessorius,
accident	baleset
accompanying	concomitans, kísérő concomitant
according to the rules	lege artis, szabályszerűen
accumulation	felhalmozás, akkumuláció
acetabulum	acetabulum,
acetylcholinesterase	acetilkolineszteráz,
Achilles tendon	tendo calcaneus, Achilles ín,
achlorhydria	achlorhydria,
achromatopsy	colorblindness, achromatopsia,
acid	acidum,
acid breakthrough	savvisszaáramlás, A sav visszaáramlása a gyomorból a nyelőcsőbe., saváttörés,
acidity	savasság, aciditás
acme	akme, csúcspont
acne	pattanás, akne pimple
acquired	szerzett, aquisitus
acral	acralis,
acral edema	végtagvizenyő, acroödéma
acro-	csúcs-, akro-
acrocyanosis	acrocyanosis,
acromioclavicular	acromioclavicularis,
acromion	akromion, vállcsúcs,
acrophobia	magasságiszony, akrofóbia
acting out	Az előzőleg elnyomott emóciók kimutatása, ami főleg tettekben, mint szavakban nyilvánul meg. Elmegyógyászatban gyógyító hatásúnak tartják. Megnyilvánulhat ellenőrizhetetlen kirobbanás formájában.
actinomycosis	actinomycosis,
activity	aktivitás, tevékenység
acuity	acuitas,
acustic	akusztikai, hallási
acustic nerve	hallóideg, nervus acusticus
acute	acutus,
acute anterior poliomyelitis	A gerincvelő elülső szarvainak poliomyelitis vírus fertőzés okozta gyulladása. Jellemzői a láz, fájadalom, gyomor és bélrendellenességek, flacid paralízis és az izomcsoportok atrófiája., Heine-Medin betegség., Heine-Medin disease, akút anterior poliomyelitis,
acute hematogenous osteomyelitis	akút vér által okozott csontvelőgyulladás
Adam's apple	Ádámcsutka,
adaptation	adaptáció,
addiction	addictio,
addictive	addiktív,
addictologist	addiktológus,
adducent	közelítő, adducens
adduction	addukció,
adduction	közelítés, addukció
adenectomy	adenectomia,
adenitis	adenitis, mirigygyulladás
adenocarcinoma	adenocarcinóma, mirigyrák/daganat
adenocortycotropic hormone (ACTH)	adenokortikotrop hormon,
adenoid vegetations	garatmandula túlburjánzás, adenoid vegetáció
adenoids	orrmandulák, nyirokszövet masszák a torok felső részében az orr mögött
adenoma	mirigyhámból eredő jóindulatú daganat,
allograft	Szövet, vagy szerv átültetése két azonos fajtájú éllőlény között, akiknek viszont különböző a genotípusa.,
allopathic	lásd: heteropathic
alloved	megengedett
alturist	altruista,
alveolitis	az alveolus gyulladása, alveolitis
alveolus	meder
alveolus dentalis	fogmeder
alveolus pulmonis	tüdő-léghólyagocska
Alzheimer's disease	Alzheimer betegség, (témák)
amaurosis	amaurosis, vakság
amblyopia	tompa látás, amblyopia, látásgyengülés
amenorrhea	a menstruáció hiánya, amenorrhoea
aminotransferase	lásd: transaminase
amnesia	amnézia, emlékezetvesztés
amniocentesis	magzatburok-csapolás, amniocentesis, magzatvíz-vétel, magzatvíz-csapolás
amnion	Vékony, erős, hártya, amely a magzatot veszi körük, és folyadékkot tartalmaz.,
Amniotic Fluid Index	AFI, Magzatvíz index,
amniotomy	a magzatburkok mesterséges bemetszése a szülés folyamatának a felgyorsítására.
amphetamine	stimuláns (élénkítő szer) és étvágyat elnyomó szer, amfetamin, amphetamin
amputation	csonkolás, amputáció
amygdaloid	amygdaloid, mandulaszerű
amylase	emésztő enzim, amely főleg a hasnyálmirigy váladékban és a nyálban található és a hosszú láncolatú szénhidrátokat kissebbekre metéli,
amyloid	amyloid, 1. keményítőre hasonlító, 2. Bármely a komplex proteinokból amely lerakódik a szövetekben és jellemezhetők bizonyos laboratóriumi tulajdonságokkal. Az amyloid lerakódás sok betegségnél előfordulhat. Sok betegségnél nem tudni, hogy a lerakódás okozza-e a betegséget, vagy a lerakódás csak a betegség velejárója. Az amyloid az egés szervezetben lerakódhat, mint pl. a szisztémás amyloidózisnál, vagy csak bizo
ANA	anti nuclear antibody
anal	anális, végbélnyílással kapcsolatos
anal canal	végbélcsatorna, canalis analis,
anal fissure	végbélrepedés, fissura ani
anal fistula	végbélsipoly, fistula ani
anal papilloma	analis papilloma,
analgesic	analgetikum, fájdalomcsillapító
anamnesis	anamnézis, kórelőzmény
anaplastic	anaplasztikus,
anaplerotic reaction	Ez egy reakció amely helyreállítja a fontos anyagokat, amelyek lecsökkentek a sejt működésében., anaplerosis
anastomositis	az anastomosis gyulladása (szintén lásd: anastomosis)
anatomic range of motion	anatómiai mozgáshatár,
anatomy	bonctan, anatómia
ancephalitis	agyvelőgyulladás, encephalitis
ancle	malleolus, boka, malleolus
androgen	Ez egy általános kifejezés bármilyen természetes, vagy szintetikus anyagra, általában steroid hormonra, amely stimulálja vagy szabályozza a férfi jellemvonások kifejlődését és ezek megtartását., androgén
anemia	anémia, vérszegénység
anesthesia	érzéstelenítés, anesztézia
anesthesiologyst	altatóorvos, aneszteziológus
anesthetic agent	érzéstelenítőszer, anesztetikum
aneurysm	aneurizma, verőértágulat
anger	düh, furor
angiestasis	angiectasia, értágulat
angina	angina, szorító mellkasfájdalom
angio-	ér-, angio-
angiocardiography	angiokardiográfia, az erek és a szív kontrasztanyagos röntgenvizsgálata
angiocath	Műanyag katéter, melyet a kéz, vagy a kar ereibe juttatnak, oldatok, vagy gyógyszereket beadására.
angioedema	angio neurotikus oedema, Quincke's edema, Gyorsan fellépő megdagadása a bőrnek, nyálkahártyáknak és a nyálkahártya alatti szöveteknek. Ez a gyros dagadás a légutak elzáródásához is vezethet, és a beteg megfulladhat
angiogenesis	új erek alkotása vagy keletkezése, angiogenesis
angiogenic	új ereket teremtő
angiogenic network	új ereket teremtő hálózat
angiography	angiográfia, az érrendszer kontrasztanyagos röntgenvizsgálata
angiopathy	érbántalom, érbetegség, angiopathia
angle	angulus, szöglet
anion gap	anionrés plazmában vagy vizeletben
aniridia	aniridia, a szivárványhártya hiánya
anisometropia	A két szem közötti refrakciós hiba (fénytörési rendellenesség), anisometropia
ankle	boka, malleolus
ankylo-	ankylo-, összenövés
ankylosis	ankylosis, merev ízület
anorectic agent	anorektikum, étvágycsökkentő
anorexia	anorexia, étvágytalanság
anorganic	anorganikus, szervetlen
anovulation	az övuláció ideiglenes vagy végleges abbamaradása, anovuláció
antacid	antacid,
antalgia	A test tartása megvátozik, hogy a fájdalomtól megszabaduljon (pl. bicegés)., antalgia
ante-	előtt, prae-
antenatal	antenatális, születés előtt
anterior	anterior, elülső
anteroposterior	elölről hátra, szagittális,
anteroseptal	septum előtt található (általában az atrioventrikuláris septumra értendő), anteroseptalis
anteversion	anteverzió, előredőlés
anthracosis	bányásztüdő, antrakózis
anthrax	anthrax, lépfene, pokolvar
anthropo-	antropo-, ember-
anti-TPO	anti-thyroperoxidáz
antiagregant	véralvadásgátló
antiandrogen	Anyag, amely gátolja az androgén (lásd: androgén) hormonok biológiai hatását., antiandrogén
anticoagulant	alvadásgátló, antikoaguláns
antidote	antidotum, ellenszer
antiemetic agent	antiemetikum, hányáselleni szer
antigen	antigén,
antiinfection	fertőzés ellenes
antiinfection agent	fertőzés elleni anyag
antiinflammatory	gyulladásgátló
antioxidant	antioxidáns, Oxidációt gátló anyag. Az oxidációs folyamatok károsíthatják a sejteket. Antioxidánsok pl. az E és a C vitamin, vagy a beta karoten.,
antiphlogistic	gyulladás és lázcsökkentő anyag
antiplatelet	vérlemezkék ellen irányuló
antiplatelet therapy	vérlemezkék ellen irányuló gyógymód (pl. aspirin szedése)
antisocial	antiszociális, közösségre ártalmas, disszociális
antiviral compound	vírus ellenes anyag, vagy vegyület.
antrum	antrum, üreg
antypiretic	lázcsillapító, antipyreticum
anular	anuláris, gyűrűszerű
anular	gyűrűalakú, anuláris
anuria	anúria, a vizelés leállása
anus	anus, végbélnyílás
anvil	üllő, incus
anxiety	anxietas, félelemérzet
anxiety	szorongás, anxietas
anxious	szorongó, anxiosus
aorta	főverőér, aorta főütőér
aortal arch	aortaív, arcus aortae
aortic dissection	Az aorta legbelső rétegének, az intimának, a hasadása, ahol a vér behatol a hasadékba, majd tovább utathasít magának, amivel egy új hamis csatornát alkot az aorta falában. Leggyakrabban a mellkasi aortánál fordul elő. Leggyakrabban a 40
aortic stenosis	aorta szűkület, aorta stenosis
apathy	apátia, közöny, közömbösség
aperture	apertura, nyílás
apetite	étvágy, appetitus
apex	csúcs, apex
apex of the heart	szívcsúcs, apex cordis
aphakia	aphakia, a szemlencse hiánya
aphasia	afázia, (lexikon)
apical	csúccsal kapcsolatos, valaminek a hegyével kapcolatos, apicalis
apicitis	valami csúcsának a gyulladása,
apnea	légzés leállása, apnoé
apocrine	A mirigyek kiválasztásának az egyik működési formája, ahol a mirigysejt apikális része lehámlik és a válladék részévé válik., apokrin
apoplexy	apoplexia, gutaütés
apoptosis	Programozott sejt halál, amely szükséges az elöregedett és hibás DNS eltávolítására és egyben helyet készít az új sejtek számára.
appendicitis	vakbélgyulladás, a féregnyúlvány gyulladása (témák)
appendix	féregnyúlvány, appendix vermiformis
appendix	függelék, appendix
aqueduct	aquaeductus, vízvezeték
Aqueduct of Sylvius	Sylvius-csatorna, a harmadik és negyedik agykamrát összekötő kanális,
arachno-	arachno-, pók-
arachnoid	pókhálóhártya, arachnoidea
arch	ív, archus
areola	areola, kis terület
areola	bimbóudvar, areola mammae
areola	udvar, areola
arm	kar, brachium
arteficial abortion	terhességmegszakítás, abortus arteficialis
arteriography	arteriográfia, artériák kontrasztanyagos röntgenvizsgálata
artery	artéria, verőér ütőér
arthralgia	ízületi fájdalom,
arthritis	arthritis, ízületi gyulladás
arthritis deformans	lásd: rheumatoid arthritis
arthro-	ízület-, artro-
arthropathy	izületi bántalom, izületi betegség
arthrosis	ízületi károsodás (degeneratív és kopásos folyamat végett)
articular	ízületi, artikuláris
articulation	ízület, articulatio
artificial airway	mesterséges légút,
arythmia	aritmia, arhytmia, ritmuszavar
ascendent	ascendens, felmenő, felhágó, felszálló
ascendent colon	felszálló hurkabél, colon ascendens,
ascites	hasvíz, ascites
Asperger syndrome	Asperger szindroma (témák)
asphyxia	megfulladás, Állapot ahol a test súlyos oxigénhiányban szenved, asphixia
aspiration	belélegzés, beszipantás (pl. idegen testet a tüdőbe), aspiratio
assistant professor	egyetemi adjunktus
asthenia	erőtlenség, aszténia
asthenozoospermia	a spermiumok csökkent mozgásképessége, asthenozoospermia
astigmatism	szemtengelyferdülés, astigmia
astrocyte	csillag alakú neuroglia sejt, asztrocyta, (szintén lásd: neuroglia)
astrocytoma	Astrocytákból álló daganat. Ez a leggyakoribb primér agydaganat, de bárhol a központi idegrendszerben előfordulhat., astrocytoma
asymptomatic	aszimptomatikus, tünetmentes
asystole	a szívkamrák összehúzódásának a hiánya,
atelectasia	tüdőlégtelenség, atelectasia
atelectasis	tüdőlégtelenség, atelectasia
atenuation	gyengítés, mitigatio
atherogenesis	Atherómás lerakódás képződésének a folyamata. Ez a folyamat nagyon jellemző az erek belső falaira., aterogenézis
atheroma	Zsírtartalmú lepedékek lerakódása vagy felgyülemlése az erek belső falán., ateróma
atherosclerosis	ateroszklerózis, az artériafal érelmeszesedése és megkeményedése
atlanto-occipital	a fejgyámmal és a nyakszirttel kapcsolatos
atlas	fejgyám, atlas
atony	petyhüdtség, atónia, tónushiány (lásd: tónus)
atopic dermatitis	atópiás ekcéma, atópiás dermatitisz, atopic eczema, (témák)
atopic eczema	lásd: atopic dermatitis
atria	pitvarok
atrial	pitvari, pitvarral kapcsolatos
atrial fibrillation	pitvarlebegés, pitvarfibriláció
atrium	átrium, pitvar
atrophy	atrófia, sorvadás
attachement	függelék, valamihez erősített valami, valamihez csatolt dolog
Attention Deficit Disorder	figyelemhiányos rendellenesség, ADD,
audiometry	audiometria
augmentation	hosszabbítás, nagyobbítás, növelés, kihangsúlyozás (méret vagy tömeg hozzáadással),
aura	előjel, aura
auscultation	auszkultáció, hallgatódzás
autism	autizmus,
autoimmun	immúnreakció a szervezet saját anyagaira,
autologous transplantation	autológ transzplantáció,
autologous trantation	ez egy elírás ü lásd: autologous transplantation,
autolysis	önmegemésztés, Szövetek tönkretétele a szövet saját maga által termelt anyagokkal., autolysis
autonomous	vegetatív
autonomous ganglion	vegetatív ganglion
autopsy	halottboncolás, autopsia
autosomal	Kromozómára vonatkozó, kivéve a szex kromozómákat., autozóm
autotransfusion	sajátvér transzfúzió, autotranszfúzió
autotransplantation	sajátszövet átültetés, autotranszplantáció
AV conduction	ingervezetés az atrio-ventrikuláris csomón    keresztül
AV node	(AV csomó) atrio-ventrikuláris csomó (atrium-pitvar, ventrikulum-kamra)
average	átlag
axeroftol	A1-vitamin, retinol
axial	axialis, tengelyes, tengelyben álló, axiális
axilla	axilla, hónalj
axillary	hónaljal kapcsolatos, axillaris
axis	1. tengely, 2. második nyakcsigolya, forgócsigolya
azygos	azygos
back	hát, dorsum
back side	üllep, natis
bacteremia	bakteriémia, baktériumok jelenléte a vérben
bacterial	baktériumok által okozott, bakteriális
bacteriocidal	baktériumokat megölő (pl. antibiotikum, antiseptikum, vagy dizinfektáns), bacteriocidális
bacteriophage	bakteriofág, baktériumot elpusztító (vírus)
bacteriostatic	bakteriosztatikus, baktérium szaporodást vagy növekedést leállító
bad breath	szájbűz, foetor ex ore
badycardia	bradikardia, lassú pulzus (p<60)
Baker's cyst	Baker ciszta,
balanitis	balanitis, a hímvessző makkjának gyulladása
balloon-expandable	ballonnal tágítható
balneology	balneológia, fürdőtan
balooning	kidudorodás, kidülledés, kifúvódás, léggömb alakú dudorodás
barium enema	irrigoszkópia, irrigoscopia, a bél kontrasztanyagbeöntéses röntgenvizsgálata, irrigoradioscopia,
barotrauma	barotrauma, nyomás által keletkezett sérülés
Barrett's esophagus	Barrett oesophagus,
basal ganglion	bazális ganglion,
basal lamina	alaplemez, lamina basalis
basal nucleus	bazális ganglion,
base	alap, basis fundus
baseline	alapszint,
basilar	alapi (agyalapi), basilaris
basilar bone	alapcsont, os basilare
batch	adag, csomó, tétel
bathophobia	bathophobia, mélységiszony
baypas	helytelen: lásd bypass
beard	barba, szakáll
bedsore	dekubitusz, felfekvés
bedwetting	enuresis, ágybavizelés
before	ante, előtt
belching	böfögés, eructatio
belly button	köldök, umbilicus
Bell's palsy	Bell bénulás, Hirtelen fellépésű, egyoldali, arcizombénulás. Kiváltó okok lehetnek az arcideg sérülése,
belt	öv, cingulum
bend	flexura, hajlat
bending	elgörbülés, gryposis
bending	flexió, hajlás, hajlítás
benign	benignus, jóindulatú
Bertolotti's syndrome	Bertolotti-szindróma,
betamethasone	Egy szintetikus glucocorticoid, amely fehér kristályos por alakú. Bőrgyógyászatban használják, mint topikus
betegségek nemzetközi osztályozása	BNO,
bicuspid	bikuszpidális, kétcsúcsú
bifurcated	bifurcatus, kettéágazó
bifurcation	bifurkáció, kettéágazódás (Y-alakú)
big	nagy, magnus
big	macro-, makro-, nagy-
big toe	hallux, nagy lábujj, öreg lábujj
bigeminy	1. párokkal kapcsolódó, 2. Olyan pulzus, ahol két szívütést szünet követ., bigeminia
bihemispheral	bihemisphaerialis,
bilateral	bilaterális, kétoldali
bile	bilis, epe
bile-	chole-, epe-
bilestone	cholelith, epekő
biliary duct	epeutak, ductus biliferi
bilirubin	epefesték, bilirubin,
biopsy	biopsia, biopszia,
bipolar	kétpólusú, bipoláris
bipolar disorder	bipoláris zavar, A bipoláris zavart, mániás depressziónak is nevezik. Ez egy rendellenesség az agyban,
birth	születés, natus
birth control	antikoncepció, fogamzásgátlás
birthmark	anyajegy, naevus, lentigo
bite	harapás, morsus
bitter	keserű
black	fekete, niger
black hairy tongue	lingua villosa nigra, fekete szőrös nyelv
black light	fekete fény,
black tongue	fekete nyelv, lingua nigra
bladder infection	húgyhólyaggyulladás, húgyhólyaghurut, cystitis
bladder-	ciszto-, húgyhólyag-
blastomere	A megtermékenyített ovum osztódásából származó egyik sejt, amely a blastulát alkotja.
blear	csipa, lema
bleb	kis hólyag (kissebb mint 5mm)
bleeding	vérfolyás, vérzés, haemorrhagia
bleeding out	elvérzés, exsanguinatio
blepharadenitis	meibomianitis, Meibom-mirigy-gyulladás, Az apró szemhéjban található Meibom-mirigyek gyulladása.
blepharitis	blepharitis, szemhéjbőr-gyulladás
blepharo-	blepharo-, szemhéj-
blepharoptosis	blepharoptosis, szemhéjsüllyedés
blindnes	vakság, amaurosis
blinking	pislogás, palpebratio
blister	vesicle, hólyag, szintén lásd: bulla
bloated	inflatus, felfúvódott,
blood	sanguis, -vér
blood	szangvum, vér
blood cell	vérsejt, hemocita
blood clot	véralvadék, coagulum
blood clotting	véralvadás, koaguláció
blood donor	véradó
blood pressure	vérnyomás, tenzió
blood sugar	vércukor
blood transfusion	vérátömlesztés, transzfúzió
blood vessel	ér, vas
blood-	hemato-, vér-
blood-	hemo-, vér-
blood-zinc-protoporphyrin	vér-cink-protoporfirin (lexikon)
bloodline	vérvonal, Egyenes leszármazott egy bizonyos embertől vagy álattól.,
bloodpressure meter	szfigmomanométer, vérnyomásmérő
bloody	sanguineus, véres
body	corpus, test
body habitus	testalkat, habitus
body mass index	Testtömegindex, BMI
body temperature	testhőmérséklet, temperatúra
bolémia	helytelen
boldness	alopecia, kopasszság
bolus	nagy adag egyszerre,
bolus of fluid	nagyobb adag folyadék relatívan gyors beadása
bone	csont, os
bone	osteo-, csont-
bone inflammation	csontgyulladás, osteitis
bone marrow	csontvelő, medulla ossium
bone mineral density	BMD,
bone scintigraphy	csontszcintigráfia,
bone spur	csontkinövés
borderline	határeset,
borderline personality dysorder	BPD, határeseti szindróma, határeseti énzavar,
bottom	üllep, natis
bottom	fenék, fundus
bow knees	genu varum, O láb
bowel	bél, intestinum
bowel gas	bélgáz, flatus
bowel loop	bélhurkok, bélkacs
bowel obstruction	ileus,
bowel perforation	bélátfúródás, perforatio intestini
bowleg	dongatérdállás, genu varum
Bowman's capsule	Bowman tok, capsula glomeruli, A vesének a glomerulusait körbefogó tok
brace	kapocs, támasz, fogszabályozó, végtagok vagy törzs merevítésére vagy támaszára használt eszköz,
brachial	brachiális, karral kapcsolatos
brachial plexus	karfonat, plexus brachialis
brachydactyly	brachydactylia, rövidujjúság
brachytherapy	brachytherapia, brahiterápia, belső besugárzás. Radioaktív anyagot tartalmazó henger alakú inplantátumokat
bracket	zárójel
bradykinin	bradikinin,
brain	agy, cerebrum
brain abscess	agytályog, abscessus cerebry
brain bloodsupply	agyi vérellátás
brain ischemia	ischaemia cerebri, az agy vérszegénysége a vérellátás hibája végett,
brain sand	agyhomok, acervulus
brain tumor	agydaganat, tumor cerebri
brainstem	agytörzs, truncus cerebry
brainstem auditory evoked potentials	BAEP,
brainstem infarction	agytörzs infarktus, infarctus trunci cerebri
branch	ág,
branched	ágas, ramosus
branching	elága zódás, ramifikáció
break down	lebomlás, összeomlás,
breakthrough bleeding	áttöréses vérzés
breast	emlő, mamma
breast absces	melltájog (emlőtájog), abscessus mammae
breast bud	emlőbimbó, papilla mammae
breast cancer	emlőrák, carcimoma mammae
breast milk	anyatej,
breath	halitus, lehellet
breathing	-pnoé, -légzés
breech	farfekvés
bridge	híd, pons
broad	széles, latus
bronchial	bronchiális, hörgővel kapcsolatos
bronchial asthma	tüdőasztma, asthma bronchiale
bronchiectasia	hörgőtágulat, bronchiectasia
bronchiolitis	bronchiolitis, a tüdőhörgőcskék gyulladása
bronchiolus	bronchiolus, kishörgő, hörgőcske
bronchitis	hörghurut, bronchitis
bronchodilator	hörgőtágító, bronchodilatátor,
bronchography	bronchográfia, a hörgők kontrasztanyagos vizsgálata
bronchopulmonary dysplasia	BPD, A tüdőszövet rendellenes kifejlődését foglalja magában. Jellemvonásai a tüdő gyulladása és
bronchoscopy	bronchoszkópia, hörgőtükrözés
bronchospasm	bronchospazmus, a hörgők simaizmának görcsös összehúzódása, hörgőgörcs
bronchus	bronchus, légcső hörgő
brow	frons, homlok
brow ridge	a csont éle a két szemüreg felett
bruise	ecchymosis, bőr bevérzés folt
bruise	suffusio, véraláfutás
bruising	véraláfutás, suffusio
bruxism	fogcsikorgatás, bruxismus
bubo	bubo, nyirokcsomó duzzadás (lágyék)
bucca	pofa, bucca
buccal	arcal kapcsolatos, buccalis
Buerger's disease	Thrombangitis obliterans (Buerger kór)
buffy coat	A véralvadék felső világos része, emely akkor keletkezik, ha a véralvadás késleltetett, vagy ha a vér
built	épített
bula	hólyag, cysta, bulla
bulb	kerek vagy gömbölyödött alak vagy szerkezet
bulge	dudor
bulging	kidudorodó, kidülledő,
bulging disc	kidudorodó porckorong, kidülledő porckorong
bulimia	farkaséhség, farkasétvágy, csillapíthatatlan éhség, kóros falánkság, A beteg rengeteget eszik, majd hányás idéz elő
bulla	bulla, blister,
bundle	funiculus, köteg
bunion	A nagylábujj körüli első izület bursa gyulladása, amely az izület dagadásával és oldalra való elmozdulásával vagy
burning of the tongue	glossopyrosis, nyelvégés
burning tongue	nyelvégés, glossopyrosis
burping	eructatio, böfögés
bursa	nyálkatömlő, bursa
bursa	tömlő, cysta
bursitis	nyálkatömlő gyulladás
bursolith	bursakő, bursolith
buttock	üllep, natis
butyric acid	vajsav, acidum butyricum
bypass	shunt, alternatív áramlási út,
C-reactive protein	CRP, C-reaktív protein,
cachexia	kachexia, Betegség okozta súly és izomtömegvesztés,
cadaver	hulla
Café-au-lait spot	Café-au-lait folt
calcaneitis	sarokcsontgyulladás
calcaneus	sarokcsont
calcification	elmeszesedés, kalcifikáció
calcified granuloma	granuloma (elmeszesedett), elmeszesedett sarjdaganat
calcify	elmeszesedik
calcipenia	Nem elegendő kalcium mennyiség a szövetekben és a testnedvekben., calcipenia
calciuria	kalciúria, kalciumvizelés
calculum	kő, calculus
calculus	lithos, kövecske
calf	lábikra, sura
calf cramp	lábikragörcs, systremma
calix	kehely
callous	kérges, kallózus, callosum
callus	csonforradás, csontheg
cancellous	szivacsos szerkezetű, rácsos szerkezetű (pl. csont),
cancer	carcinoma,
Candida	Kandida, élesztőgomba, sarjadzógomba,
candida albicans	Parazita gomba amely fertőzést okozhat a bőrön, szájban, belekben és a hüvelyben.,
candidiasis	candida okozta ferőzés,
cannula	Hajlékony cső, amely végén általában trokár található, amely a test üregeibe, csatornáiba, vagy ereibe van
canthus	szemzug, a szem külső sarka
canul	lásd: cannula
capillary	hajszálér, kapilláris
capnography	capnographia,
capsule	theca, hüvely, tok, kapszula
capsulotomy	tok sebészeti bemetszése, capsulotomia
carbon monoxide	szén-monoxid, carboneum monoxidatum
carbuncle	darázsfészek, karbunkulus
carcino-	carcino-, rák-
carcinogenic	karcinogén, rákkeltő
carcinoma	cancer,
cardiac	szívvel kapcsolatos
cardiac arrest	szívleállás
cardiac contraction	szívösszehúzódás, szisztolé
cardiac edema	cardialis oedema,
cardiac failure	lásd: cardiac insufficiency
cardiac insufficiency	szívelégtelenség, insufficientia cordis
cardial	kardiális, szívvel kapcsolatos
cardio-	szív-, kardio-
cardio-	kardio-, szív-
cardiocentesis	szívpunkció, cardiocentesis
cardiological	a szívvel kapcsolatos
cardiology	szívgyógyászat, kardiológia
cardiomegaly	szívmegnagyobbodás, cardiomegalia, cardiomegaly
cardiomyopathy	cardiomyopathia, szívizombántalom
care	kezelés, gondozás, törődés
caries	Csont, vagy fog romlása, fogszuvasodás, káriesz
carotic	caroticus, nyaki verőérrel kapcsolatos
carotid artery	fejverőér, arteria carotis
carotid duplex	A nyaki verőerek ultahang vizsgálata amellyel a nyaki verőér elzáródásának a fokozatát, vagy a véráram
carpal	karpális, kéztőcsonti
carpal tunel	kéztőcsatorna szindróma
cartilage	cartilago, chondro-, porc
case study	kazuisztika, esettanulmány
caseating	sajtos, caseous
caseation	elsajtosodás, caseatio
casein	a tejben és tejtermékekben található legfontosabb, kazein
caseous	caseosus, elsajtosodott
casted	begipszelt,
castration	testectomia, orchiectomia, kasztrálás
cat-scratch disease	macskakarmolási betegség, Nagyon lassú lefolyású betegség amelyet az emberekre a macskák karmolásával,
cat-scratch fever	lásd: cat scratch disease
catalyse	katalizálni,
cataract	szürke hályog, A lencse   elhomályosodása az egyik, vagy mindkét szemben, amely csökkenti a normális látást. A
catecholamine	Catecholból eredő aminok, melyek neurotranszmitter és hormon szerepet töltenek be a szervezetben. Ide
catharal	catarrhalis, hurutos
catheter shaft	katéterszár
catheter tip	katéter csúcsa
cauda equina	A subarachnoid téren keresztül futó spinális ideggyökér köteg a gerinccsatornában az első ágyéki csigolya
caudal	1. farokkal kapcsolatos, 2. A test hatulsó része felé irányuló vagy a test hatulsó részén található., caudalis,
caudo-	kaudo-, farok-
cauter	Forró vas elhamvasztásra, vagy égetésre.
cauterisation	kiégetés, égetés, kauterizáció
cavern	kaverna, üreg
cavernoma	üreges érdaganat, cavernoma
cavernous	barlangos, üreges, cavernosus
cavitation	üregesedés, üregképződés
cavity	cavum, üreg, syrinx, cavitas
cavum vergae	Horizontális repedészserű tér a corpus callosum posterior egyharmada és az alattafekvő commissura fornicis
cecal	cekális, vakbéllel kapcsolatos
cecum	caecum, vakbél,
cell	sejt, cella
cell cycle	sejtciklus, cell cycle
cell differentiation	sejtdifferenciálódás,
cell division	sejtosztódás, anaplázia
cell membrane	sejtmembrán
cell-	sejt-, cito-
cellline	sejtvonal
cellular	sejtes, celluláris
cellulitis	a bőralatti szövetek fertőzése és gyulladása
central	központi, centrális
central facialis paresis	Központi idegrenszeri rendellenesség okozta kontralaterélis szájzug lefiggyedés. A rendellenesség
central line	A nagy vénákba behelyezett katéter, amelynek a vége a vena cava mellkesi részében, vagy a szív jobb pitvarában
centriole	centriolum, Egyik a két hengeralakú sejt alkotóelemből, amely kilenc mikrotubulus-tripletből áll. A
centripetal	centripetális, középpont felé irányuló
centrum	központ
cephalhematoma	cephalhaematoma, Fejtetői vérömleny amely a szülés alatt alakul ki a fejtetőn a koponyacsont és külső
cerato-	szaru
cerebellar	cerebelláris, kisagyi
cerebellar  falx	kisagysarló, falx cerebelli
cerebellum	kisagy
cerebral	agyi, cerebrális
cerebral abscess	agytályog, abscessus cerebry
cerebral atrophy	agysorvadás, atrophia cerebri
cerebral bleed	agyvérzés, apoplexia cerebry
cerebral compression	compressio cerebri, nyomás az agyra,
cerebral contusion	agyzúzódás, contusio cerebry
cerebral cortex	agykéreg, nagyagykéreg, cortex cerebri
cerebral edema	az agy vizenyője, agydagadás, oedema cerebri
cerebral hemisphere	agyfélteke,
cerebral lobe	agylebeny, lobus cerebri
cerebral ventricle	agykamra, ventriculus cerebri
cerebri	agyhoz tartozó
cerebro spinal	agyi-gerincvelői, cerebrospinális
cerebro spinal fluid	agyi-gerincvelői folyadék, cerebrospinális folyadék
cerebro-	agyvelő-, encefalo-, cerebro-
cerebrovascular	az agy érrendszerével kapcsolatos, cerebrovascularis
cerebrovascular accident	gutaütés, agyvérzés, szélütés
cerumen	fülzsír
cervical	nyakkal vagy méhnyakkal kapcsolatos, cervicalis
cervical diaphragm	vaginal diaphragm, hüvelyi diaphragma,
cervical dysplasia	A méhnyak sejtjeinek rendellenes fejlődése vagy egy rendellenes kinövés ezen rendellenes fejlődés
cervical laceration	1. méhnyak szakadás vagy tépődés, 2. nyak szakadás vagy tépődés
cervical metaplasia	méhnyakmetaplázia,
cervical myelitis	a nyaki gerincvelő gyulladása, cervicalis myelitis
cervicalisation	A méh nyakcsatornájában található hengerhám hormonális hatásokra vagy a hüvely vegyhatásának lúgosodására
cervicitis	méhnyakgyulladás
cervico-	nyaki-,
cervicocranal syndrome	cervicocraniális szindróma, Az ostorcsapás sérülés által keletkezett tünetegyüttes (szédülés,
cervix	nyak, méhnyak
cesarean section	császármetszés, sectio caesarea
cessation	cessatio, megszűnés
chalasion	jégárpa, chalazion
chancre (primary sifilis)	sánker, szövetkeményedés (elsodleges szifilisz)
chaperon	védő, óvó, felügyelő (pl. protein)
characteropathy	characteropathia, karakteropátia, kóros jellemtelenség,
Charlie horse	systremma, lábikra izomgörcs
chase	kergetni
checklist	a tennivalók listája,
cheek	arc, orca, pofa
cheesy	sajtos, caseous
cheilitis	ajakgyulladás
chelating agent	A szervezetből a nehézfémek vagy ionok eltávolítására használt anyag.
chest	stetho-, thoraco-, thorako-, mellkas-
chest	pectus, mell
chest	stethos, mellkas, thorax
chest pain	stethalgia, mellkasi fájdalom
chest wall	mellkasfal
chestcage	mellkas, thorax
chiasma	kereszteződés
chickenpox	bárányhimlő, varicella
child	gyermek, infans
child study	gyermek tanulmány
childbed	gyermekágy, puerperium
chimera	kiméra; egy egyén szerv vagy rész, amelynek 2 vagy több genetikai kódja van (pl. két külömböző élőlény sejtjeinek
chin	áll, mentum, toka, buccula
chin-	áll-, gnato-, gnatho-
cholangioma	cholangioma, epevezetékdaganat
cholangiopathy	epevezetékbántalom, epevezetékbetegség, cholangiopathia
cholangitis	cholangitis, epeútgyulladás
cholecystectomy	cholecystectomia, az epehólyag sebészeti eltávolítása
cholecystitis	cholecystitis, epehólyag-gyulladás
cholecystolithiasis	epehólyag-kövesség, cholecystolithiasis
choledocholithiasis	epevezeték-kövesség, choledocholithiasis
cholelith	epeko, calculus biliaris
cholelithiasis	cholelithiasis, epekövesség
cholestasis	epepangás, kolesztázis
cholesterol	koleszterin,
chondritis	chondritis, porcgyulladás
chondro-	chondro-, porc-
chondroma	condroma,
chondromalatia	chondromaláció,
chorda	chorda, szalag húr
chordoma	A notochord maradékaiból keletkező ritka csontrák ami általában a gerinc alsó részében szok kezdődni., chordoma
chorea	chorea, vitustánc, Szent Vitus tánca, Szűnni nem akaró, komplex testmozgás, amely nagyon rendezettnek és
chorionic villi	chorionbolyhok,
choroid	choroidea, érhártya (a szemben)
chromoperturbation	A meddőség kivizsgálásánál használt alapvető laparoszkópos kivizsgálási módszer amivel a petevezetékek
chronic	idült, krónikus
chronic fatigue syndrome	CFS, krónikus fáradtság szindróma,
chronic pansinutitis	az összes paranasális üreg idült gyulladása, pansinusitis chronica
chylomicron	Emulzifált zsírrészecske ami a vérben vagy nyirokban található és a zsírok emésztésekor keletkezik.,
chylomicronemia	magas chylomicron szint a vérben (szintén lásd: chyolomicron), chylomicronaemia,
ciliary	1. sejtekből kiálló rövid csillókkal kapcsolatos., 2. A szem lencséjét körülvevő izmokkal és szövetekkel
ciliated	csillószőrös
cinnamon	fahéj
circle	circuls, kör
circle of Willis	circulus Willisii, Willis-kör,
circulation	keringés
circumcision	cirkumcízió,
cirrhosis	cirrózis; cirrhosis; a kötőszövet krónikus gyulladása, mely a kötőszövet burjánzásához, majd a szerv sorvadásához
class	osztály
claudication (intermittent)	klaudikáció intermittensz, Intermittáló sántítás
claudication claudicatio	sántítás
claudication sántítás	claudicatio
claustrophobia	a bezártságtól, vagy a zárt terektől való félelem, claustrofóbia
clavicle	clavicula, kulcscsont,
clean	tiszta, purus
clearance	klírensz, A vese egy adott anyagra vonatkozó kiválasztóképességének az értéke, (pl. kreatinin klírensz
cleido-	kulcscsont-, cleido-
clitoris	csikló, klitorisz
clockwise	horális,
clonal dissemination	klonális disszemináció
closer	proximális, közelebbi
clot	coagulum, véralvadék, alvadék, koagulum
clotting	koaguláció, alvadás
coagulation	alvadás, koaguláció
coagulopathy	véralvadási zavar, coagulopathia
coagulum	alvadék, koagulum
coaptation	coaptatio, összeillesztés
coarctation	coarctatio, szűkület
coccygeal	coccygeus, farkcsonti
cochlea	cochlea, csiga (fülben), csigajárat, fülcsiga
cochlear	kochleáris, csigajárattal kapcsolatos
cognition	a megismerés folyamata (tudat, gondolkodás, tanulás, felfogás és elbírálás)
cognitive	a megismerés folyamatával kapcsolatos (tudat, gondolkodás, tanulás, felfogás és elbírálás)
cognitive dissonance	Félelemérzet vagy más kellemetlen érzés amely a megnemegyezésből ered a személy berögződött
cohesion	kohézió, összetartás
coimmunoprecipitation	Egy tisztítási folyamat, ami két molekula (általában protein) kölcsönhatásának a meghatározására
coitus	coitus, közösülés, koitusz
colectomy	A vastagbél egy részének, vagy az egész vastagbél sebészeti eltávolítása, colectomia
colic	hascsikarás, kólika, hasgörcs
colitis	vastagbélgyulladás, colitis
collagen	enyvadó, kollagén, kolagén,
collapse	ájulás, syncope, kollapszus
collar	gallér (pl. nyak stabilizációra)
collateral ligament	oldalszalag
colon	colon, vastagbél
colonography	A vastagbél képalkotása pl. CT-vel vagy MR-al., colonographia
colonoscopy	kolonoszkópia, (kivizsgálások)
colorblindness	színtévesztés, dikromázia, színvakság, achromatopsia
colorectal	a vastagbéllel és végbéllel kapcsolatos, colorectalis
colostrum	colostrum, előtej
colpitis	colpitis, hüvelygyulladás
colpo-	hüvely-, vagino-, kolpo-
colposcope	hüvelytükör, kolposzkóp
colposcopy	kolposzkópia,
column	columna, oszlop
combed	fésus, pectinatus
common	közönséges, vulgaris, vulgáris
compensation	kiegyenlítődés, egyensúly visszaállás, kompenzáció
component	alkotóelem
compound	vegyület, összetétel, összetett, anyag,
compound fracture	összetett/komplikált törés,
compound fractures	nyílt vagy komplikált törések,
compression	összenyomás, kompresszió, Nyomás gyakorlása valamire., Valami tömeegének a csökkenése, nyomás hatására.,
compressive bandage	nyomókötés,
compulsions	Ellenőrizhetetlen gondolatok, vagy cselekedetek egy cselekvés véghezvitelére, ami gyakran ismétlődő, mint egy
conception	fogamzás, koncepció
concha bulosa	Az orrkagyló megnagyobbodása és léggömb szerű kidudorodása. Ez egy normális anatómiai variáns, de néha nagyon
concomitant	concomitans, kísérő, accompanying
condition	állapot, status, conditio, -sis
conductance	konduktancia,
condyle	condylus,
condyloma	Szemölcsökre hasonlító növések a bőrön vagy a nyálkahártyán, általában az anus és a nemi szervek körül.,
condylomata	a condyloma többes száma
conference call	konferencia hívás
confluent	confluens, összefolyó
confused	zavarodott, konfúzus
congenital	veleszületett, kongenitális
congestion	vértolulás, congestio
coniosis	coniosis, porártalom
conjunctiva	conjunctiva, kötőhártya (szemben)
conjunctivitis	conjunctivitis, kötőhártya-gyulladás, konjunktivitisz,   (szintén lásd: kötőhártya)
connection	ansa, összeköttetés
connective tissue	kötőszövet, Ez az anyag rostokból felépített hálózat és támasz szerkezet a szervezet szövetei és szervei
consanguinity	consanguinitas, vérrokonság
consolidation	konszolidáció,
constipation	konstipáció, szorulás, székrekedés, obstipáció
consultant	konzultáns, konzultáló orvos, szaktanácsadó
contagious	contagiosus, ragályos, fertőző, infectiosus
contaminated	fertőzott, szennyezett, kontaminált
continence	continentia, visszatartás
contour	körvonal
contouring	körvonalazás
contraception	antikoncepció, fogamzásgátlás
contractile	összehúzódásra képes, contarctilis
contraction	összehúzódás
contraindication	ellenjavallat, kontraindikáció
contralateral	ellenoldali, kontralaterális, ellenkező oldali
contrast medium	kontrasztanyag, Oldat amelyet a szervezet különböző részeinek a kihangsúlyozására használnak a
contusion	contusio, zúzódás
convulsion	convulsio, konvulzió, görcs, görcsös rángatózás, görcsös vonaglás,
copro-	bélsár-, kopro-, szterko-, széklet-
coprolalia	coprolália,
coprophagia	bélsárevés, koprofágia
coracoid process	hollócsőrnyúlvány, processus coracoideus,
core	nucleus, mag
cornea	cornea, a szem szaruhártyája
corneal	korneális, szaruhártyával kapcsolatos
coronary angiography	koronarográfia, a koszorúerek kontrasztanyagos röntgenvizsgálata,
coronary arteries	szívkoszorúserek, arteriae coronariae cordis
coronary artery	koszorúsér, arteria coronaria cordis
coronary intervention	koszorúéren végzett beavatkozások
corpus	test,
corpus callosum	Idegrostok vastag kötege amely a két agyféltekét köti össze.
corpus luteum	sárgatest, corpus luteum
corpuscle	testecske, corpusculum
cortex	cortex, kéreg
cortical	agykérgi, kortikális, kérgi, kéreggel kapcsolatos
cortical cyst	kéregben található ciszta, corticalis cysta
cortico-	cortico-, kéreg-
cortisol	kortizol,
coryza	coryza, nátha
costal	kosztális, bordával kapcsolatos
cough	köhögés, tussis
cover	tető, tegmentum, tegmen, takaró
covering	tectorius, beborító, befedő
coxa valga	Csípő deformitás, ahol a femur nyaka és teste közötti szög meg van nagyobbodva., coxa valga
coxa vara	coxa vara,
crabs	lapostetű, peduculus pubis
crack	scissura, repedés
crackles	ropogás (tüdő halgatásakor)
cramp	crampus, görcs, fájdalommal járó görcsös izomösszehúzódás
cramps in the calf	systremma, lábikra izomgörcs
cranial	kraniális, 1. koponyával kapcsolatos, 2. a test fej része felé irányuló,
cranial nerves	agyidegek, nervi craniales,
cranio-	cranio-, koponya-
craniosacral	1. a koponyával és a keresztcsonttal kapcsolatos, 2. a paraszimpatikus idegrendszerrel kapcsolatos.,
craniotomy	a koponya sebészeti bemetszése, craniotomia
cranium	koponya, cranium
cream	kenőcs, unguendum
creatinine	kreatinin, Kreatin anhidrid, C4H7N3O, amely a kreatin anyagcserefolyamatából keletkezik. Megtalálható az
creatinine kinase	egy izomban található enzym, amely vérszintje izomsérüléskor, vagy izombetegségek esetében megemelkedik
creatinine phospho kinase	egy izomban található enzym, amely vérszintje izomsérüléskor, vagy izombetegségek esetében
creation	-poesis, -poézis, -képzés
credit card	hitelkártya,
cremation	hamvasztás, crematio, incineratio, hullaégetés
cremor	krém, krémrehasonlító anyag, penész, tajték,
crepitation	sercegés, crepitatio
CREST syndrome	A szisztémás szklerózis egy formája, amely jellemzői a következők: mészlerakódás (Calcinosis) főleg sz
crevice	repedés, vagy kis fisszúra tömör anyagokban
cribriform	szitaszerű, cribriformis
cricoid	gyűrű szerű, gyűrűporcal kapcsolatos, cricoideus
cricoid pressure	A gyűrűporcra kifejtett enyhe nyomás, amit a nyelőcső elzárására használnak pozitív nyomásos
crista	taraj, crista
critical care	sürgősségi ellátás,
cross laps	lásd: beta cross laps
cross shaped	cruciformis, kereszt alakú
cross-eyedness	strabizmus, kancsalság
crossed	cruciatus, keresztezett
crossed fused renal ectopia	A két vese fúziója, ahol legalább az egyik vese a normális helyétől az ellenkező oldalon
crossing	chiasma, keresztezsdés
crossover	a kromozómák közti kölcsönös genetikai anyag cseréjének eredménye
croup	laryngitis subglottica
crural	krurális, lábszárral kapcsolatos
crural ulcer	lábszárfekély
crush injuries	zúzódásos sokk, zúzódásos sérülések,
crust	crusta, var
cryo-	hideg, fagyos, fagy-
cryotherapy	kezelés hideggel vagy fagyasztással, cryokezelés
CSF (cerebro spinal fluid)	liquor, likvor, gerincnedv, agyvíz, liquor cerebrospinalis
Csillag's Disease, Planus Type	lásd: lichen planus
cube-like	cuboideus, köb alakú
cuboid bone	köbcsont, os cuboideum
cuff	mandzetta (lehet felfújható)
cummulation	kumuláció, felhalmozódás
cure	gyógyulás, végleges kigyógyulás valamiből
curettage	curettage, méhkaparás
curvature	curvatura, görbület
curve	flexura, hajlat
Cushing's syndrome	a mellékvese fokozott működéséből eredő szindróma, Cushing-szindróma,
cuspid tooth	szemfog, dens caninus
cut	-metszés, -tómia
cut	sectio, vágás, tómia
cutaneous	cutaneus, bőrrel kapcsolatos
cutaneous horn	borszarv, cornu cutaneum
cutdown	katéter sebészeti érbejuttatása
cutting energy	az energia csökkentése
CVA	cerebro vascular accident
cyanosis	cianózis, szederjesség
cyanotic	cianotikus, szederjes
cyst	ciszta,
cystectomy	ciszta sebészeti eltávolítása (érthetik epehólyagra, vagy húgyhólyagra is), cystectomia
cystic	tömlős, cisztikus
cystic fibrosis	cisztás fibrózis,
cysticercosis	cysticercosis, borsókabetegség
cystitis	húgyhólyaggyulladás, húgyhólyaghurut
cysto-	ciszto-, húgyhólyag
cystocele	cystokele, húgyhólyagsérv, cystocele
cystography	a húgyhólyag kontrasztanyagos röntgenvizsgálata, cisztográfia
cystolithiasis	cystolithiasis, kövek jelenléte a húgyhólyagban
cystoscopy	cisztoszkópia, húgyhólyagtükrözés
cyto-	sejt-, cito-
cytology	sejttan, citológia
cytolysis	sejtoldódás, citolízis
cytoplasm	sejtplazma, citoplazma, A sejtmaghártyán kívül elhelyezkedő sejtállomány.,
cytostatic agent	citosztatikum, sejtosztódást megállító anyag
cytotoxicity	sejmérgezés, sejtekre való mérgező hatás kifejtése
daltonism	daltonizmus, a vörös és a zöld színtévesztése
danger	periculum, veszély
dangling	pendulus, függő
daycare	napközi, óvoda
De Ritis ratio	De Ritis hányados,
deaf and mute	surdimutitas, süketnémaság
deafness	anacusis, süketség
death	mors, halál
debridement	débridement, sebkimetszés
decibel	dB, decibel
decidua	decidua, hullóhártya
decidual teeth	tejfogak, dentes decidui
deciduous cell	deciduális sejt (lásd: decidua)
decubitus	dekubitusz, felfekvés
deep	mély, profundus
deep tendon reflexes	mély ín reflexek, (pl. Achiles ín, biceps ín, patelláris, stb..)
defecation	defaecatio, széklet ürítés, székelés
defect	hiba, a test valamelyikrészének valamilyen baja, defectus
deferent	deferens, kivezető, levezető
definitive	végleges döntés, végleges határozat, definitív
degeneration	degeneráció, elkorcsosodás, elfajulás
degloving	1. Az állkapocscsont sebészeti felfedése, úgy, hogy az alsó ajkat és az áll puha
deglutination	nyelés, deglutitio
dehiscence	dehistentia,
dehydration	dehydratáció, kiszáradás, dehydratio
deletion	törlés (pl. bázist a génből), deléció
delirium	lázálom, delírium
delivery	partusz, szülés
delivery	toco-, toko-, szülés-
deltoid muscle	deltaizom, musculus deltoideus
deltoid tuberosity	tuberisitas deltoidea,
delusion	téveszme, doxasma
dementia	dementia, elbutulás
demyelisation	demielizáció, elvelőtlenedés
density	sűrüség, densitas
dent	kis behorpadás
dental eruption	fogáttörés, eruptio dentis
dentist	sztomatológus, fogorvos
denudation	denudáció, lecsupaszítás
dependence	függőség, dependencia
dermal	dermális, bőrrel kapcsolatos
dermatitis	bőrgyulladás
dermato-	bőr-, dermo-, dermato-
dermatology	bőrgyógyászat, dermatológia
dermatom	bőrgyalu, dermatom
dermatome	bőrszelvény, dermatoma
dermis	dermis, irha,
dermo-	bőr-, dermo-, dermato-
desaturation	deszaturáció,
descendent	leszálló, deszcendens
descendent colon	leszálló vastagbél, colon descendens
desinfection	dezinfekció, fertőtlenítés
desmoid	ínra hasonlító
desorientation	dezorientáció,
desoxyribonucleic acid	DNS, dezoxiribonukleinsav
desquamation	bőrhámlás, hámlás, desquamatio
destruction	destrukció, tönkretétel, szétbomlasztás,
deterioration	deterioratio, állapot romlása
detoxification	detoxikáció, méregtelenítés
detrusor	detrusor, kilökő
deviation	ferdülés, elhajló, a normálistóleltérő, deviatio
dextro-	laevo-, bal-
dextrocardia	dextrocardia, jobboldali szív
diabetes	cukorbetegség, diabetes mellitus
diabetic ketoacidosis	DKA, diabetikus ketoacidózis
diabetology	a diabétesszel foglalkozó orvosi tudományág, diabetológia
diagnosis	diagnózis, kórismeret
diagnostics	diagnostica, diagnosztika, a betegségek megállapításának a tudománya
diaphoresis	diaforézis, izzadás
diaphragm	diaphragma, rekeszizom,
diarhea	diarrhoea, hasmenés
diastasis	diastasis
diastole	szívelernyedés, diasztolé, szívizom-elernyedés
diathesis	hajlam, diatézis
diencephalon	köztiagy, diencephalon
dietary nurse	diétás nővér
diffuse	diffúz,
diffusion	szétterjedés, diffúzió
digestion	emésztés, digestio
digital	ujjal kapcsolatos, ujjal elvégzett, digitális
digits	kézujjak, digiti manus
dilatation	dilatáció,
dilution	dilúció,
dimple	foveola, gödröcske
dimpling	scrobiculus, mélyedés
diplegia	A test mindkét oldalán található megegyező testrészek paralízise., diplegia,
disability	ez egy állapot ahol a betegség, sérülés vagy más behatás megnehezíti olyan
discomfort	kellemetlenség, kényelmetlenség
discopathy	discopathia, csigolyaközi porckorong megbetegedés
discrepancy	aránytalanság, nem egyformaság, nem ugyan az, discrepantia
discus	porckorong, lemez,
disease	betegség, kór, morbus
disk	korong,
disk herniation	korongsérv, porckorongsérv, discushernia, hernia disci,
disk protrusion	protrusio disci,
dislocation	diszlokáció, elmozdulás, kificamodás
dismutation	disproportionation, diszmutáció, diszproporcionálódás, A redox folyamatok
disorder	rendellenesség
disproportionation	lásd: dismutation
dissected	lehasított, széthasított, dissecans
dissecting	száthasító, hasító, dissecáló
dissecting aneurism	olyan aneurizma, ahol a vér utathasít magának az érfal rétegei között,
disseminated	disseminatus, szétszórt
dissonance	viszály, nézeteltérés, dissonancia, (lásd: kognitív dissonancia)
distal	disztális, távolabbi (a test középpontjától)
distal tip	distalis vég, distalis csúcs
distorsion	distorsio, disztorzió, rándulás, csavarodás, eltorzulás,
distress	gyötrelem, fájdalom, szenvedés,
diuresis	diurézis, vizeletkiválasztás
diuretic	diuretikum, vízelhajtó, vizelethajtó
divergent	széttartó, divergens
diverticulitis	diverticulitis,
diverticulosis	divertikulumok (lásd: divertikulum) jelenléte a beleken, divertikulózis
diverticulum	divertikulum,
dizentery	vérhas, dizentéria
dizziness	szédülés, vertigo
DNA	DNS, dezoxiribonukleinsav
dog tooth	szemfog, dens caninus
dorsal	dorzális, háttal kapcsolatos
dorsiflection	hátradőlés,hátrahajlás, dorziflexió
dorsum	hát, dorsum
dose titration	Adagolás a kívánt hatás eléréséig., (pl. morfium fájdalomcsillapításra)
double dummy	Ez az eljárás lehetővé teszi két dózis forma összehasonlítását, mint pl.
double vision	diplopia, kettős látás
douglas	lásd: douglas tasak
downward titration	lefelé titrálás,
draft	vázlat
drain	Egy eszköz, amivel folyadékot távolítunk el egy üregből, vagy sebből. Általában ez
drainage	lecsapolás
dream	álom, alvás, somnus
drilling	fúrás
drooling	nyálcsorgás, salivatio, nyálzás,  ptyalismus
drop	csepp, gutta
drug	1. gyógyszer, orvosság, 2. kábítószer
drug data sheet	gyógyszer adatlap, A gyógyszer tulajdonságait leíró adatlap.
drum	tympanum, dob
dry	száraz, xero
dry mouth	szájszárazság, xerostomia
dry powder inhaler	szárazpor-inhalátor (DPI)
drying	siccatio, szárítás
dubious	dubiosus, kétes, kétséges, dubiózus
duct	cső, csatorna, ductus, vezeték
dull	tompa
dull throbbing	tompa lüktetés
dull throbbing pain	tompa lüktető fájdalom
duodenal	duodenális, nyombéllel kapcsolatos
duodenal ulcer	nyombélfekély, ulcus duodeni
duodenal ulcus	lásd: duodenal ulcer
duodenoscopy	nyombéltükrözés, bulboscopia
duodenum	patkóbél, nyombél
dwarf	nanus, törpe
dyscalculia	diszkalkúlia,
dyscharge	fluor, folyás
dysdiadokokinesia	a beteg nehezen tudja a gyorsan változó és ismétlődő mozgásokat
dysentery	vérhas, dizentéria, A belek gyulladásos betegsége, melyet általában baktériumok,
dysgenesis	Egy bizonyos szerv hibás vagy abnormális kifejlődése., dysgenesis
dysgeusia	lásd: parageusia
dyskaryosis	Enyhe sejtelváltozás, ahol a sejtmag hyperchromatikus, megnagyobbodott,
dyskinesia	Az akarattal irányított mozgás eltorzulása vagy nehezen kivitelezhetősége.
dyslexia	Az írott szavak felismerésének és felfogásának hibájával járó tanulási
dyslipidemia	dyslipidaemia, a lipidek (zsírok) normálisnál magasabb szintje a vérben,
dysmorphic	rendellenessen formázott testrész (pl. fül, orr, stb..)
dysphonia	A hang károsodása vagy elváltozása. Nehéz beszéd. A rekedtség egy gyakori
dysphoria	diszfória, 1. Hangulat, melyre a következők jellemzők: elégedetlenség,
dysplasia	diszplázia,
dysplastic erythroid precursors	dysplasticus erytroid precursorok,
dyspnea	diszpnoé, dyspnoe, nehézlégzés, légszomj
dystonia	disztónia, izomtónus rendellenesség
dystrophy	tápanyag hiánya okozta szövetsorvadás, dystrophia
dysuria	fájdalmas vizelés
ear	auris, fül, oto-, fül-
eardrum	dobhártya, membrana tympani, myringo-, tympano-
early	korai, praecox
earwax	fülzsír, cerumen
ecchymosis	ecchymosis, bőr bevérzés, folt, bruise
ECG	EKG, elektrokardiogram, elektrokardiográfia
echo	viszhang (szintén lásd a rövidítések részleget)
echolalia	echolália,
echopoor	hypoechogén,
eclampsia	rángógörcs, Kóma és rángógörcs a terhesség alatt, vagy közvetlenül utána, amit
ecto-	ekto-, külső
ectopic pregnancy	méhen kívüli terhesség, ectópiás terhesség
ectropion	ectropion, szemhéj kifordulás,
ectropium	lásd: ectropion
ectropody	A láb teljes, vagy részleges veleszületett hiánya.,
edema	oedema, ödéma, vizenyő
edematous	megdagadt, oedemás
EEG	elektroencefalográfia, EEG
efferent	efferens, elvezető
egg	óvum, petesejt, tojás
egy cső, vagy géz., (to drain	lecsapolni)
ejaculation	ejakuláció, ondókilövelés, kilövelés
ejection	ejekció, kilökés
elapsed	eltelt
elapsed time	eltelt idő
elastic artery	elasztikus típusú artéria
elasticity	elaszticitás, rugalmasság
elbow	cubitus, könyök
electicution	electrocutio, villanyáramütés
electric shock	áramütés, elektrotrauma
electrocardiogram	EKG, elektrokardiogram
electrocardiography	elektrokardiográfia, EKG
electrocorticography	elektrokortikográfia, ECG
electroencephalography	elektroencefalográfia, EEG
electromyography	elektromiográfia, EMG
elongation	elongáció, megnyúlás, nyújtás, extenzió
embolectomy	embolektómia
embolism	embólia
embolysm	érdugulás, embólia
embryo	magzat, embrió (a testalakjának kialakulása előtt), Így nevezik az emberi utódot a
emergency contraceptive medication	sürgősségi tabletta, morning after pill,
emergency medicine	oxiológia, oxyológia, sürgősségi orvostan,
emesis	hányás, vomitus
EMG	elektromiográfia, EMG
emission	kibocsátás, emisszió
emmetropia	emmetropia,
emollition	malacia, lágyulás, emollitio
emotion	érzelem, emóció
empiric	empirikus, tapasztalaton alapuló
empty	vacuus, üres
empty sella syndrome	gyakran fordul elő túlsúlyos, magasvérnyomásban szenvedő nőknél. A
emptyness	üresség
empyema	gennygyülem, empyema
enamel	enamelum, fogzománc
enanthem	enantéma, nyálkahártyakiütés, enanthema
encephalo-	agyvelő-, encefalo-, cerebro-
encephalocele	agysérv, encephalokele, agyvelősérv
encephalolith	agykő, encephalolith
encephalopathy	agyvelőbántalom, encephalopathia
end stage	végső állapot (pl. betegségnél)
end-to-end	vég a véghez
end-to-side	vég az oldalhoz
endo-	belső-, endo-
endocarditis	endocarditis
endocardium	endocardium
endocervical	endocelvicalis,
endocervix	endocervix,
endocrine	endokrin, belső elválasztású
endocrinology	endokrinológia, Orvosi tudományág amely a belső elválasztású hormonális
endodontist	a fogbél és foggyökér betegségeire szakosodott orvos
endodontitis	fogbélgyulladás, pulpitis
endogenous	endogén,
endolymph	endolympha,
endometrial proliferation stage	endometrium proliferatios szakasz,
endometriosis	endometriosis,
endometrium	méhnyálkahártya,
endomysium	lásd: perimysium internum
endorphin	A szervezet természetes fájdalomcsillapítói. Vegyileg ezek morfiumhoz hasonló
endoscope	endoszkóp, A test üregeinek vizsgálatára használt eszköz. Általában egy
endothelial	endotheliummal kapcsolatos, lásd: endothelium
endothelium	endothelium,
enema	enema, beöntés
engorgement	plethora, vérteltség
engorgement	vérteltség, plethora
enhancement	kihangsúlyozás, valaminek a megerősítése,
enopthalmus	szembesüllyedés, enophthalmus
enterobacterium	Gram negatív, pálcika formájú baktérium az Enterobacteriaceae családból.
enteropathy	enteropathia, bélbántalom, bélbetegség
enterotoxin	enterotoxin,
entity	lét, lényeg, valóság, jogi személy
entrance	introitus, bejárat
entropium	szemhéjbefordulás
enuresis	ágybavizelés, enuresis, bedwetting
environment	milieu
enzim	Anyag, amely felgyorsítja a vegyi folyamatokat anélkül, hogy saját maga
eosinophil	eozinofil, érett granulociták amelyek az allergiás álapotokra és a parazitákra
epicondyle	csontbütyöknyúlvány, epicondylus (izomtapadásra szolgál)
epicondylitis	csontbütyöknyúlványgyulladás, epicondylitis
epicondylitis humeri lateralis	teniszkönyök, tennis elbow
epicondylitis humeri medialis	golfkönyök, golf elbow
epicrisis	Kritikus analízise vagy megvitatása egy betegségnek, miután már végetért.,
epidemiological	epidemiológiával kapcsolatos, (szintén lásd: epidemiológia)
epidemiology	epidemiológia, járványtan
epidemy	epidémia, járvány
epidermal	epidermális,
epidermis	epidermisz, felhám
epididymis	epididymis, mellékhere
epididymitis	epididymitis, mellékhere gyulladás
epigastric	gyomortáji, epigasztrikus
epigenetics	Egy orvosi tudományág, amely öröklődő változásokkal foglalkozik DNS szekvenció
epiglottis	gégefedő, epiglottis
epilation	szőrtelenítés, epilálás,
epilepsy	epilepszia,
epinephrine	epinefrin, adrenalin
episiotomy	epiziotómia
epistaxis	epistaxis, orrvérzés
epithelial	epitheliummal kapcsolatos, (szintén lásd: epithelium)
epithelioma	laphámdaganat, epithelioma
epithelisation	epitelizáció, hámképződés
epithelium	fedőhám,
epitop	az antigén azon része (molekulacsoportja), amellyel az ellenanyaghoz kötődik,
Epley maneuver	Epley manőver,
eradication	kiirtás, teljes megszabadulás valamitől, eradikáció
erection	erekció, merevedés
ergotherapy	a személy funkcionális függetlenségének megteremtésére irányuló felmérés és
erysipel	orbánc, erysipelas
erysipelas	Szent Antal tüze, erysipelas
erysipeloid	sertésorbánc, erysipeloid
erythema	eritéma, bőrpír
erythema infectiosum	eritéma infekciózum, ötödik betegség, fifth disease,
erythro-	vörös, ruber, eritro-, vörös-, erythro-
erythrocyte	eritrocita, vörösvérsejt
erythrocyte sedimentation rate	ESR, Westergen (We), vérsejtsülyedés, (lexikon)
erythroplakia	bársonyos felszínű vörösses folt a szájban, erytroplakia
esophageal	özöfageális, nyelőcsővel kapcsolatos
esophagus	oesophagus,
ESR	vérsejtsüllyedés, Westergren (We)
estradiol	ösztradiol,
estrogen	ösztrogén,
ethmoid	etmoidális, ethmoidalis, rostacsonttal kapcsolatos, (diakok)
ethmoiditis	etmoiditis, rostacsontgyulladás,
ethyology	lásd: etiology
etiology	kóroktan, etiológia, A betegségek okait és eredetét vizsgáló orvosi tudományág.,
eunuch	eunuch, herélt férfi
euthyroidism	lásd: euthyroid
evaporation	párolgás, evaporatio
evulsion	evulsio, kiszakítás
Ewing's sarcoma	Rosszindulatú csontvelődaganat, ami leggyakrabban a medencében és a
exacerbation	súlyosbodás, exacerbáció, fellángolás, exacerbatio
exanthem	exanthema,
excessive	excesszív, túlzott
excision	excízió, kivágás
excision	kimetszés, excízió
excoriation	kisebesedés, excoriatio
excretion	exkréció, kiválasztás
exhaustion	kimerülés, exhaustio
exo-	külső-, exo-
exocrine gland	külső elválasztású mirigy,
exogenous	külső eredetű, exogén,
exopthalmus	szemkidülledés, exophtalmus
expansion	tágulás, kitágítás, expanzió
expectoration	expectoratio, köpetürítés
expiratory	kilélegzési
exsanguination	elvérzés, exsanguinatio
extension	extenzió, kinyújtás, feszítés
extension study	Az eredeti tanulmány, vagy kísérlet kibővítése.,
extensive	kiterjedt, extenzív
extensive intraductal carcinoma	kiterjedt kivezetőcsőben található rák
extensor	extensor, feszítő, kiegyenesítő, nyújtó
external	externus, külső
extracapsular	ízületi tokon kívüli
extracardial	szíven kívüli, extracardialis
extraction	kihúzás, extrakció
extrahepatic	májon kívüli, extrahepaticus
extrauterine	méhen kívüli
extrauterine pregnancy	méhen kívüli terhesség
extravasation	A vér kiszivárgása az érből az azt körülvevő szövetekbe.
extreme	extrém, véglet
extremity	extremitas, végtag
eye	szem, oculus
eye-	oculo-, okulo-, szem-, ophthalmo-
eyeball	szemgolyó, bulbus oculi
eyebrow	supercilium, szemöldök
eyelashes	szempilla, cilium
eyelid	palpebra, szemhéj
fabella	a gastrocnaemius izom laterális fejének az ínjában található sezamcsont, fabella
face	1. arc, facies, 2. szembesülni., kitenni valakit, vagy valamit valakinek, vagy
facial	faciális, arccal kapcsolatos
facial nerve	nervus facialis,
facility	intézmény
factitious	facticius, mesterséges
Factor V deficiency	az alvadáshoz szükséges Factor V protein hiánya ami vérzéssel járó
failure	meghibásodás, romlás, leromlás, kudarc
failure to thrive	Egy állapot, ahol a gyermek súlygyarapodása és növekedése messze elmarad
faking	szimulálás, betegségek tettetése
falling	cadens, süllyedő
falx	sarló, falx
family history	családi kórtörténet
famine	éhség
farsightedness	távollátás, hypermetropia
fascia	fascia, izompólya, izombőnye
fascicle	fasciculus, köteg, nyaláb
fasting	éhomi,
fat	adeps, zsír, lipo, kövér, crassus, steato-
fat-	zsír-, szteato-
fatal	fatális, végzetes
father	apa, pater
fear	félelem, pavor, fóbia, iszony, phobia
fear of depth	bathophobia, mélységiszony
febrile	lázas, febrilis
febrile seizure	lázgörcs
feces	széklet, faeces, bélsár
fecula	magok keményítő alapú része,
feeling	sensus, érzék
felon	whitlow, körömágy-gyulladás, az ujj végének a gennyes gyulladása,
femoral	femorális, combcsonttal kapcsolatos
femoral artery	combartéria, arteria femoralis, combverőér
femoral hernia	combsérv, hernia femoralis
femoral neck	combnyak, collum femoris
femoral neck fracture	combnyaktörés, fractura colli femoris
femur	combcsont, femur
fenestration	ablak készítése, nyílás készítése valamin, valami felnyitása, fenestratio
ferritin	Ez egy vas-protein komplexus, amely egészen 23% vasat tartalmazhat, amely a vas
fertile	termékeny, fertilis
fertilisation	fecundatio, megtermékenyítés, termékenyítés, fertilizáció
fertility	fertilitás, termékenység
fetal	magzattal kapcsolatos, fetalis, (szintén lásd: fetus)
fetoscopy	fetoszkópia, fetoscopy
fetus	magzat, fetus (a test alakjának kialakulása után)
fever	febris, láz, pirexia
fiber	fibra, rost
fiber-like	filiform, fonal alakú
fibrillation	fibrilláció, 1. Finom, gyors egyedülálló izomrostrángatózás az izom mozgatása
fibrillin-1 gén	FBN1, Ez a gén mutálva van a Marfan szindrómában és a MASS szindrómában.
fibrin	Rostos fehérje, amely fontos szerepet játszik a véralvadásban és fibrinogénből
fibrinogen	vérplazmában található fehérje ami trombin hatására fibrinné változik,
fibroblast	a kötőszöveti sejt (fibrocyta) fiatal alakja, fibroblast
fibroepithelioma	Bőrdaganat, amely rostos szövetből áll és amelyen keresztül az epidermis
fibroglandular	fibroglanduláris,
fibroid	rostdaganat, fibroid
fibroleiomyoma	leiomyofibroma,
fibromyalgia	Gyakori krónikus rendellenesség. Jellemző rá a kiterjedt izomfájdalom,
fibrosis	fibrosis,
fibrotic	fibrotikus,
fibula	szárkapocs, fibula, lábszárcsont
fibular	szárkapcsi, fibuláris
fifth disease	lásd: erythema infectiosum
fifth finger	kisujj, digitus minimus
filter	filter, szűrő
finding	lelet
fine needle aspiration biopsy	FNAB,
finger	dactylus, ujj, digitus
fingerprint	ujjlenyomat, daktilogram
fingers	kézujjak, digiti manus
first toe	hallux, nagy lábujj, öreg lábujj
fissure	berepedés, fissura, repedés
fistula	fistula, fisztula, sipoly
fixation	fixáció, rögzítés
fizzy	pezsgő, effervescens
flacid	flaccidus, elernyedt, petyhüdt
flag	zászló
flagged	megjelölt
flagged chart	a betegről készült orvosi jegyzetek megjelölése. (pl. vigyázzat alkoholista)
flank	ágyék, lumbus, psoas
flashcard	tanulásra vagy tesztelésre használt kártyák
flat	sík, planus
flatus	szél, flatus
flea-bite	bolhacsípés, pulicosis
flexibility	hajlékonyság, flexibilitás
flexible	flexibilis, hajlékony
flexion	flexió, hajlás, hajlítás
flexor	flexor, hajlító
floating on the surface	szupernatáns, a felületen úszó
fluctuation	unduláció, hullámzás
fluid	fluidum, folyadék
fluidothorax	folyadékkal telt mellkas,
fluoroscopy	flouroszkópia
foamy	effervescens, habzó
focal	központi, központban lévő, focalis
focal sparing	érintetlen, vagy eredeti állapotában megmaradt központi rész
fold	plica, redő
folic acid	levélsav, acidum folicum, folsav
folicle	tüsző, folliculus
follicular	follikuláris, tüszős
folliculitis	folliculitis, szőrtüszőgyulladás
fonation	hangképzés, fonáció
fontanel	fontanella, kutacs, fonticulus
food	alimentum, táplálék
food intake	táplálékfelvétel, ingestio
foot	pes, láb, ped-
foot sweating	lábizzadás, acrohyperhidrósis
forearm	alkar, antebrachium
forebrain	előagy, prosencephalon,
forehead	frons, homlok
foreign	idegen-, xeno-
foreign body	idegentest, corpus alienum
forensic	bírósági, forensicus
foreskin	fityma, praeputium
foreskin	posthio-, fityma-, praeputium
forhead	metopo-, homlok-
formication	formicatio, hangyamászásérzés
fornix	boltozat, fornix
forth finger	gyűrűsujj, digitus anularis
fortification	sánc, vallum
fossa	fossa, árok
fotosensitive	fotoszenzíbilis, fényérzékeny
four times a day	QID, négyszer naponta
fraction	frakció, rész
fractura cranii	koponya törés
fracture	csonttörés, fractura, törés
fragile	törékeny, fragilis
fragility	fragilitás, törékenység
fragment	fragmentum, töredék
fragmentation	széttöredezés, fragmentáció
frame	stroma, váz
freckle	szeplő, ephelis
free radical	szabadgyök
freezing	congelatio, fagyás
fremitus	fremitus, rezgés
frenulum	ajakfék, frenulum labii
frenulum	nyelvfék, frenulum linguae
friction	dörzsölés, frikció, frictio
frontal bone	homlokcsont, os frontale
frontal sinus	homloküreg, sinus frontalis
frontooccipital	a homlokcsonttal és a nyakszirtcsonttal kapcsolatos
frontoparietal	a homlokcsonttal és a falcsonttal kapcsolatos
frontotemporal	a homlokcsonttal és a halántékcsonttal kapcsolatos
fugitive	fugax, múlékony
fulminant	fulmináns, villámgyors, heves
fulvic acid	fulvósav, Sárga, vagy sárgás barna humin anyag, amely a vízben oldódó
fundus	fenék, fundus, alap, basis
fungemia	fungaemia,
fungus	fungus, gomba, miko-, gomba-
funnel	infundibulum, tölcsér
furrow	sulcus, barázda
fusion	fúzió, egyesülés
fuzzy	bolyhos, frondosus
gadopentetic acid	gadopentetát (kontrasztanyag)
galacto-	tej, lac, lakto-, galakto-
galactorhea	galactorrhoea, tejcsorgás, tejfolyás
gallbladder	epehólyag, vesica fellea
gallbladder polyp	epehólyag polip, polyp cholecystae
gallbladder sludge	sludge cholecystae,
gallstone	epekő, calculus biliaris (röntgen)
Gamma GT	gamma-glutamyltransferase, GGT, γGT, gamma-glutamil transzpeptidáz (szakok)
gamma-glutamyltransferase	GGT, γGT, Gamma GT, gamma-glutamil transzpeptidáz (szakok)
ganglioglioma	ganglioglioma,
ganglion	1. idegdúc, 2. idegközpont, 3. Ínburokból eredő ciszta, ami általában a csuklón
ganglion chain	ganglion lánculat, ganglionok csoportja, szintén lásd: ganglion
gangrene	üszkösödés, gangréna, üszök
gangrenous	gangraenosus, üszkös
gash	seb, vulnus
gastrectomy	gastrectomia,
gastric ulcer	gyomorfekély, ulcus ventriculi
gastrinoma	gasztrinóma
gastritis	gyomorhurut, gastritis, gyomorgyulladás
gastro esophageal reflux disease	GERD, gastro-oesophagealis reflux betegség,
gastro-	gyomorral kapcsolatos, gastro-
gastrocnemius muscle	lábikraizom, musculus gastrocnemius
gastroenteritis	gastroenteritis, gyomor- és bélhurut
gastroenterologist	gastroenterológus,
gastroenterology	gastroenterológia,
gastroparalysis	gyomorbénulás, gastroparalysis
gastroscopy	gasztroszkópia
gastrulation	Az embrió kifejlődése, ahol a barázdálódáskor létrejött sejtek végleges
gate	kapu, porta
gender	nem,
gene silencing	gén elhalgattatás
generalist	Általános orvor, aki a legtöbb betegséggel foglalkozik, ahol nincs szükség
genesis	genézis, keletkezés
genetic	genetikai, örökléssel kapcsolatos
genetics	örökléstan, genetika
genital	külső nemi szervel kapcsolatos, genitális
genital herpes	herpes genitalis,
genitalia	nemi szervek,
genome	A sejtben található gének összessége., genom
genotype	Egy élőlény, vagy sejt genetikai felépítése (itt nem a test formája értendő)
genuin	verus, valódi, verum
genus	faj, fajta, nem
germ plasm	A cytoplazmának az a része, amely a genetikai információt tartalmazza.
German measles	rubella, Enyhe lefolyású, kiütéses, fertőző betegség, amely képes
Gianotti-Crosti syndrome in children	acrodermatitis papulosa infantum,
giant	mega-, óriás-, megalo-, mega-, megalo-
giant	óriás,
Giardia lamblia	A nyombélben és az epehólyagban élősködő egysejtű ostoros, amely
giardiasis	Giardia lamblia által okozott fertőzés, giardiasis
gigantism	óriásnövés, gigantizmus
gilatoxin	glycoprotein neurotoxin, a mexikói gyöngyös gyík (Heloderma horridum horridum)
Gilbert's syndrome	Gilbert szindróma,
gingiva	fogíny, gingiva
gingivitis	gingivitis,
gland	mirigy, glandula
gland-	gland-, mirigy-
glandula	glandula, mirigy
glandular	glandularis, glanduláris, miriggyel kapcsolatos, mirigy része,
glans	glans, makk
glans penis	makk, glans
glass	üveg, hial-, hyal-, vitrum
glaucoma	glaukóma, zöld hályog, Gyakori szemrendellenesség, ahol a szemben található
Gleason tumor grade	a prosztata adenokarcinómájának az osztályozása amely a mirigyek
glia	lásd: neuroglia
glioma	glioma,
globulin	A fehérjék bármelyike, amelyek a vérben, tejben, izmokban és növényi magvakban
glomerular	gomolyagos, glomeruláris
glomerulus	gomolyag, a vesekéregben található érgomolyagok egyike
glossitis	nyelvgyulladás, glossitis
glotic	glottikus, hangréssel kapcsolatos
glucose	Egyszerű monoszacharid
glucose tolerance test	vércukor terheléses vizsgálat,
gluteal	gluteális, farral kapcsolatos
gluteal muscle	farizom, musculus gluteus
glycated hemoglobin	glikohemoglobin,
glycemia	glykaemia, glikémia,
glyco-	cukor-, gliko-, szacharo-
glycogenolysis	A glycogén lebontása glukózra hidrolísissel vagy foszforolízissel.,
salutogenesis	szalutogenézis, egészségteremtés
sanguinous	sanguineus, véres
sanguinous	sanguineus, véres
saphenous	- saphenus, elrejtett
saphenous	- saphenus, elrejtett
sapient	sapiens, bölcs
sapient	sapiens, bölcs
sapro-	szapro-, rothadás-
sapro-	szapro-, rothadás-
sarcoidosis	szarkoidózis,
sarcoidosis	szarkoidózis,
sarcolemma	szarkolemma, sarcolemma, izomrost burok
sarcolemma	szarkolemma, sarcolemma, izomrost burok
sarcoma	szarkóma, kötőszövet eredetű rosszindulatú daganat
sarcoma	szarkóma, kötőszövet eredetű rosszindulatú daganat
saturation	telítés, telítettség, átitatás
saturation	telítés, telítettség, átitatás
scab	crusta, var
scab	crusta, var
scabies	rühösség, scabies
scabies	rühösség, scabies
scaffold	álvány
scaffold	álvány
scale	pikkely
scale	pikkely
scaphoid	scaphoideus, sajka alakú
scaphoid	scaphoideus, sajka alakú
scaphoid fossa	sajkaárok, fossa scaphoidea
scaphoid fossa	sajkaárok, fossa scaphoidea
scapular	szkapuláris, lapockával kapcsolatos
scapular	szkapuláris, lapockával kapcsolatos
scapuloclavicular	a lapockával és a kulcscsonttal kapcsolatos
scapuloclavicular	a lapockával és a kulcscsonttal kapcsolatos
scapulohumeral	a lapockával és a felkarcsonttal kapcsolatos
scapulohumeral	a lapockával és a felkarcsonttal kapcsolatos
scar	sebhely, heg
scar	sebhely, heg
scare	ijedtség, pavor
scare	ijedtség, pavor
scarlatina	vörheny, skarlát
scarlatina	vörheny, skarlát
scarlet fever	skarlát, scarlatina, vörheny
scarlet fever	skarlát, scarlatina, vörheny
Scheuermann's disease	A vertebrális epifízisek fiatalkori osteochondrózisa., Scheuermann betegség
Scheuermann's disease	A vertebrális epifízisek fiatalkori osteochondrózisa., Scheuermann betegség
Schistosomiasis	Bilharsiasis (vérmételybetegség), Schistosomiasis
Schistosomiasis	Bilharsiasis (vérmételybetegség), Schistosomiasis
schizophrenia	skizofrénia,
schizophrenia	skizofrénia,
schizotypal personality disorder	skizotíp személyiségzavar,
schizotypal personality disorder	skizotíp személyiségzavar,
schizotypic personality disorder	skizotíp személyiségzavar,
schizotypic personality disorder	skizotíp személyiségzavar,
Schmorl body	A Schmorl-csomót a zárólemezen keresztül a csigolyatestbe sérvesedő nucleus pulposus okozza., Schmorl-csomó, Schmorl nodule,
Schmorl body	A Schmorl-csomót a zárólemezen keresztül a csigolyatestbe sérvesedő nucleus pulposus okozza., Schmorl-csomó, Schmorl nodule,
Schmorl nodule	lásd: Schmorl body
Schmorl nodule	lásd: Schmorl body
schwannoma	jóindulatú körülírt daganat amely az idegeket körülburkoló Schwann sejtekből ered
schwannoma	jóindulatú körülírt daganat amely az idegeket körülburkoló Schwann sejtekből ered
schyzophrenia	énhasadás, szkizofrénia, elmehasadás
schyzophrenia	énhasadás, szkizofrénia, elmehasadás
sciatic nerve	ülőideg, nervus ischiadicum
sciatic nerve	ülőideg, nervus ischiadicum
sciatica	ülőidegzsába, isiász
sciatica	ülőidegzsába, isiász
scintillation	szikrázás, szcintilláció
scintillation	szikrázás, szcintilláció
sclera	ínhártya, sclera,  a szem ínhártyája
sclera	ínhártya, sclera,  a szem ínhártyája
scleroderma	scleroderma, A scleroderma ritka kötőszövet rendellenesség, amit a bőr rendellenes megvastagodása jellemez. Több fajta scleroderma létezik. Vannak lokalizáltak, amelyek csak bizonyos testrészeket támadnak meg és vannak szisztémásak, amelyek az egész szervezetet és belső szerveit érintik.,
scleroderma	scleroderma, A scleroderma ritka kötőszövet rendellenesség, amit a bőr rendellenes megvastagodása jellemez. Több fajta scleroderma létezik. Vannak lokalizáltak, amelyek csak bizonyos testrészeket támadnak meg és vannak szisztémásak, amelyek az egész szervezetet és belső szerveit érintik.,
sclerosis	megkeményedés, szklerózis
sclerosis	megkeményedés, szklerózis
sclerotic	szklerotikus, megkeményedett
sclerotic	szklerotikus, megkeményedett
scrofula	scrofula, a nyaki nyirokcsomók gümőkór okozta megnagyobbodása
scrofula	scrofula, a nyaki nyirokcsomók gümőkór okozta megnagyobbodása
scrotal	szkrotális, herezacskóval kapcsolatos
scrotal	szkrotális, herezacskóval kapcsolatos
scrotal tongue	szkrótális nyelv,
scrotal tongue	szkrótális nyelv,
scrotum	herezacskó, scrotum
scrotum	orchi-, here-
scrotum	scrotum, herezacskó
scrotum	herezacskó, scrotum
scrotum	orchi-, here-
scrotum	scrotum, herezacskó
scull	koponya, cranium, calva, cranio-, koponya-
scull	koponya, cranium, calva, cranio-, koponya-
scurvy	skorbut, scorbut, C vitamin hiánya okozta betegség
scurvy	skorbut, scorbut, C vitamin hiánya okozta betegség
sebaceous	faggyús, sebaceus
sebaceous	faggyús, sebaceus
seborrhea	fagyúár, seborrhoea,
seborrhea	fagyúár, seborrhoea,
sebum	faggyú, sebum
sebum	faggyú, sebum
second	secundus, második
second	secundus, második
second vertebra	axis, második nyakcsigolya
second vertebra	axis, második nyakcsigolya
secondary wound healing	per secundam intentionem, másodlagos sebgyógyulás
secondary wound healing	per secundam intentionem, másodlagos sebgyógyulás
secretion	váladék, szekrétum
secretion	váladék, szekrétum
sedation	sedatio, szedálás, nyugtatás
sedation	sedatio, szedálás, nyugtatás
sedative	nyugtató, szedatív
sedative	nyugtató, szedatív
sedative agent	sedativum,
sedative agent	sedativum,
sedimentation	szedimentáció, üllepedés
sedimentation	szedimentáció, üllepedés
segment	szegmens, gerezd, metszet, rész, szelet
segment	szegmens, gerezd, metszet, rész, szelet
segmentation	szegmentáció, barázdálódás
segmentation	szegmentáció, barázdálódás
segregation	szegregáció, elválasztás
segregation	szegregáció, elválasztás
seizure	roham, Az agy rendezetlen elektrikus aktivitása, amely az egész test, vagy csak a test egy részének a rángotódzó görcseihez vezethet, vagy kis fizikai vagy gondolkozási rendellenességekhez vezethet.
seizure	roham, Az agy rendezetlen elektrikus aktivitása, amely az egész test, vagy csak a test egy részének a rángotódzó görcseihez vezethet, vagy kis fizikai vagy gondolkozási rendellenességekhez vezethet.
self	saját, auto
self	saját, auto
semen	semen, mag
semen	semen, mag
semi-	semi-, fél-
semi-	semi-, fél-
seminal	szeminális, ondóval kapcsolatos
seminal	szeminális, ondóval kapcsolatos
seminal vesicles	A húgyhójag alján található páros mirigy, amely spermafolyadékot és fruktózt termel., vesicula seminalis
seminal vesicles	A húgyhójag alján található páros mirigy, amely spermafolyadékot és fruktózt termel., vesicula seminalis
semivowel	magánhangzó mássalhangzó jelekkel (pl az angol W vagy Y)
semivowel	magánhangzó mássalhangzó jelekkel (pl az angol W vagy Y)
senile	szenilis, aggkori
senile	szenilis, aggkori
senior	nyugdíjas, idős ember
senior	nyugdíjas, idős ember
senior nurse	rangidős nővér
senior nurse	rangidős nővér
sensation	érzés, esztézia
sensation	szenzáció, érzékelés
sensation	érzés, esztézia
sensation	szenzáció, érzékelés
sense	érzék, sensus
sense	érzék, sensus
sensorineural hearing impairment	idegi halláskárosodás, A hallástérzékelő idegvégződések hibájából bekövetkezett halláskárosodás,
sensorineural hearing impairment	idegi halláskárosodás, A hallástérzékelő idegvégződések hibájából bekövetkezett halláskárosodás,
sensory organ	érzékszerv, organum sensuum
sensory organ	érzékszerv, organum sensuum
senzibility	szenzibilitás, érzékenység
senzibility	szenzibilitás, érzékenység
separation	szeparáció, elválasztódás
separation	szeparáció, elválasztódás
sepsis	szepszis, vérmérgezés, szeptikémia
sepsis	szepszis, vérmérgezés, szeptikémia
septal	szeptális, septummal kapcsolatos
septal	szeptális, septummal kapcsolatos
septotomy	septum bemetszése, septum kimetszése, septum bevágása, septotomia (általában az orrsövényre értendő)
septotomy	septum bemetszése, septum kimetszése, septum bevágása, septotomia (általában az orrsövényre értendő)
septum	sövény, septum
septum	sövény, septum
septum of the heart	szívsövény, septum cordis
septum of the heart	szívsövény, septum cordis
septum pellucidum	Idegszövetből alkotott vékony hártya, amely a laterális agykamra mediális falát alkotja.,
septum pellucidum	Idegszövetből alkotott vékony hártya, amely a laterális agykamra mediális falát alkotja.,
sequence	szekvencia, sorrend
sequence	szekvencia, sorrend
sequestration	sequestratio, csontelhalás
sequestration	sequestratio, csontelhalás
serious	súlyos, gravis
serious	súlyos, gravis
serology	serológia, szerológia, egy immunológiai tudományág amely az antigén-antitest reakció tanulmánzozásával foglalkozik,
serology	serológia, szerológia, egy immunológiai tudományág amely az antigén-antitest reakció tanulmánzozásával foglalkozik,
serotonin	C10H12N2O (5-hydroxytryptamine, or 5-HT) Triptofánból alkotott monoamin neurotranszmitter. Megtalálható főleg az agyban, savóban és a gyomor nyálkahártyájában. Szerepet játszik az erek összehúzódásában, simaizom stimulációban, idegsejtek közti ingerátvitelben és a ciklikus szervezeti folyamatok irányításában., szerotonin
serotonin	C10H12N2O (5-hydroxytryptamine, or 5-HT) Triptofánból alkotott monoamin neurotranszmitter. Megtalálható főleg az agyban, savóban és a gyomor nyálkahártyájában. Szerepet játszik az erek összehúzódásában, simaizom stimulációban, idegsejtek közti ingerátvitelben és a ciklikus szervezeti folyamatok irányításában., szerotonin
serotonin-syndrome	Ezt az állapot a magas szerotonin szint okozza az agyban. A tünetek lehetnek enyhék, mint a fejfájás, szédülés, hányás, de lehetnek nagyon súlyosak is mint a kóma és halál. További tünetek: magas test hőmérséklet, izzadás, magas vérnyomás, magas pulzus, hasmenés, izomrángás, hyperreflexia, rigiditás, reszketés, zavartság és agitáció. A szerotonin szindrómát általában a szerotoninergikus gyógyszerek kölcsönhat
serotonin-syndrome	Ezt az állapot a magas szerotonin szint okozza az agyban. A tünetek lehetnek enyhék, mint a fejfájás, szédülés, hányás, de lehetnek nagyon súlyosak is mint a kóma és halál. További tünetek: magas test hőmérséklet, izzadás, magas vérnyomás, magas pulzus, hasmenés, izomrángás, hyperreflexia, rigiditás, reszketés, zavartság és agitáció. A szerotonin szindrómát általában a szerotoninergikus gyógyszerek kölcsönhat
serous	serosus, savós
serous	serosus, savós
sertraline	sertralin
sertraline	sertralin
serum	savó, szérum
serum	savó, szérum
serum pool	több egyéntől összegyüjtött szérum keveréke
serum pool	több egyéntől összegyüjtött szérum keveréke
serum protein electrophoresis	szérum protein elektroforézis, A vér specifikus fehérjéi a globulinok vizsgálására használt laboratóriumi teszt. A szérumot agarózzal kezelt speciális papirra helyezik, majd villanyárammal a globulinokat öt csoportra osztják: albumin, alfa-1-globulinok, alfa-2-globulinok, beta globulinok és gamma globulinok.,
serum protein electrophoresis	szérum protein elektroforézis, A vér specifikus fehérjéi a globulinok vizsgálására használt laboratóriumi teszt. A szérumot agarózzal kezelt speciális papirra helyezik, majd villanyárammal a globulinokat öt csoportra osztják: albumin, alfa-1-globulinok, alfa-2-globulinok, beta globulinok és gamma globulinok.,
serum sickness	szérumbetegség, Egy túlérzékenységi reakció, amely idegen szérum beadására alakul ki. Az érfalban immunkomplexek rakódnak le. Csalánkiütéssel, lázzal, dagadással, izületi fájdalommal és nyirokcsomó-duzzanattal jár, mely tünetek 10-12 órán át tartanak.,
serum sickness	szérumbetegség, Egy túlérzékenységi reakció, amely idegen szérum beadására alakul ki. Az érfalban immunkomplexek rakódnak le. Csalánkiütéssel, lázzal, dagadással, izületi fájdalommal és nyirokcsomó-duzzanattal jár, mely tünetek 10-12 órán át tartanak.,
severity	súlyosság
severity	súlyosság
sex	sexus, nem
sex	sexus, nem
sexual	nemi, szexuális
sexual	nemi, szexuális
sexual aberration	fajtalanság, aberratio sexualis
sexual aberration	fajtalanság, aberratio sexualis
sexual intercourse	coitus, közösülés
sexual intercourse	coitus, közösülés
sexually transmitted diseases	STDs, nemi betegségek,
sexually transmitted diseases	STDs, nemi betegségek,
sezamoid bones	szezámcsontok, ossa sezamoidea
sezamoid bones	szezámcsontok, ossa sezamoidea
shake	commotio, rázkódás
shake	tremor, reszketés
shake	commotio, rázkódás
shake	tremor, reszketés
shaking	tremens, reszkető
shaking	tremens, reszkető
shear	deformálódik
shear	deformálódik
sheet	theca, hüvely
sheet	theca, hüvely
shield like	pajzs alakú, scutiformis
shield like	pajzs alakú, scutiformis
shin	az alsó végtag elülső része a térd alatt,
shin	az alsó végtag elülső része a térd alatt,
shingles	övsömör, herpes zoster,
shingles	övsömör, herpes zoster,
shock	sokk, shock
shock	sokk, shock
short	brevis, rövid
short	brevis, rövid
short-	brachy-, rövid-
short-	brachy-, rövid-
shoulder	váll
shoulder	váll
shoulder joint	articulatio humeri, vállízület, omarthros
shoulder joint	articulatio humeri, vállízület, omarthros
shoulder joint damage	a vállízület károsodása, omarthrosis
shoulder joint damage	a vállízület károsodása, omarthrosis
shoulder joint inflammation	a vállízület gyulladása, omarthritis
shoulder joint inflammation	a vállízület gyulladása, omarthritis
shoulder-	váll-, omo-, om-
shoulder-	váll-, omo-, om-
shoulderblade	lapocka, scapula
shoulderblade	lapocka, scapula
shunt	sönt, alternatív áramlási út
shunt	sönt, alternatív áramlási út
sialadenosis	sialadenosis,
sialadenosis	sialadenosis,
sialo-	sialo-, nyál-
sialo-	sialo-, nyál-
sialographia	szialográfia, nyálvezetékek kontrasztanyagos vizsgálata
sialographia	szialográfia, nyálvezetékek kontrasztanyagos vizsgálata
sialolith	nyálkő, sialolith
sialolith	nyálkő, sialolith
sibling	testvér
sibling	testvér
sickle	sarló
sickle	sarló
sickle cell anemia	sarlósejtes vérszegénység, Autozóm recesszív genetikai betegség, ahol valin helyett glutaminsav kódja található a hatos pozíción a beta-globin génben, ami a hibás hemoglobin S (HbS) termeléséhez vezet.Ha a HbS deoxigenálódik, akkor az egymás melletti HbS molekulák hydrofób kötésekkel egymáshozkötődnek és nagyobb méretű polimérokká rendeződnek. Ezek a polimérok eltorzítják a vörösvérsejt alakját a klasszikus
sickle cell anemia	sarlósejtes vérszegénység, Autozóm recesszív genetikai betegség, ahol valin helyett glutaminsav kódja található a hatos pozíción a beta-globin génben, ami a hibás hemoglobin S (HbS) termeléséhez vezet.Ha a HbS deoxigenálódik, akkor az egymás melletti HbS molekulák hydrofób kötésekkel egymáshozkötődnek és nagyobb méretű polimérokká rendeződnek. Ezek a polimérok eltorzítják a vörösvérsejt alakját a klasszikus
side	oldal, latus
side	oldal, latus
sidero-	sidero-, vas-
sidero-	sidero-, vas-
sievelike	cribriformis, szitaszerű
sievelike	cribriformis, szitaszerű
sigmoid colon	szigmabél, colon sigmoideum, a vastagbél rectum előtti S alakú része,
sigmoid colon	szigmabél, colon sigmoideum, a vastagbél rectum előtti S alakú része,
sigmoid colon inflammation	a colon sigmoideum gyulladása, a szigmabél gyulladása, sigmoiditis
sigmoid colon inflammation	a colon sigmoideum gyulladása, a szigmabél gyulladása, sigmoiditis
sign	stigma, jel
sign	stigma, jel
silent ischemia	csendes isémia, mellkasfájdalom nélkül járó szívisémia, silent ischaemia
silent ischemia	csendes isémia, mellkasfájdalom nélkül járó szívisémia, silent ischaemia
silicosis	szilikózis, silicosis,
silicosis	szilikózis, silicosis,
silly	bolondos
silly	bolondos
silver nitrate	lápisz, ezüst-nitrát pálcika
silver nitrate	lápisz, ezüst-nitrát pálcika
simbiosis	szimbiózis, két élőlény kölcsönösen hasznos együttélése
simbiosis	szimbiózis, két élőlény kölcsönösen hasznos együttélése
similar	similis, hasonló
similar	similis, hasonló
Simonart's band	lásd: Simonart's thread
Simonart's band	lásd: Simonart's thread
Simonart's thread	Simonart-féle szalag, Az amnion és a magzat közötti feszülő összenövések, ami az amniotikus üreget kitöltő folyadék megnövekedése és ezáltal az amnion megnagyobbodása okoz., Simonart's band,
Simonart's thread	Simonart-féle szalag, Az amnion és a magzat közötti feszülő összenövések, ami az amniotikus üreget kitöltő folyadék megnövekedése és ezáltal az amnion megnagyobbodása okoz., Simonart's band,
simple	egyszerű, simplex
simple	egyszerű, simplex
simulation	szimulálás, betegségek tettetése
simulation	szimulálás, betegségek tettetése
simultaneous	szimultán, egyidejű
simultaneous	szimultán, egyidejű
simultaneously	szimultán, egyidejűleg
simultaneously	szimultán, egyidejűleg
sinus	öböl, üreg, sinus
sinus	öböl, üreg, sinus
sinus rythm	sinusritmus, sinus csomóból gerjesztett szívritmus
sinus rythm	sinusritmus, sinus csomóból gerjesztett szívritmus
sinus sigmoideus	S alakú durális sinus a temporális és occipitális csontokon, sinus sigmoideus
sinus sigmoideus	S alakú durális sinus a temporális és occipitális csontokon, sinus sigmoideus
sinusitis	arcüreggyulladás, sinusitis
sinusitis	arcüreggyulladás, sinusitis
siphilis	lues, szifilisz
siphilis	lues, szifilisz
Sister Joseph's Nodule	Joseph nővér csomó
Sister Joseph's Nodule	Joseph nővér csomó
sistole	szívösszehúzódás, szisztolé
sistole	szívösszehúzódás, szisztolé
sixth ventricle	lásd: cavum vergae
sixth ventricle	lásd: cavum vergae
Sjogren's syndrome	Idült autoimmún gyulladásos betegség, mely a szem, száj és más nyálkahártyák fokozott kiszáradásával jár. Szintén a betegség velejárói lehetnek a reumatoid artritiszre vagy a szklerodermára jellemző tünetek. A nőknél gyakrabban fordul elő, mint a férfiaknál., Sjögren-szindróma,
Sjogren's syndrome	Idült autoimmún gyulladásos betegség, mely a szem, száj és más nyálkahártyák fokozott kiszáradásával jár. Szintén a betegség velejárói lehetnek a reumatoid artritiszre vagy a szklerodermára jellemző tünetek. A nőknél gyakrabban fordul elő, mint a férfiaknál., Sjögren-szindróma,
skeleton	csontváz
skeleton	csontváz
skin	cutis, bőr, dermis, dermo-, bőr-
skin	cutis, bőr, dermis, dermo-, bőr-
skin dryeness	bőrszárazság, xeroderma
skin dryeness	bőrszárazság, xeroderma
sleep	somnus, alvás álom
sleep	somnus, alvás álom
sleep apnea	alvási apnoe, A légzés rövid idejű leállása az alvás alatt. Ennek oka leggyakrabban obstrukció.,
sleep apnea	alvási apnoe, A légzés rövid idejű leállása az alvás alatt. Ennek oka leggyakrabban obstrukció.,
sleeping sickness	álomkór, trypanosomiasis
sleeping sickness	álomkór, trypanosomiasis
sleeplessness	insomnia, álmatlanság
sleeplessness	insomnia, álmatlanság
slight deviation	nüansz, enyhe eltérés, árnyalat
slight deviation	nüansz, enyhe eltérés, árnyalat
slit-lamp	réslámpa /szemészeti műszer/
slit-lamp	réslámpa /szemészeti műszer/
slow	tardus, késő, lassú
slow	lassú-, brady-
slow	tardus, késő, lassú
slow	lassú-, brady-
small	kicsi, parvus
small	kicsi, parvus
small artery	arteriola, kis artéria
small artery	arteriola, kis artéria
small bowel	vékonybél, intestinum tenue,
small bowel	vékonybél, intestinum tenue,
small bowel inflammation	vékonybélgyulladás, ileitis
small bowel inflammation	vékonybélgyulladás, ileitis
small branch	ágacska,
small branch	ágacska,
small intestine	vékonybél, intestinum tenue
small intestine	vékonybél, intestinum tenue
smaller	kisebb, minor
smaller	kisebb, minor
smaller trochanter	kistompor, trochanter minor
smaller trochanter	kistompor, trochanter minor
smallpox	fekete himlő, variola
smallpox	fekete himlő, variola
smegma	fitymafaggyú, smegma
smegma	fitymafaggyú, smegma
smell	szaglás, olfactus
smell	szaglás, olfactus
smooth	sima, levis
smooth	sima, levis
smooth muscle	simaizom
smooth muscle	simaizom
smooth-	lei(o)-, sima-
smooth-	lei(o)-, sima-
sneeze	tüsszentés, sternutatio
sneeze	tüsszentés, sternutatio
sneezing	sternutatio, tüsszentés
sneezing	sternutatio, tüsszentés
soap	sapo, szappan
soap	sapo, szappan
social anxiety disorder	a társadalmi státusszal vagy viselkedéssel kapcsolatos stresszérzés, erős félelem a nyilvánosság előtt való megszégyenüléstől, szociális fóbia, social phobia
social anxiety disorder	a társadalmi státusszal vagy viselkedéssel kapcsolatos stresszérzés, erős félelem a nyilvánosság előtt való megszégyenüléstől, szociális fóbia, social phobia
social phobia	a társadalmi státusszal vagy viselkedéssel kapcsolatos stresszérzés, erős félelem a nyilvánosság előtt való megszégyenüléstől, szociális fóbia, social anxieaty disorder
social phobia	a társadalmi státusszal vagy viselkedéssel kapcsolatos stresszérzés, erős félelem a nyilvánosság előtt való megszégyenüléstől, szociális fóbia, social anxieaty disorder
socket	fovea, gödör
socket	fovea, gödör
soft	puha
soft	puha
soft plaque	puha lepedék
soft plaque	puha lepedék
soft tumor	puha daganat
soft tumor	puha daganat
solarium	szolárium,
solarium	szolárium,
sole	planta,
sole	planta,
solid	szolid, szilárd, tömör
solid	szolid, szilárd, tömör
solitary	egyedülálló, valami amiből csak egy van, soliter
solitary	egyedülálló, valami amiből csak egy van, soliter
solitary nodule	egyedülálló csomó (pl. pajzsmirigyben), soliter göb
solitary nodule	egyedülálló csomó (pl. pajzsmirigyben), soliter göb
soluble	szolúbilis, oldható
soluble	szolúbilis, oldható
solution	solutio, oldat
solution	solutio, oldat
solvent	szolvens, oldószer
solvent	szolvens, oldószer
somatic	szomatikus, testtel kapcsolatos, testi
somatic	szomatikus, testtel kapcsolatos, testi
somatisation	somatisatio,
somatisation	somatisatio,
somatoform	Fizikai tünetek amelyeket nem lehet organikus betegséggel, vagy rendellenességgel megmagyarázni és úgy tűnik, hogy lelki háttere van., somatoform,
somatoform	Fizikai tünetek amelyeket nem lehet organikus betegséggel, vagy rendellenességgel megmagyarázni és úgy tűnik, hogy lelki háttere van., somatoform,
somatosensory	szomatoszenzoros,
somatosensory	szomatoszenzoros,
somatotropic hormone	STH, szomatotrop hormon
somatotropic hormone	STH, szomatotrop hormon
somnolence	aluszékonyság, somnolentia
somnolence	aluszékonyság, somnolentia
somnolent	aluszékony, somnolens
somnolent	aluszékony, somnolens
sonogram	ultrahang vizsgálat
sonogram	ultrahang vizsgálat
soor	szájpenész, thrush
soor	szájpenész, thrush
soor colpitis	Candida albicans okozta hüvelygyulladás
soor colpitis	Candida albicans okozta hüvelygyulladás
sore	seb, vulnus
sore	seb, vulnus
soul	anima, lélek
soul	anima, lélek
spa	balneum
spa	balneum
space	tér, űr
space	tér, űr
sparkling	szikrázás, szcintilláció
sparkling	szikrázás, szcintilláció
spastic	spasztikus, görcsös
spastic	spasztikus, görcsös
spastic diplegia	Little-kór, diplegia spastica infantilis, Veleszületett szpasztikus végtagmerevség. Az agybénulás formája, amely már a születéstől jelenvan és a pyramidális tractusok kifejlődésének hiányából ered. Többfajta rendellenesség következménye lehet, mint pl. sérülés szülés közben (pl. agyroncsolás), oxigénhiány a szülés közben, fertőzés terhesség alatt, az anya betegségei terhesség alatt, stb... Klinikailag jelle
spastic diplegia	Little-kór, diplegia spastica infantilis, Veleszületett szpasztikus végtagmerevség. Az agybénulás formája, amely már a születéstől jelenvan és a pyramidális tractusok kifejlődésének hiányából ered. Többfajta rendellenesség következménye lehet, mint pl. sérülés szülés közben (pl. agyroncsolás), oxigénhiány a szülés közben, fertőzés terhesség alatt, az anya betegségei terhesség alatt, stb... Klinikailag jelle
spatula	lapoc, spatula, kenőlapátka, nyelvkanál
spatula	lapoc, spatula, kenőlapátka, nyelvkanál
spazmus	spazmus, görcs
spazmus	spazmus, görcs
specie	species, faj
specie	species, faj
specific	specifikus, jellegzetes
specific	specifikus, jellegzetes
spectrography	Folyamat, ahol fényképezik, vagy felrajzolják a spektrumot., spectographia
spectrography	Folyamat, ahol fényképezik, vagy felrajzolják a spektrumot., spectographia
speculum	speculum, vizsgálótükör
speculum	speculum, vizsgálótükör
speech therapist	logopédus, beszédzavar gyógyításával foglalkozó szakember
speech therapist	logopédus, beszédzavar gyógyításával foglalkozó szakember
speech-	logo-, beszéd-
speech-	logo-, beszéd-
sperm	ondó, sperma
sperm	ondó, sperma
sperm cell	ondósejt, spermium
sperm cell	ondósejt, spermium
spermatic cord	funiculus spermaticus,
spermatic cord	funiculus spermaticus,
spermatocid	spermaticid, ondósejtölő
spermatocid	spermaticid, ondósejtölő
sphenoidal	szfenoidális, ékcsonttal kapcsolatos
sphenoidal	szfenoidális, ékcsonttal kapcsolatos
sphenoidal bone	ékcsont, os sphenoidale
sphenoidal bone	ékcsont, os sphenoidale
spherocyte	szferocita, gömbölyű vörösvérsejt
spherocyte	szferocita, gömbölyű vörösvérsejt
sphincter	sphincter, záróizom
sphincter	sphincter, záróizom
sphygmograph	szfigmográf, a pulzust képen megjelenitő készülék
sphygmograph	szfigmográf, a pulzust képen megjelenitő készülék
spina bifida	gerinchasadék, spina bifida
spina bifida	gerinchasadék, spina bifida
spinal	a gerincel kapcsolatos, spinalis
spinal	a gerincel kapcsolatos, spinalis
spinal column	hátgerinc
spinal column	hátgerinc
spinal cord	gerincvelő, medulla spinalis
spinal cord	gerincvelő, medulla spinalis
spinal cord compression	compressio spinalis, nyomás a gerincvelőre,
spinal cord compression	compressio spinalis, nyomás a gerincvelőre,
spinal ganglion	gerincvelői ganglion
spinal ganglion	gerincvelői ganglion
spinal muscular atrophy	(SMA), spinális izomatrófia, Genetikai motoros neuron rendellenesség, ahol izom atrófia lép fel, ami a gerincvelő elülső szarvainak a degenerációjának a következménye. A rendellenesség gyengeséget és atrófiát okoz az akarattal irányított izmokban. A gyengeség súlyosabb az alsó végtagokban mint a karokban.,
spinal muscular atrophy	(SMA), spinális izomatrófia, Genetikai motoros neuron rendellenesség, ahol izom atrófia lép fel, ami a gerincvelő elülső szarvainak a degenerációjának a következménye. A rendellenesség gyengeséget és atrófiát okoz az akarattal irányított izmokban. A gyengeség súlyosabb az alsó végtagokban mint a karokban.,
spinal proces	tövisnyúlvány, processus spinosus
spinal proces	tövisnyúlvány, processus spinosus
spinatus	spinatus, tövises
spinatus	spinatus, tövises
spindle-	shaped fusiformis, orsó alakú
spindle-	shaped fusiformis, orsó alakú
spine	spina, tövis, akanto-
spine	spina, tövis, akanto-
spino-	gerinc-, spino-, rachio-
spino-	gerinc-, spino-, rachio-
spinosus	spinosus, tövises
spinosus	spinosus, tövises
spinous process	csigolya-tövisnyúlvány, processus spinosus
spinous process	csigolya-tövisnyúlvány, processus spinosus
spiral	spirális, csavarodott
spiral	spirális, csavarodott
spirit	anima, lélek
spirit	anima, lélek
spit	-ptoe, -köpés
spit	-ptoe, -köpés
splanchnic	szplanchnikus, zsigerekkel kapcsolatos
splanchnic	szplanchnikus, zsigerekkel kapcsolatos
splanchno-	zsiger-, szplanchno-
splanchno-	zsiger-, szplanchno-
spleen	splen, lép, lien
spleen	splen, lép, lien
spleen capsule	léptok, capsula lienalis
spleen capsule	léptok, capsula lienalis
splenectomy	a lép sebészeti eltávolítása, splenectomia
splenectomy	a lép sebészeti eltávolítása, splenectomia
splenic	szplenikus, léphez tartozó
splenic	szplenikus, léphez tartozó
spleno-	lép-
spleno-	lép-
splenomegaly	splenomegalia,
splenomegaly	splenomegalia,
splint	egy merev anyagból készült sáv (rúd, léc, stb..), amely a törött csontot, vagy más sérült testrést mozdulatlanul tart.,
splint	egy merev anyagból készült sáv (rúd, léc, stb..), amely a törött csontot, vagy más sérült testrést mozdulatlanul tart.,
split	schizo-, hasadt
split	schizo-, hasadt
spondylolisthesis	csigolyacsuszamlás, spondylolisthesis
spondylolisthesis	csigolyacsuszamlás, spondylolisthesis
spondylolysis	csigolyaívek sérülése/szakadása
spondylolysis	csigolyaívek sérülése/szakadása
spondylopathy	csigolyabántalom, spondylopathie
spondylopathy	csigolyabántalom, spondylopathie
spondylosis	csigolyaizületek nem gyulladásos eredetű, merevséggel járó megbetegedése
spondylosis	csigolyaizületek nem gyulladásos eredetű, merevséggel járó megbetegedése
spondylotic	csigolyás, csigolyával kapcsolatos, spondylotikus
spondylotic	csigolyás, csigolyával kapcsolatos, spondylotikus
sponge	spongia, szivacs
sponge	spongia, szivacs
sponge-like	spongiformis, szivacsszerű
sponge-like	spongiformis, szivacsszerű
spongy	szivacsos
spongy	szivacsos
spontaneous	spontán, spontaneously,
spontaneous	spontán, spontaneously,
spontaneously	spontaneous, spontán,
spontaneously	spontaneous, spontán,
sporadic	sporadikus, szórványos
sporadic	sporadikus, szórványos
sporocide	sporocid, spóraölő
sporocide	sporocid, spóraölő
spot	folt, pecsét, macula (macula corneae
spot	folt, pecsét, macula (macula corneae
spotting	pecsételő vérzés
spotting	pecsételő vérzés
spread	propagáció, terjedés
spread	propagáció, terjedés
sprue	Krónikus öröklődő rendellenesség, amelyre a glutén gliadin részének a felszívódása a jellemző. A gliadin immunreakciót vált ki, amely tönkreteszi a bél nyálkahártyáját. Ez egy autoimmún betegség.
sprue	Krónikus öröklődő rendellenesség, amelyre a glutén gliadin részének a felszívódása a jellemző. A gliadin immunreakciót vált ki, amely tönkreteszi a bél nyálkahártyáját. Ez egy autoimmún betegség.
spur	sarkantyú, kinövés, nyúlvány, calcar
spur	sarkantyú, kinövés, nyúlvány, calcar
sputum	köpet, sputum
sputum	köpet, sputum
squamous	pikkelyes
squamous	pikkelyes
squamous epithelium	laphám
squamous epithelium	laphám
stab	szúrás
stab	szúrás
stab wound	szúrás okozta seb
stab wound	szúrás okozta seb
stable angina	stabil angina, Olyan melkas tájéki fájdalmat, vagy kellemetlen érzést jelent, amely a szív elégtelen vérellátásából ered és gyógyszerrel, vagy pihenéssel kb. 10-15 perc alatt elmúlik.,
stable angina	stabil angina, Olyan melkas tájéki fájdalmat, vagy kellemetlen érzést jelent, amely a szív elégtelen vérellátásából ered és gyógyszerrel, vagy pihenéssel kb. 10-15 perc alatt elmúlik.,
stagnation	stagnálás, pangás
stagnation	stagnálás, pangás
stapes	kengyel, stapes
stapes	kengyel, stapes
staphicillin	lásd: methicillin
staphicillin	lásd: methicillin
stasis	pangás, sztázis
stasis	pangás, sztázis
stat	azonnal, Ezt a kifejezést a rendelt vérvizsgálat, röntgenvizsgálat, gyógyszerrendelés, stb.. után írják.,
stat	azonnal, Ezt a kifejezést a rendelt vérvizsgálat, röntgenvizsgálat, gyógyszerrendelés, stb.. után írják.,
state	állapot, status, conditio
state	állapot, status, conditio
stealing	klepto-, lopás-
stealing	klepto-, lopás-
steam	gőz
steam	gőz
steato-	zsír-, szteato-
steato-	zsír-, szteato-
steatocardia	stenocardia, szívszorulás
steatocardia	stenocardia, szívszorulás
steatorrhea	steatorrhoea, zsírszéklet
steatorrhea	steatorrhoea, zsírszéklet
steatosis	Zsírfelgyülemlés egy szerv intersztíciumában (pl. máj elzsírosodása)
steatosis	Zsírfelgyülemlés egy szerv intersztíciumában (pl. máj elzsírosodása)
steeple sign	Antero-posterior nyaki puha szövet röntgenfelvételeken látható szubglotikus üreg leszűkülése. A trachea oedemája okozzak., (képek 1, 2).
steeple sign	Antero-posterior nyaki puha szövet röntgenfelvételeken látható szubglotikus üreg leszűkülése. A trachea oedemája okozzak., (képek 1, 2).
stem-cell	őssejt
stem-cell	őssejt
stenosis	szukület, sztenózis
stenosis	szukület, sztenózis
stent	Erek, vagy más üreges vezeték nzitvatartására használt kis csőalakú szerkezet. Haználhatják lezűkült erek, nyelőcső, epevezeték vagy ureterek leszűkülésénél ahol fontos, hogy az adott szerkezet átjárható maradjon., stent
stent	Erek, vagy más üreges vezeték nzitvatartására használt kis csőalakú szerkezet. Haználhatják lezűkült erek, nyelőcső, epevezeték vagy ureterek leszűkülésénél ahol fontos, hogy az adott szerkezet átjárható maradjon., stent
stent delivery system	sztentbehelyező rendszer
stent delivery system	sztentbehelyező rendszer
sterco-	bélsár-, kopro-, szterko-
sterco-	bélsár-, kopro-, szterko-
sterilisation	terméketlenítés, sterilizáció
sterilisation	terméketlenítés, sterilizáció
sterility	csíramentesség
sterility	csíramentesség
sternal	szternális, szegycsonthoz tartozó,
sternal	szternális, szegycsonthoz tartozó,
sternum	szegycsont, sternum,
sternum	szegycsont, sternum,
steroid	szteroid, Kémiai anyagok családja amelyek közös jellemzője a ciklikus kémiai váz. Sok hormon, gyógyszer és a szervezetben található vegyület tartozik ide, pl. kortikoszteroidok (prednizon), D vitamin, tesztoszteron, koleszterin stb...,
steroid	szteroid, Kémiai anyagok családja amelyek közös jellemzője a ciklikus kémiai váz. Sok hormon, gyógyszer és a szervezetben található vegyület tartozik ide, pl. kortikoszteroidok (prednizon), D vitamin, tesztoszteron, koleszterin stb...,
stick	pálca, bot
stick	pálca, bot
stiff joint	ankylosis, merev izület
stiff joint	ankylosis, merev izület
stigma	stigma, jel
stigma	stigma, jel
stimulant	stimuláns, élénkítőszer
stimulant	stimuláns, élénkítőszer
stimulus	stimulus, inger
stimulus	stimulus, inger
stink	foetor, bűz
stink	foetor, bűz
stinky breath	foetor ex ore, bűzös lehellet
stinky breath	foetor ex ore, bűzös lehellet
stirrup	stapes, kengyel
stirrup	stapes, kengyel
stomach	gyomor, gaster
stomach	gyomor, gaster
stomach wall	gyomorfal
stomach wall	gyomorfal
stomachburn	gyomorégés, pyrosis
stomachburn	gyomorégés, pyrosis
stomatho-	stomato-, száj-
stomatho-	stomato-, száj-
stomatology	sztomatológia, a szájüreg betegségeivel foglalkozó tudomány
stomatology	sztomatológia, a szájüreg betegségeivel foglalkozó tudomány
stone	kő, calculus
stone	kő, calculus
stone-	lito-, kő-
stone-	lito-, kő-
stool	faeces
stool	faeces
stool-	scato-, széklet-, kopro-
stool-	scato-, széklet-, kopro-
strabismus	kancsalság, strabizmus
strabismus	kancsalság, strabizmus
straight	egyenes, rectus
straight	egyenes, rectus
strain	1. mikroorganizmus törzs, 2. feszülés, húzódás, 3. megterhelés
strain	1. mikroorganizmus törzs, 2. feszülés, húzódás, 3. megterhelés
strangulation	stranguláció, elszorítás
strangulation	stranguláció, elszorítás
streptococcus	Kerek vagy tojás alakú, gyakran kórokozó, baktérium., streptococcus
streptococcus	Kerek vagy tojás alakú, gyakran kórokozó, baktérium., streptococcus
streptolysin	streptococcusok által termelt hemolizin, streptolizin
streptolysin	streptococcusok által termelt hemolizin, streptolizin
stria	csík, stria
stria	csík, stria
stricture	strictura, szűkület
stricture	strictura, szűkület
stridor	stridor, sípoló légzés
stridor	stridor, sípoló légzés
string	chorda, szalag, húr
string	chorda, szalag, húr
stroke	gutaütés, agyvérzés, szélütés (vérzés, vagy isémia okozta)
stroke	gutaütés, agyvérzés, szélütés (vérzés, vagy isémia okozta)
stroma	váz
stroma	váz
structural	valami szerkezetével kapcsolatos, szerkezeti, strukturális
structural	valami szerkezetével kapcsolatos, szerkezeti, strukturális
studdering	lallatio, dadogás
studdering	lallatio, dadogás
stunning	1. meglepő, pompás, erős benyomást keltő, vonzó kinézetű, 2. bizonyos funkció elvesztése,
stunning	1. meglepő, pompás, erős benyomást keltő, vonzó kinézetű, 2. bizonyos funkció elvesztése,
stupor	sopor, stupor, eszméletlenség
stupor	sopor, stupor, eszméletlenség
stye	hordeolum, árpa
stye	hordeolum, árpa
styloideus	styloideus, vesszőszerű
styloideus	styloideus, vesszőszerű
sub	szub-, sub-, alatti-
sub	szub-, sub-, alatti-
subacute	félheveny, szubakút
subacute	félheveny, szubakút
subcarinal	a carina tracheae alatt elhelyezkedő, subcarinalis
subcarinal	a carina tracheae alatt elhelyezkedő, subcarinalis
subclinical	tüneteket nem mutató,
subclinical	tüneteket nem mutató,
subconjunctival	szubkonjunktivális, subconjunctivalis, kötőhártya alatti, (szintén lásd: kötőhártya)
subconjunctival	szubkonjunktivális, subconjunctivalis, kötőhártya alatti, (szintén lásd: kötőhártya)
subcortical	kéreg alatti, subcorticalis
subcortical	kéreg alatti, subcorticalis
subcutaneously	s.c., szubkután, bőr alá
subcutaneously	s.c., szubkután, bőr alá
subdural	szubdurális
subdural	szubdurális
sublingual	szublingvális, s.l., nyelv alatti
sublingual	szublingvális, s.l., nyelv alatti
subluxation	félficam, szubluxáció, nem teljes ficam
subluxation	félficam, szubluxáció, nem teljes ficam
submersion	szubmerzió, alámerítés
submersion	szubmerzió, alámerítés
submucosa	a nyálkahártyák alatt található laza kötőszövet
submucosa	a nyálkahártyák alatt található laza kötőszövet
subpleural	pleura alatti, subpleuralis
subpleural	pleura alatti, subpleuralis
subscryption	subscriptio, aláírás
subscryption	subscriptio, aláírás
subset	alcsoport,
subset	alcsoport,
substance	anyag,
substance	anyag,
substantia nigra	feketeállomány, Sötéten pigmentált szürkeállomány réteg a középagyban. Anyagcserezavarai kapcsolatban vannak a Parkinson betegségel és Huntington betegséggel.,
substantia nigra	feketeállomány, Sötéten pigmentált szürkeállomány réteg a középagyban. Anyagcserezavarai kapcsolatban vannak a Parkinson betegségel és Huntington betegséggel.,
substituting	succedaneus, helyettesítő
substituting	succedaneus, helyettesítő
substrate	1. Tápláló oldatot tartalmazó neutrális anyag., 2. Egy anyag, amelyre az enzim hat., 3. Felszín, melyre különböző anyagok vannak lerakódva, vagy hozzátapadva., szubsztrátum
substrate	1. Tápláló oldatot tartalmazó neutrális anyag., 2. Egy anyag, amelyre az enzim hat., 3. Felszín, melyre különböző anyagok vannak lerakódva, vagy hozzátapadva., szubsztrátum
successive	szukcesszív, egymást követő
successive	szukcesszív, egymást követő
suction	suctio, szívás
suction	suctio, szívás
suction curettage	vacuum aspiration, A terhességmegszakítás egyik módszere amelyet az első trimeszterben alkalmaznak, ahol a méh tartalmát egy szűk csövön keresztül eltávolítják.,
suction curettage	vacuum aspiration, A terhességmegszakítás egyik módszere amelyet az első trimeszterben alkalmaznak, ahol a méh tartalmát egy szűk csövön keresztül eltávolítják.,
sudoriferrous	izzadságtermelő
sudoriferrous	izzadságtermelő
sufficient	szufficiens, elegendő
sufficient	szufficiens, elegendő
suffocation	suffocatio, fulladás
suffocation	suffocatio, fulladás
sugar	cukor, saccharum
sugar	cukor, saccharum
sugar-	cukor-, gliko-, szacharo-
sugar-	cukor-, gliko-, szacharo-
suggestion	szuggesztió, sugallás
suggestion	szuggesztió, sugallás
suicide	öngyilkosság, suicidium
suicide	öngyilkosság, suicidium
super-	super-, felett
super-	super-, felett
superficial	szuperficiális, felületi, felszíni
superficial	szuperficiális, felületi, felszíni
supernatant	szupernatáns, a felületen úszó
supernatant	szupernatáns, a felületen úszó
supination	kifordítás, szupináció, kifelé fordulás, kifelé fordítás,
supination	kifordítás, szupináció, kifelé fordulás, kifelé fordítás,
supinator	supinator, hanyintó
supinator	supinator, hanyintó
suppository	kúp, suppositorium
suppository	kúp, suppositorium
suppuration	suppuratio, gennyesedés
suppuration	suppuratio, gennyesedés
suppurative	szuppuratív, gennyes
suppurative	szuppuratív, gennyes
supra-	szupra-, supra-, felett-
supra-	szupra-, supra-, felett-
supracondilar	csontbütyök feletti
supracondilar	csontbütyök feletti
suprarenal	mellékvesével kapcsolatos, suprarenalis
suprarenal	mellékvesével kapcsolatos, suprarenalis
supraspinatus	A fossa supraspinatusból kiinduló izom, amely a humerusra kapcsolódik., musculus supraspinatus
supraspinatus	A fossa supraspinatusból kiinduló izom, amely a humerusra kapcsolódik., musculus supraspinatus
supreme	supremus, legfelső
supreme	supremus, legfelső
supressor	szupresszor, elnyomó, gátló
supressor	szupresszor, elnyomó, gátló
sural	szurális, lábikrával kapcsolatos
sural	szurális, lábikrával kapcsolatos
surface	felszín, facies, superficies
surface	felszín, facies, superficies
surgeon	sebész, kirurgus
surgeon	sebész, kirurgus
surgery	kirurgia, sebészet
surgery	kirurgia, sebészet
surgical	attachment pexis, műtéti rögzítés
surgical	attachment pexis, műtéti rögzítés
susceptibility	fogékonyság, szuszceptibilitás
susceptibility	szuszceptibilitás, fogékonyság
susceptibility	fogékonyság, szuszceptibilitás
susceptibility	szuszceptibilitás, fogékonyság
suspected	feltételezett, gyanított
suspected	feltételezett, gyanított
sustained	hosszantartó,
sustained	hosszantartó,
suture	varrat, sutura
suture	varrat, sutura
sux	slang, ami a succinylcholin-t jelent (neuromuscularis depolarizáló anyag)
sux	slang, ami a succinylcholin-t jelent (neuromuscularis depolarizáló anyag)
swallowing	nyelés, deglutitio
swallowing	nyelés, deglutitio
sweat	sudor, verejték, izzadtság
sweat	sudor, verejték, izzadtság
sweating	diaforézis, izzadás, hidrosis, sudor, verejtékezés, sudatio
sweating	diaforézis, izzadás, hidrosis, sudor, verejtékezés, sudatio
sympathetic ganglion	szimpatikus dúc, (szintén lásd: szimpatikus dúclánc)
sympathetic ganglion	szimpatikus dúc, (szintén lásd: szimpatikus dúclánc)
sympathy	szimpátia, együttérzés
sympathy	szimpátia, együttérzés
symphysis	symphysis, a szeméremcsontok porcos összekapcsolódása
symphysis	symphysis, a szeméremcsontok porcos összekapcsolódása
symphysis pubis	szeméremízület, symphysis
symphysis pubis	szeméremízület, symphysis
symptom	kórtünet, szimptóma, tünet
symptom	kórtünet, szimptóma, tünet
symptomatic	tüneti, szimptomatikus
symptomatic	tüneti, szimptomatikus
symptomatology	szimptomatológia,
symptomatology	szimptomatológia,
synalgy	synalgia, nem a sérülés helyén fellépő fájdalom
synalgy	synalgia, nem a sérülés helyén fellépő fájdalom
synapsis	szinapszis, idegek átkapcsolódási pontja
synapsis	szinapszis, idegek átkapcsolódási pontja
synaptic	szinapszissal kapcsolatos, szinaptikus, (lásd szintén: szinapszis)
synaptic	szinapszissal kapcsolatos, szinaptikus, (lásd szintén: szinapszis)
syncope	ájulás, syncope, kollapszus, rövid idejű eszméletlenség
syncope	ájulás, syncope, kollapszus, rövid idejű eszméletlenség
syndactily	syndactylia, ujjösszenövés
syndactily	syndactylia, ujjösszenövés
syndrom	tünetcsoport, szindróma
syndrom	tünetcsoport, szindróma
synechia	beteges összenövés
synechia	beteges összenövés
synergy	szinergia, együttműködés
synergy	szinergia, együttműködés
synoatrial	szinuatriális, szinuszhoz és pitvarhoz egyaránt tartozó
synoatrial	szinuatriális, szinuszhoz és pitvarhoz egyaránt tartozó
synostosis	csontösszenövés, synostosis
synostosis	csontösszenövés, synostosis
synovectomy	ízületi hártya sebészeti eltávolítása (a reumatoid artritisznél a gyulladt  ízületi hártyát távolítják el), synovectomia
synovectomy	ízületi hártya sebészeti eltávolítása (a reumatoid artritisznél a gyulladt  ízületi hártyát távolítják el), synovectomia
synproportionation	szinproporcionálódás, A redox folyamatoknak egy sajátos típusa, aholazonos atomból származó, de két különböző oxidációs állapotú részecske az átalakulás során azonos oxidációs állapotba jut.
synproportionation	szinproporcionálódás, A redox folyamatoknak egy sajátos típusa, aholazonos atomból származó, de két különböző oxidációs állapotú részecske az átalakulás során azonos oxidációs állapotba jut.
synthesis	szintézis, összerakás, összeállás
synthesis	szintézis, összerakás, összeállás
syphilis	syphilis, szifilisz, vérbaj,
syphilis	syphilis, szifilisz, vérbaj,
syringe	fecskendő
syringe	fecskendő
syrinx	üreg a gerincvelőben, bármilyen folyadékkal telt csőalakú üreg a gerincvelő idegszövetében syringomyelia esetében,
syrinx	üreg a gerincvelőben, bármilyen folyadékkal telt csőalakú üreg a gerincvelő idegszövetében syringomyelia esetében,
systemic	szisztémás,
systemic	szisztémás,
systemic lupus erythematosus	SLE, szisztémás lupus erythematosus
systemic lupus erythematosus	SLE, szisztémás lupus erythematosus
systemic sclerosis	szisztémás sclerosis,
systemic sclerosis	szisztémás sclerosis,
systole	szisztolé, szívösszehúzódás
systole	szisztolé, szívösszehúzódás
t.bilirubin	total bilirubin, össz bilirubin, (szintén lásd: bilirubin és bilirubin normál értékek)
t.bilirubin	total bilirubin, össz bilirubin, (szintén lásd: bilirubin és bilirubin normál értékek)
tachycardia	tachikardia,
tachycardia	tachikardia,
tachylalia	tachylália,
tachylalia	tachylália,
tachyphylax-	tachyphylax-,
tachyphylax-	tachyphylax-,
tachypnea	tachipnoé,
tachypnea	tachipnoé,
tactile	taktilis,
tactile	taktilis,
tail	farok, cauda
tail	farok, cauda
tailbone	farokcsont, os coccygis
tailbone	farokcsont, os coccygis
talocrural	talokrurális,
talocrural	talokrurális,
talofibular	talofibuláris,
talofibular	talofibuláris,
talotibial	talotibiális,
talotibial	talotibiális,
talus	talus,
talus	talus,
tamponade	tamponálás,
tamponade	tamponálás,
Tanner stages	Tanner-féle beosztás,
Tanner stages	Tanner-féle beosztás,
Tanner's classification	Tanner-féle beosztás,
Tanner's classification	Tanner-féle beosztás,
tap	csapolás, lecsapolás, csap (pl. spinal tap)
tap	csapolás, lecsapolás, csap (pl. spinal tap)
target	cél,
target	cél,
target blood glucose level	cél glukóz szint a vérben
target blood glucose level	cél glukóz szint a vérben
Tarlov cyst	Tarlov ciszta,
Tarlov cyst	Tarlov ciszta,
tarsal	tarso-,
tarsal	tarso-,
tarsus	tarsus,
tarsus	tarsus,
tasteless	íztelen, insipidus
tasteless	íztelen, insipidus
taxidermy	taxidermia,
taxidermy	taxidermia,
TB	gümokór, tuberkulózis
TB	gümokór, tuberkulózis
tear	dacryon, könny lacrima
tear	dacryon, könny lacrima
tear-	dacry-, dacryo-, könny-
tear-	dacry-, dacryo-, könny-
tearduct	könnycsatorna, ductus lacrimalis
tearduct	könnycsatorna, ductus lacrimalis
tearsack	dacryocysta, könnytömlő
tearsack	dacryocysta, könnytömlő
teeth clenching	fogak összeszorítása
teeth clenching	fogak összeszorítása
teeth grinding	fogcsikorgatás, bruxismus
teeth grinding	fogcsikorgatás, bruxismus
teething	dentitio, fogzás, odontosis
teething	dentitio, fogzás, odontosis
teleagiectasia	teleangiectasia, hajszálértágulat
teleagiectasia	teleangiectasia, hajszálértágulat
telencephalon	végagy, telencephalon
telencephalon	végagy, telencephalon
temperature	temperatúra, hőmérséklet
temperature	temperatúra, hőmérséklet
temple	halánték, tempora
temple	halánték, tempora
temporal	halántékcsonti, halántékcsonttal kapcsolatos, temporális
temporal	halántékcsonti, halántékcsonttal kapcsolatos, temporális
temporal bone	halántékcsont, os temporale
temporal bone	halántékcsont, os temporale
temporary teeth	tejfogak, dentes decidui
temporary teeth	tejfogak, dentes decidui
temporomandibular	temporomandibuláris, halántékcsonti-állkapcsi
temporomandibular	temporomandibuláris, halántékcsonti-állkapcsi
tendinitis	tendinitis, íngyulladás
tendinitis	tendinitis, íngyulladás
tendinous	inas, tendineous
tendinous	inas, tendineous
tendon	tendo, ín
tendon	tendo, ín
tendonsheet	ínhüvely, vagina tendinis
tendonsheet	ínhüvely, vagina tendinis
tendovaginitis	Tendovaginitis, ínhüvelygyulladás
tendovaginitis	Tendovaginitis, ínhüvelygyulladás
tenesmus	Olyan állapot ahol a beteg állandó kényszerét érzi annak, hogy a beleit ürítse, ami fájdalommal, görcsökkel és akaratlan eröltetéssel jár.
tenesmus	Olyan állapot ahol a beteg állandó kényszerét érzi annak, hogy a beleit ürítse, ami fájdalommal, görcsökkel és akaratlan eröltetéssel jár.
tenia	galandféreg, taenia
tenia	galandféreg, taenia
tennis elbow	teniszkönyök, epicondylitis humeri
tennis elbow	teniszkönyök, epicondylitis humeri
tenosynovitis	ínburok gyulladás, tenosynovitis,
tenosynovitis	ínburok gyulladás, tenosynovitis,
tenotomy	ín műtéti metszése vagy szétválasztása, tenotomia,
tenotomy	ín műtéti metszése vagy szétválasztása, tenotomia,
tension	tónus, feszültség, tenzió
tension	tónus, feszültség, tenzió
tension pneumothorax	feszülő légmell
tension pneumothorax	feszülő légmell
tentorium	sátor, tentorium
tentorium	sátor, tentorium
teratogenesis	teratogenézis, torzfejlődés
teratogenesis	teratogenézis, torzfejlődés
teres muscle	görgetegizom, musculus teres
teres muscle	görgetegizom, musculus teres
terminal	terminális, végső
terminal	terminális, végső
termoregulation	termoreguláció, hőszabályzás
termoregulation	termoreguláció, hőszabályzás
tertiary wound healing	per tertiam intentionem, harmadlagos sebgyógyulás
tertiary wound healing	per tertiam intentionem, harmadlagos sebgyógyulás
testes	herék,
testes	herék,
testicle	here, testis
testicle	here, testis
testicular cancer	hererák
testicular cancer	hererák
testicular torsion	herecsavarodás, torsio testis
testicular torsion	herecsavarodás, torsio testis
testo-	here-, teszto-, orchio-
testo-	here-, teszto-, orchio-
testosteron	férfi nemi hormon, amely a herékben termelődik, tesztoszteron
testosteron	férfi nemi hormon, amely a herékben termelődik, tesztoszteron
tethered cord	letapadt gerincvelő
tethered cord	letapadt gerincvelő
tetraparesis	négy végtag enyhe bénulása, tetraparesis
tetraparesis	négy végtag enyhe bénulása, tetraparesis
thalamus	talamusz,
thalamus	talamusz,
thecal	burokkal kapcsolatos, főleg az ínburokkal
thecal	burokkal kapcsolatos, főleg az ínburokkal
thenar	Az öregujj tövénél található, izom alkotta, domborulat.
thenar	Az öregujj tövénél található, izom alkotta, domborulat.
theory	teória, elmélet
theory	teória, elmélet
therapeutic	gyógyászati, therapeutical
therapeutic	gyógyászati, therapeutical
therapeutical	therapeutic, gyógyászati
therapeutical	therapeutic, gyógyászati
therapy	gyógykezelés, terápia
therapy	gyógykezelés, terápia
thiamin	tiamin, B1 vitamin
thiamin	tiamin, B1 vitamin
thick-	pachy-, vastag-
thick-	pachy-, vastag-
thigh	comb, femur
thigh	comb, femur
thin	vékony, tenuis
thin	vékony, tenuis
thoracic cavity	mellüreg, cavum thoracis
thoracic cavity	mellüreg, cavum thoracis
thoraco-	torako-, mellkas-, stetho-
thoraco-	torako-, mellkas-, stetho-
thoracocentesis	mellkascsapolás, thoracocentesis
thoracocentesis	mellkascsapolás, thoracocentesis
thoracotomy	thoracotomia,
thoracotomy	thoracotomia,
thorax	mellkas, thorax stethos
thorax	mellkas, thorax stethos
thorn	spina, tövis
thorn	spina, tövis
thorny	spinatus, tövises, spinosus
thorny	spinatus, tövises, spinosus
thread	filum, szál, fonal
thread	filum, szál, fonal
three headed triceps	háromfejű
three headed triceps	háromfejű
throat	faux, torok
throat	faux, torok
throbbing	lüktetés
throbbing	lüktetés
thrombin	Egy enzim amely protrombinból keletkezik és a fibrinogént fibrinné alakítja, thrombin. Kulcsfontosságú szerepet játszik a véralvadásban., trombin
thrombin	Egy enzim amely protrombinból keletkezik és a fibrinogént fibrinné alakítja, thrombin. Kulcsfontosságú szerepet játszik a véralvadásban., trombin
thrombocyte	trombocyta, vérlemezke
thrombocyte	trombocyta, vérlemezke
thrombocytemia	trombocitémia, kóros vérlemezke szám megemelkedés
thrombocytemia	trombocitémia, kóros vérlemezke szám megemelkedés
thrombocytopenia	thrombocytopénia, trombocitopénia, vér trombocita szám csökkenés
thrombocytopenia	thrombocytopénia, trombocitopénia, vér trombocita szám csökkenés
thrombolysis	trombolízis, vérrög feloldása, vérrögoldás
thrombolysis	trombolízis, vérrög feloldása, vérrögoldás
thrombophlebitis	tromboflebitisz, trombophlebitis, Akkor keletkezik, amikor egy vérrög gyulladást okoz egy, vagy több érben. A tromboflebitisz általában az alsó végtagokban keletkezik, ritkábban a felső végtagokban. Az érintett erek lehetnek a felszinen, vagy mélyen. A tromboflebitisz vérrögöket indíthat a véráramba, amelyek a tüdőbe kerülhetnek és elyárhatják a tüdő ereit (tüdő embólia). A tromboflebitisz hosszú idejű tétlenség
thrombophlebitis	tromboflebitisz, trombophlebitis, Akkor keletkezik, amikor egy vérrög gyulladást okoz egy, vagy több érben. A tromboflebitisz általában az alsó végtagokban keletkezik, ritkábban a felső végtagokban. Az érintett erek lehetnek a felszinen, vagy mélyen. A tromboflebitisz vérrögöket indíthat a véráramba, amelyek a tüdőbe kerülhetnek és elyárhatják a tüdő ereit (tüdő embólia). A tromboflebitisz hosszú idejű tétlenség
thrombosis	trombózis, vérrögösödés, vérrögök képződése a vérben
thrombosis	trombózis, vérrögösödés, vérrögök képződése a vérben
thrombotic thrombocytopenic purpura	TTP, trombocitopéniás trombotikus purpura
thrombotic thrombocytopenic purpura	TTP, trombocitopéniás trombotikus purpura
thrombus	vérrög, trombus
thrombus	trombus, vérrög
thrombus	vérrög, trombus
thrombus	trombus, vérrög
thrush	soor, szájpenész
thrush	soor, szájpenész
thumb	hüvelykujj, pollex
thumb	hüvelykujj, pollex
thymoma	thymoma,
thymoma	thymoma,
thymus	thymus, tímusz, csecsemőmirigy
thymus	thymus, tímusz, csecsemőmirigy
thyreo-	pajzsmirigy-, thyreo-, tireo-
thyreo-	pajzsmirigy-, thyreo-, tireo-
thyreoiditis	pajzsmiriggyulladás, thyreoiditis
thyreoiditis	pajzsmiriggyulladás, thyreoiditis
thyreotoxicosis	a pajzsmirigyhormonok túltermelése, thyreotoxicosis
thyreotoxicosis	a pajzsmirigyhormonok túltermelése, thyreotoxicosis
thyroid eye disease	pajzsmirigy okozta szembetegség
thyroid eye disease	pajzsmirigy okozta szembetegség
thyroid gland	pajzsmirigy, glandula thyroidea
thyroid gland	pajzsmirigy, glandula thyroidea
thyroid hormone	tiroxin, pajzsmirigy hormon
thyroid hormone	tiroxin, pajzsmirigy hormon
thyroid stimulating hormone	TSH, tireotrop hormon
thyroid stimulating hormone	TSH, tireotrop hormon
thyroid-	thyreo-, tireo-, pajzsmirigy-
thyroid-	thyreo-, tireo-, pajzsmirigy-
thyroidectomy	sebészeti pajzsmirigyeltávolítás
thyroidectomy	sebészeti pajzsmirigyeltávolítás
thyroiditis	A pajzsmirigygyulladás lehet akut, mint pl. bakteriális fertőzésnél, vagy krónikus mint pl. autoimmún betegségnél, amikor a limfociták megtámodják a pajzsmirigyet. A pajzsmirigy autoimmún betegségeihez tartozik pl. a Hashimoto pajzsmirigygyulladás., pajzsmirigygyulladás
thyroiditis	A pajzsmirigygyulladás lehet akut, mint pl. bakteriális fertőzésnél, vagy krónikus mint pl. autoimmún betegségnél, amikor a limfociták megtámodják a pajzsmirigyet. A pajzsmirigy autoimmún betegségeihez tartozik pl. a Hashimoto pajzsmirigygyulladás., pajzsmirigygyulladás
thyroxin	tiroxin,
thyroxin	tiroxin,
tibia	sípcsont, tibia
tibia	sípcsont, tibia
tibial	tibiális, sípcsonttal kapcsolatos
tibial	tibiális, sípcsonttal kapcsolatos
tic	tic, tik,
tic	tic, tik,
tight	szűk
tight	szűk
tilted	megdőlt
tilted	megdőlt
time	tempus, idő
time	tempus, idő
timpanic	timpanikus, dobüregi
timpanic	timpanikus, dobüregi
tinea	tinea, gomba okozta bőrelváltozás, (lásd: ringworm)
tinea	tinea, gomba okozta bőrelváltozás, (lásd: ringworm)
tinitus	tinnitus, fülcsengés
tinitus	tinnitus, fülcsengés
tinnitus	fülcsengés, tinnitus
tinnitus	fülcsengés, tinnitus
tissue	szövet
tissue	szövet
tissue culture	szövettenyészet
tissue culture	szövettenyészet
titer	bizonyos anyag ereje vagy koncentrációja amit titrációval állapítanak meg
titer	bizonyos anyag ereje vagy koncentrációja amit titrációval állapítanak meg
titubation	titubatio, inbolygó bizonytalan járás
titubation	titubatio, inbolygó bizonytalan járás
tolerance	tolerancia, tűrés
tolerance	túrés, tolerancia
tolerance	tolerancia, tűrés
tolerance	túrés, tolerancia
tone	tónus, feszültség
tone	tónus, feszültség
tongue	nyelv, lingua
tongue	nyelv-, glosso-
tongue	nyelv, lingua
tongue	nyelv-, glosso-
tongue base	nyelvgyök, radix linguae
tongue base	nyelvgyök, radix linguae
tonic	tónikus, (lásd szintén: tonus)
tonic	tónikus, (lásd szintén: tonus)
tonsil	tonsilla, mandula
tonsil	tonsilla, mandula
tonsilectomy	tonsillectomia, mandula sebészeti eltávolítása
tonsilectomy	tonsillectomia, mandula sebészeti eltávolítása
tonsilitis	tonsilitis,
tonsilitis	tonsilitis,
tonsillectomy	a mandulák sebészeti eltávolítása, tonsilectomia
tonsillectomy	a mandulák sebészeti eltávolítása, tonsilectomia
tonsilolith	mandulakő,
tonsilolith	mandulakő,
tonus	tónus, 1. Az elasztikus feszülés, vagy részleges izomösszehúzódás a pihenő izomban., 2. Szövet vagy szerv normális feszessége vagy ruganyossága.,
tonus	tónus, 1. Az elasztikus feszülés, vagy részleges izomösszehúzódás a pihenő izomban., 2. Szövet vagy szerv normális feszessége vagy ruganyossága.,
tonzura	(lat., pilis is, hajnyirat, hajkorona), a katolikus egyházban egy egyházi rendhez tartozóknál a hajnak a fej hátsó részén való kerek lenyirása vagy kiberetválása. Ez a kisebb egyházi rendek (l. Egyházi rend, V. kötet, 765. old.) feladását szokta megelőzni. Nem külön rend, hanem a papi rendbe való felvételnek bevezetéséül szolgál és a világi hiuságról való lemondásnak jelvénye. A hajkorona oly javadalmak megszerezh
tonzura	(lat., pilis is, hajnyirat, hajkorona), a katolikus egyházban egy egyházi rendhez tartozóknál a hajnak a fej hátsó részén való kerek lenyirása vagy kiberetválása. Ez a kisebb egyházi rendek (l. Egyházi rend, V. kötet, 765. old.) feladását szokta megelőzni. Nem külön rend, hanem a papi rendbe való felvételnek bevezetéséül szolgál és a világi hiuságról való lemondásnak jelvénye. A hajkorona oly javadalmak megszerezh
tooth	dens, fog
tooth	dens, fog
tooth grinding	bruxizmus, fogcsikorgatás
tooth grinding	bruxizmus, fogcsikorgatás
torsion	csavarodás, megcsavarodás, torzió
torsion	csavarodás, megcsavarodás, torzió
total capacity	TC, totálkapacitás
total capacity	TC, totálkapacitás
total iron binding capacity	TIBC, TVK, teljes vas kötő képesség (vérkép),
total iron binding capacity	TIBC, TVK, teljes vas kötő képesség (vérkép),
totipotent	totipotens, bármilyen fejlődési irányra képes
totipotent	totipotens, bármilyen fejlődési irányra képes
Tourette syndrome	Tourette szindróma,
Tourette syndrome	Tourette szindróma,
toxic	- mérgező, toxikus
toxic	- mérgező, toxikus
toxic substance	toxicum, méreg
toxic substance	toxicum, méreg
toxicology	toxikológia, méregtan
toxicology	toxikológia, méregtan
toxidrome	toxidróm, bizonyos méreg okozta tünetek tipikus együttese
toxidrome	toxidróm, bizonyos méreg okozta tünetek tipikus együttese
toxin	méreg, toxin
toxin	méreg, toxin
trace	nyom,
trace	nyom,
tracer	Bármilyen radioaktív izotóp, amelyet a szervezetbejuttatással az anyagcsere és más folyamatok tanulmányozására használnak.
tracer	Bármilyen radioaktív izotóp, amelyet a szervezetbejuttatással az anyagcsere és más folyamatok tanulmányozására használnak.
trachea	trachea, légcső
trachea	trachea, légcső
tracheal	tracheális, légcsővel kapcsolatos
tracheal	tracheális, légcsővel kapcsolatos
tracheitis	tracheitis, légcsőgyulladás
tracheitis	tracheitis, légcsőgyulladás
tracheorrhaphy	A légcső bevágásának, vagy sérülésének sebészeti varrással való helyreállítása., tracheorrhaphia,
tracheorrhaphy	A légcső bevágásának, vagy sérülésének sebészeti varrással való helyreállítása., tracheorrhaphia,
trachoma	trachoma, egyiptomi szem gyulladás
trachoma	trachoma, egyiptomi szem gyulladás
traction	tractio, húzás
traction	tractio, húzás
tragus	fülcsap, tragus
tragus	fülcsap, tragus
trans-	át-, túl-, keresztül-,
trans-	át-, túl-, keresztül-,
transaminase	Bármely enzim amely a transzamináció folyamatot katalizálja., transzaminázis,
transaminase	Bármely enzim amely a transzamináció folyamatot katalizálja., transzaminázis,
transfer	transzfer, áthelyezés
transfer	transzfer, áthelyezés
transferrin	transzferin, A vérben a vas szálítására szolgáló fehérje., (normálérték)
transferrin	transzferin, A vérben a vas szálítására szolgáló fehérje., (normálérték)
transfusion	vérátömlesztés átömlesztés, transzfúzió
transfusion	vérátömlesztés átömlesztés, transzfúzió
transient	tranziens,
transient	tranziens,
transit	tranzitórius,
transit	tranzitórius,
translucent	transzparens, átlátszó
translucent	transzparens, átlátszó
transmural	transmuralis,
transmural	transmuralis,
transpalntation	transzplantáció, átültetés
transpalntation	transzplantáció, átültetés
transparent	transzparens, átlátszó
transparent	transzparens, átlátszó
transudation	transzszudáció, átszivárgás
transudation	transzszudáció, átszivárgás
transvenous	vénán keresztül
transvenous	vénán keresztül
transvers	transzverzális, harántirányú
transvers	transzverzális, harántirányú
transverse	haránt, transversus
transverse	haránt, transversus
transverse colon	haránt vastagbél, colon transversum,
transverse colon	haránt vastagbél, colon transversum,
transverse process	csigolya-harántnyúlvány, processus transversus
transverse process	csigolya-harántnyúlvány, processus transversus
trapesius muscle	csuklyásizom, musculus trapesius
trapesius muscle	csuklyásizom, musculus trapesius
trauma	sérülés, lesio
trauma	sérülés, lesio
traumatology	baleseti sebészet, traumatológia
traumatology	baleseti sebészet, traumatológia
treatment	gyógyítás
treatment	gyógyítás
tremor	tremor, reszketés
tremor	tremor, reszketés
trepanation	csontfúrás, trepanáció
trepanation	csontfúrás, trepanáció
triage	Egy folyamat, ahol a betegek az állapotuk súlyossága szerint vannak osztályozva.,
triage	Egy folyamat, ahol a betegek az állapotuk súlyossága szerint vannak osztályozva.,
triangular fossa	háromszög alakú árok (pl. fülön)
triangular fossa	háromszög alakú árok (pl. fülön)
triceps	triceps, háromfejű
triceps	triceps, háromfejű
trichinellosis	lásd: trichinosis
trichinellosis	lásd: trichinosis
trichinosis	Étellel terjedő, parazita okozta fertőző betegség. A Trichinella spiralis nevű parazita okozza. Leggyakrabban nem elegendően hőkezelt disznóhússal, vagy vadhússal terjed. A fertőzés emberről emberre nem terjed. Az inkubációs időszak 5
trichinosis	Étellel terjedő, parazita okozta fertőző betegség. A Trichinella spiralis nevű parazita okozza. Leggyakrabban nem elegendően hőkezelt disznóhússal, vagy vadhússal terjed. A fertőzés emberről emberre nem terjed. Az inkubációs időszak 5
trichobesoar	trichobezoár, szőrgolyó
trichobesoar	trichobezoár, szőrgolyó
trichophagia	trichofágia, hajevés
trichophagia	trichofágia, hajevés
trichotillomania	hajtépdesés, beteges hajtépdesés,  trichotillomania
trichotillomania	hajtépdesés, beteges hajtépdesés,  trichotillomania
tricuspid	háromcsúcsú, trikuszpidális, háromhegyű
tricuspid	háromcsúcsú, trikuszpidális, háromhegyű
trigeminal	háromosztatú, trigeminus
trigeminal	háromosztatú, trigeminus
trigeminal nerve	háromosztatú ideg, nervus trigeminus
trigeminal nerve	háromosztatú ideg, nervus trigeminus
trigger	kivált, elindít, megindít
trigger	kivált, elindít, megindít
triglycerides	triglyceridek
triglycerides	triglyceridek
trigonocephaly	trigonocephalia, metopic synostosis,
trigonocephaly	trigonocephalia, metopic synostosis,
triple A	abdominal aortic aneurysm,
triple A	abdominal aortic aneurysm,
tripple cocktail	A HIV fertőzés gyógyítására használt gyógyszerkombináció, amely két nukleozid analógból (AZT, 3TC) és egy proteázis inhibítor (Crixivan)., tripla koktél
tripple cocktail	A HIV fertőzés gyógyítására használt gyógyszerkombináció, amely két nukleozid analógból (AZT, 3TC) és egy proteázis inhibítor (Crixivan)., tripla koktél
tripsy	tripsia, zúzás
tripsy	tripsia, zúzás
trismus	szájzár, trismus,
trismus	szájzár, trismus,
tritanotopy	tritanotopia, sárga és kék szín tévesztése
tritanotopy	tritanotopia, sárga és kék szín tévesztése
trocar	szúrcsap, trokár
trocar	trokár, szúrcsap
trocar	szúrcsap, trokár
trocar	trokár, szúrcsap
trochanter	trochanter, tompor
trochanter	trochanter, tompor
trochlea	csiga, pörge, trochlea
trochlea	csiga, pörge, trochlea
trochlear nerve	sodorideg, nervustrochlearis
trochlear nerve	sodorideg, nervustrochlearis
trophic	trofikus,
trophic	trofikus,
trophoblast	Az embriót körbefogó vékony külső ectoderma réteg ami a megtermékenyített petesejtet a méh falához csatolja és felszívja a tápanyagokat., trofoblaszt,
trophoblast	Az embriót körbefogó vékony külső ectoderma réteg ami a megtermékenyített petesejtet a méh falához csatolja és felszívja a tápanyagokat., trofoblaszt,
trophyc	trofikus, táplálkozással kapcsolatos
trophyc	trofikus, táplálkozással kapcsolatos
troponin	Globuláris izom fehérjék, amelyek az I sávban találhatók és a kontrakciót inhibálják. Az inhibálás az aktin és myosin interakciójának a blokkolásán alapszik. Kulcs szerepet játszik az izomösszehúzódás szabályozásában.
troponin	Globuláris izom fehérjék, amelyek az I sávban találhatók és a kontrakciót inhibálják. Az inhibálás az aktin és myosin interakciójának a blokkolásán alapszik. Kulcs szerepet játszik az izomösszehúzódás szabályozásában.
trunc	törzs, truncus
trunc	törzs, truncus
trysomy	trisómia, egy kromozóma fajtából 3 darab van 2 helyett
trysomy	trisómia, egy kromozóma fajtából 3 darab van 2 helyett
tuba uterina	oviductus, petevezeték
tuba uterina	oviductus, petevezeték
tubal pregnancy	graviditas tubaria, kürtterhesség,
tubal pregnancy	graviditas tubaria, kürtterhesség,
tube	cső tuba, kürt, ductus
tube	cső tuba, kürt, ductus
tuberculosis	gümőkór, tuberkulózis TBC
tuberculosis	gümőkór, tuberkulózis TBC
tuberosity	tuberositas, csontdudor
tuberosity	tuberositas, csontdudor
tuberous sclerosis	sclerosis tuberosa,
tuberous sclerosis	sclerosis tuberosa,
tubo-	petevezeték-, salpingo-
tubo-	petevezeték-, salpingo-
tumor	-oma, -daganat
tumor	oncos, daganat
tumor	-oma, -daganat
tumor	oncos, daganat
tunica	tunica, burok
tunica	tunica, burok
tunnel syndrome	alagút szindróma, (témák1, témák2)
tunnel syndrome	alagút szindróma, (témák1, témák2)
turbid	zavaros, turbidus
turbid	zavaros, turbidus
turbidity	turbiditás, zavarosodás
turbidity	turbiditás, zavarosodás
turicephaly	turricephalia, toronykoponya
turicephaly	turricephalia, toronykoponya
Turner's syndrome	A nők ritka genetikai rendellenessége (1:2500), amely jellemzői az alacsony testmagasság (100%), és a szexuális fejlődés hiánya a pubertáskor. Normálisan a nőknél két X chromozóma van. A Turner szindrómánál az egyik X chromozóma hiányzik (45,X), vagy hibás. Más klinikai tünetek: alacsony testmagasság (100%), petefészekelégtelenség (90%), megdagadt kéz és lábfejek (80%), alacsony hátulsó hajhatár (80%), széles mel
Turner's syndrome	A nők ritka genetikai rendellenessége (1:2500), amely jellemzői az alacsony testmagasság (100%), és a szexuális fejlődés hiánya a pubertáskor. Normálisan a nőknél két X chromozóma van. A Turner szindrómánál az egyik X chromozóma hiányzik (45,X), vagy hibás. Más klinikai tünetek: alacsony testmagasság (100%), petefészekelégtelenség (90%), megdagadt kéz és lábfejek (80%), alacsony hátulsó hajhatár (80%), széles mel
turycephaly	toronykoponya, turricephalia
turycephaly	toronykoponya, turricephalia
twisting	csavarodás, torzió
twisting	csavarodás, torzió
tympanic membrane	dobhártya, membrana tympani
tympanic membrane	dobhártya, membrana tympani
tympano-	tympano-, dobhártya-
tympano-	tympano-, dobhártya-
tympaosclerosis	tympanosclerosis, dobhártya-keményedés
tympaosclerosis	tympanosclerosis, dobhártya-keményedés
typical	tipikus, jellegzetes
typical	tipikus, jellegzetes
ubiquitous	ubikviter, mindenütt meglelhető/előforduló
ubiquitous	ubikviter, mindenütt meglelhető/előforduló
ulcer	fekély, ulkusz, ulcus
ulcer	fekély, ulkusz, ulcus
ulceration	ulceratio, fekélyesedés
ulceration	ulceratio, fekélyesedés
ulcerative colitis	colitis ulcerosa, fekélyes vastagbélgyulladás
ulcerative colitis	colitis ulcerosa, fekélyes vastagbélgyulladás
ulna	singcsont, ulna
ulna	singcsont, ulna
ulnar	ulnaris, singcsontal kapcsolatos,
ulnar	ulnaris, singcsontal kapcsolatos,
ultimate	utolsó, ultimus
ultimate	utolsó, ultimus
ultrasound examination	ultraszonográfia, ultrahangkivizsgálás
ultrasound examination	ultraszonográfia, ultrahangkivizsgálás
ultraviolet	UV, ultraviola
ultraviolet	UV, ultraviola
umami	Az ötödik íz. Ez a glutamát és a MSG íze. A többi négy íz az édes, savanyú, sós és keserű. Kikunae Ikeda 1907-ben fedezte fel. Umami japánul felséges ízt jelent.
umami	Az ötödik íz. Ez a glutamát és a MSG íze. A többi négy íz az édes, savanyú, sós és keserű. Kikunae Ikeda 1907-ben fedezte fel. Umami japánul felséges ízt jelent.
umbilical	omphalo-, köldök-
umbilical	omphalo-, köldök-
umbilical hernia	omphalokele, hernia umbilicalis, köldöksérv
umbilical hernia	omphalokele, hernia umbilicalis, köldöksérv
umbilicalisation	\köldökösödés\, Olyan papullák a bőrön, amelyeknek középtályt besüppedésük van.,
umbilicalisation	\köldökösödés\, Olyan papullák a bőrön, amelyeknek középtályt besüppedésük van.,
umbilicus	köldök, umbilicus, omphalum
umbilicus	köldök, umbilicus, omphalum
uncarthrosis	a processus uncinatus (a nyaki csigolzák része) betegsége,
uncarthrosis	a processus uncinatus (a nyaki csigolzák része) betegsége,
unconsciousness	sopor, eszméletlenség
unconsciousness	sopor, eszméletlenség
under-	szub-, sub-, alatti-
under-	szub-, sub-, alatti-
underneeth the tongue	szublingvális, nyelv alatti
underneeth the tongue	szublingvális, nyelv alatti
unilateral	unilaterális, egyoldalú
unilateral	unilaterális, egyoldalú
unit	egység
unit	egység
unit dose	Cssak egy dózisban előforduló, vagy használatos, amit standardként használnak, vagy van elfogadva.
unit dose	Cssak egy dózisban előforduló, vagy használatos, amit standardként használnak, vagy van elfogadva.
unstable angina	nemstabil angina, Olyan melkas tájéki fájdalmat, vagy kellemetlen érzést jelent, amely a szív elégtelen vérellátásából ered és gyógyszerrel, vagy pihenéssel kb. 10-15 perc alatt nem múlik el, vagy esetleg minimális munka után, vagy pihenés közben lép fel.,
unstable angina	nemstabil angina, Olyan melkas tájéki fájdalmat, vagy kellemetlen érzést jelent, amely a szív elégtelen vérellátásából ered és gyógyszerrel, vagy pihenéssel kb. 10-15 perc alatt nem múlik el, vagy esetleg minimális munka után, vagy pihenés közben lép fel.,
upper arm	felkar, brachium
upper arm	felkar, brachium
uptake	felvétel,
uptake	felvétel,
Ureaplasma	Microaerofilikus vagy anaerób, nem-motilis, sejtfal nélküli baktérium, amely a Mycoplasmataceae családba tartozik. Gram negatív coccus-ok. Átmérőjük 0,3 mikrométer. Megtalálható az emberi húgyutakban, és néha a végbélben vagy a garatban. Férfiaknál húgycsőgyulladást vagy prosztatagyulladást okozhat. Nőknél húgyuti és nemiszervi gyulladásokat okozhat ami terméketlenséghez vezethet. Ujszülötteknél tüdőgyulladást
Ureaplasma	Microaerofilikus vagy anaerób, nem-motilis, sejtfal nélküli baktérium, amely a Mycoplasmataceae családba tartozik. Gram negatív coccus-ok. Átmérőjük 0,3 mikrométer. Megtalálható az emberi húgyutakban, és néha a végbélben vagy a garatban. Férfiaknál húgycsőgyulladást vagy prosztatagyulladást okozhat. Nőknél húgyuti és nemiszervi gyulladásokat okozhat ami terméketlenséghez vezethet. Ujszülötteknél tüdőgyulladást
uremia	azotémia, urémia, uraemia, húgyvérűség
uremia	azotémia, urémia, uraemia, húgyvérűség
uresis	vizeletürítés
uresis	vizeletürítés
ureter	ureter, húgyvezeték
ureter	ureter, húgyvezeték
urethra	húgycső, urethra
urethra	húgycső, urethra
urethral obstruction	urethraobstrukció,
urethral obstruction	urethraobstrukció,
urethritis	húgycsőgyulladás, urethritis
urethritis	húgycsőgyulladás, urethritis
uretra	urethra, húgycső
uretra	urethra, húgycső
uric acid	húgysav
uric acid	húgysav
urinary	a vesével, húgyvezetékekkel és a húgyhólyaggal kapcsolatos
urinary	a vesével, húgyvezetékekkel és a húgyhólyaggal kapcsolatos
urinary continence	continentia urinae, képesség a vizelet visszatartására
urinary continence	continentia urinae, képesség a vizelet visszatartására
urinary sediment	vizelet üledék
urinary sediment	vizelet üledék
urination	urinatio, vizeletürítés, uresis
urination	urinatio, vizeletürítés, uresis
urine	urina, vizelet
urine	urina, vizelet
urine protein	Fehérje jelenléte a vizeletben. Normálisan 24 óral alatt kevesebb mint 150 mg. Ha az érték magasabb az vesekárosodást jelezhet., vizelet fehérje
urine protein	Fehérje jelenléte a vizeletben. Normálisan 24 óral alatt kevesebb mint 150 mg. Ha az érték magasabb az vesekárosodást jelezhet., vizelet fehérje
urobilinogen	A bilirubin lebomlásából keletkezett chromogén a belekben. Oxidációval urobilinre változik. Bizonyos mennyisége a széklettel ürül és bizonyos mennyiség felszívódik és az epébe vagy a vizeletbe bocsájtódik ki., urobilinogén,
urobilinogen	A bilirubin lebomlásából keletkezett chromogén a belekben. Oxidációval urobilinre változik. Bizonyos mennyisége a széklettel ürül és bizonyos mennyiség felszívódik és az epébe vagy a vizeletbe bocsájtódik ki., urobilinogén,
urogenital	urogenitális, húgy-ivar rendszerrel kapcsolatos
urogenital	urogenitális, húgy-ivar rendszerrel kapcsolatos
urology	urológia, Egy orvosi tudományág, amely a vizelet termelő és elvezető szervek tanulmányozásával és gyógyításával foglalkozik a nőknél és a vizelet termelő, vizelet elvezető és nemi szervek tanulmányozásával és gyógyításával foglalkozik a férfiaknál.,
urology	urológia, Egy orvosi tudományág, amely a vizelet termelő és elvezető szervek tanulmányozásával és gyógyításával foglalkozik a nőknél és a vizelet termelő, vizelet elvezető és nemi szervek tanulmányozásával és gyógyításával foglalkozik a férfiaknál.,
urtica	csalánfolt
urtica	csalánfolt
urticaria	csalánkiütés, urticaria,
urticaria	csalánkiütés, urticaria,
uter-	metro-, méh-
uter-	metro-, méh-
uterine cervix	méhnyak, cervix uteri
uterine cervix	méhnyak, cervix uteri
uterine fundus	méhfenék,
uterine fundus	méhfenék,
uterine perforation	a méh átlyukadása,
uterine perforation	a méh átlyukadása,
uterine prolaps	méhelőesés, prolapsus uteri
uterine prolaps	méhelőesés, prolapsus uteri
uterus	méh
uterus	méh
UV light	UV-fény,
UV light	UV-fény,
uvea	A szemgolyó egy része amely a szaruhártyából, sugártestből és az érhártyából áll., uvea, (kép)
uvea	A szemgolyó egy része amely a szaruhártyából, sugártestből és az érhártyából áll., uvea, (kép)
uvula	nyelvcsap, uvula palatina
uvula	nyelvcsap, uvula palatina
vacuum	vákuum, légüres tér
vacuum	vákuum, légüres tér
vacuum aspiration	suction curettage, A terhességmegszakítás egyik módszere amelyet az első trimeszterben alkalmaznak, ahol a méh tartalmát egy szűk csövön keresztül eltávolítják.,
vacuum aspiration	suction curettage, A terhességmegszakítás egyik módszere amelyet az első trimeszterben alkalmaznak, ahol a méh tartalmát egy szűk csövön keresztül eltávolítják.,
vacuum phenomenon	(bővebben itt)
vacuum phenomenon	(bővebben itt)
vagina	hüvely, vagina
vagina	hüvely, vagina
vagina-	elytro-, hüvely-
vagina-	elytro-, hüvely-
vaginal	vaginális, hüvellyel kapcsolatos
vaginal	vaginális, hüvellyel kapcsolatos
vaginal diaphragm	hüvelyi diaphragma, cervical diaphragm,
vaginal diaphragm	hüvelyi diaphragma, cervical diaphragm,
vaginal pain	vaginodynia, hüvelyfájdalom
vaginal pain	vaginodynia, hüvelyfájdalom
vaginitis	colpitis, hüvelygyulladás
vaginitis	colpitis, hüvelygyulladás
vagino-	hüvely-, vagino-, kolpo-
vagino-	hüvely-, vagino-, kolpo-
vagus nerve	bolygóideg, nervus vagus
vagus nerve	bolygóideg, nervus vagus
validation	jóváhagyás, érvényesítés, megerősítés
validation	jóváhagyás, érvényesítés, megerősítés
valve	billentyű, valvula
valve	billentyű, valvula
valvular	valvuláris, billentyűvel kapcsolatos
valvular	valvuláris, billentyűvel kapcsolatos
valvular insufficiency	billentyűelégtelenség, insufficientia valvularis
valvular insufficiency	billentyűelégtelenség, insufficientia valvularis
Van Nuys classification	Van Nuys osztályozás,
Van Nuys classification	Van Nuys osztályozás,
vaporisation	vaporizáció, párolás
vaporisation	vaporizáció, párolás
variable	variábilis, változó
variable	variábilis, változó
variant	variáns, változat
variant	variáns, változat
varicocele	varicokele, visszerek alkotta sérv
varicocele	varicokele, visszerek alkotta sérv
varicose	varicosus, visszeres
varicose	varicosus, visszeres
varicose vein	viszér
varicose vein	viszér
varicosity	varicositas, visszeresség
varicosity	varicositas, visszeresség
varicous	visszeres, varicosus
varicous	visszeres, varicosus
varix	ércsomó, varix, görcsér, kidudorodó visszerek
varix	ércsomó, varix, görcsér, kidudorodó visszerek
varus foot	dongaláb, pes varus
varus foot	dongaláb, pes varus
vascular	vaszkuláris, érrendszeri
vascular	érrel kapcsolatos, vascularis
vascular	vaszkuláris, érrendszeri
vascular	érrel kapcsolatos, vascularis
vascular encephalopathy	az erek megbetegedéséből és ezáltal a vérellátás hiánya okozta agyvelőbántalom, encephalopathia vascularis
vascular encephalopathy	az erek megbetegedéséből és ezáltal a vérellátás hiánya okozta agyvelőbántalom, encephalopathia vascularis
vascularisation	vascularisatio, érképződés
vascularisation	vascularisatio, érképződés
vasculitis	érgyulladás, vasculitis
vasculitis	érgyulladás, vasculitis
vasectomy	vasectomia, az ondóvezeték sebészeti átmetszése (fogamzásgátlás)
vasectomy	vasectomia, az ondóvezeték sebészeti átmetszése (fogamzásgátlás)
vaso-	ér-, angio-
vaso-	ér-, angio-
vasoconstriction	érszűkítés, vazokonstrikció
vasoconstriction	érszűkítés, vazokonstrikció
vasoconstrictor	vazokonstrictor, érszűkítő
vasoconstrictor	vazokonstrictor, érszűkítő
vasodilatation	vazodilatáció, értágulás
vasodilatation	vazodilatáció, értágulás
vasodilator	vazodilatátor, értágító
vasodilator	vazodilatátor, értágító
vasodylation	értágulás, vazodilatáció
vasodylation	értágulás, vazodilatáció
vasodylator	értágító, vazodilatátor
vasodylator	értágító, vazodilatátor
vasopresin	vazopresszin, antidiuretikus hormon
vasopresin	vazopresszin, antidiuretikus hormon
vasospasm	vazospazmus, érgörcs
vasospasm	vazospazmus, érgörcs
vault	fornix, boltozat
vault	fornix, boltozat
vector	vektor, átvivő
vector	vektor, átvivő
vegetarian	vegetariánus, növényi eredetű ételekkel táplálkozó
vegetarian	vegetariánus, növényi eredetű ételekkel táplálkozó
vegetative	vegetatív, nem akaratlagos akarat nélkül működő
vegetative	vegetatív, nem akaratlagos akarat nélkül működő
vein	gyűjtőér, véna, visszér, flebo-
vein	gyűjtőér, véna, visszér, flebo-
venasection	érvágás, venasectio
venasection	érvágás, venasectio
venepunction	vénapunkció, vénacsapolás
venepunction	vénapunkció, vénacsapolás
veneral	venerális, nemi érintkezéssel kapcsolatos
veneral	venerális, nemi érintkezéssel kapcsolatos
venesection	venesectio, érvágás
venesection	venesectio, érvágás
venipuncture	Az ér megszúrása orvosi okból (pl. vérvételre, IV folyadékok, vagy gyógyszerek beadására)
venipuncture	Az ér megszúrása orvosi okból (pl. vérvételre, IV folyadékok, vagy gyógyszerek beadására)
venostasis	venosztázis, vénás pangás
venostasis	venosztázis, vénás pangás
venous	vénás, venosus, vénával kapcsolatos
venous	vénás, venosus, vénával kapcsolatos
ventilation	ventilláció, légzés, légcsere
ventilation	ventilláció, légzés, légcsere
ventouse	Vákumot gerjesztő eszköz, amit a szülésnél használnak, ha a szülés nem halad a megfelelő módon.
ventouse	Vákumot gerjesztő eszköz, amit a szülésnél használnak, ha a szülés nem halad a megfelelő módon.
ventral	ventrális, hasi síkhoz közelebb eső
ventral	ventrális, hasi síkhoz közelebb eső
ventricle	kamra, ventriculus
ventricle	kamra, ventriculus
ventricular	ventrikuláris, kamrai
ventricular	ventrikuláris, kamrai
ventricular parasystole	Szívritmus rendellenesség, ahol két ritmusadó központ van, amelyek különböző sebességgel adják a ritmust. A kamrai parasystoliánál az egyik ritmusadó a sinoatriális csomó (a normális ritmusadó) és a másik pedig a kamrákban található. Mindegyik ritmusadó és így a ritmus is egymás hatásától védve vannak., kamrai parasystolia,
ventricular parasystole	Szívritmus rendellenesség, ahol két ritmusadó központ van, amelyek különböző sebességgel adják a ritmust. A kamrai parasystoliánál az egyik ritmusadó a sinoatriális csomó (a normális ritmusadó) és a másik pedig a kamrákban található. Mindegyik ritmusadó és így a ritmus is egymás hatásától védve vannak., kamrai parasystolia,
ventricular septal deffect	VSD, ventricularis septum defectus, A kamrákat elválasztó septum (fal) hibája ami általában azt jelenti, hogy nyílás található benne,
ventricular septal deffect	VSD, ventricularis septum defectus, A kamrákat elválasztó septum (fal) hibája ami általában azt jelenti, hogy nyílás található benne,
ventricular septum	A jobb és bal szívkamrát elválasztó sövény.,
ventricular septum	A jobb és bal szívkamrát elválasztó sövény.,
ventricular shunt	ventrikuláris sönt,
ventricular shunt	ventrikuláris sönt,
ventriculomegaly	ventriculomegalia,
ventriculomegaly	ventriculomegalia,
ventriculotomy	ventriculotómia,
ventriculotomy	ventriculotómia,
ventriculum	ventriculus, kamra
ventriculum	ventriculus, kamra
venule	venula, kis méretű véna, vénácska
venule	venula, kis méretű véna, vénácska
verbal	verbális, szóbeli
verbal	verbális, szóbeli
Verga's ventricle	lásd: cavum vergae
Verga's ventricle	lásd: cavum vergae
veridical	igazmondó, a valóságnak megfelelő, veridicalis
veridical	igazmondó, a valóságnak megfelelő, veridicalis
vermicular	hernyós, hernyóhoz hasonló (pl. mozgás), vermikuláris
vermicular	hernyós, hernyóhoz hasonló (pl. mozgás), vermikuláris
vermis of the cerebellum	kisagyféreg, vermis cerebelli
vermis of the cerebellum	kisagyféreg, vermis cerebelli
vermus	A kisagy középvonalát a vermis vermus zónájának hívják.,
vermus	A kisagy középvonalát a vermis vermus zónájának hívják.,
version	fordulás, verzió
version	fordulás, verzió
vertebra	csigolya, vertebra, spondylus
vertebra	csigolya, vertebra, spondylus
vertebral	csigolyával kapcsolatos, vertebralis
vertebral	csigolyával kapcsolatos, vertebralis
vertebral artery	csigolyaartéria, arteria vertebralis
vertebral artery	csigolyaartéria, arteria vertebralis
vertebral canal	gerinccsatorna, canalis vertebralis
vertebral canal	gerinccsatorna, canalis vertebralis
vertebral column	gerinc, collumna vertebralis
vertebral column	gerinc, collumna vertebralis
vertebral fracture	csigolyatörés, fractura vertebrae
vertebral fracture	csigolyatörés, fractura vertebrae
vertebro-	csigolya-,
vertebro-	csigolya-,
vertebrobasilar	a vertebrális és a basilaris verúerekkel kapcsolatos, vertebrobasilaris
vertebrobasilar	a vertebrális és a basilaris verúerekkel kapcsolatos, vertebrobasilaris
vertebrobasilar syndrome	A vertebrobasilaris rendszer ereinek elszűkülése., A tünetek a következők lehetnek: szédülés, ataxia, vertigo, látási zavarok, motoros hiányosságok, zavartság, fokális görcsös rohamok, afázia, fejfájás és ájulás., vertebrobasilaris szindróma,
vertebrobasilar syndrome	A vertebrobasilaris rendszer ereinek elszűkülése., A tünetek a következők lehetnek: szédülés, ataxia, vertigo, látási zavarok, motoros hiányosságok, zavartság, fokális görcsös rohamok, afázia, fejfájás és ájulás., vertebrobasilaris szindróma,
vertebrobasilar system	vertebrobasilaris rendszer, Ez az agy posterior vérkeringését látja el és 3 fő érből áll össze. Két arteria vertebralis-ból és az artéria basilaris-ból.,
vertebrobasilar system	vertebrobasilaris rendszer, Ez az agy posterior vérkeringését látja el és 3 fő érből áll össze. Két arteria vertebralis-ból és az artéria basilaris-ból.,
vertical	vertikális, függőleges
vertical	vertikális, függőleges
vertigo	szédülés, vertigo
vertigo	szédülés, vertigo
vesical	vezikális, hólyaggal kapcsolatos
vesical	vezikális, hólyaggal kapcsolatos
vesicle	vesice, kis hólyag, cysta, bulla
vesicle	vesice, kis hólyag, cysta, bulla
vesicular breathing	sejtes légzés, Normális légzéshang amely puha és mélyebbre hangolt, amikor a tüdőt halgatjuk.,
vesicular breathing	sejtes légzés, Normális légzéshang amely puha és mélyebbre hangolt, amikor a tüdőt halgatjuk.,
vesiculobullous	egyszerre kis és nagy hólyagos, vesiculobullosus
vesiculobullous	egyszerre kis és nagy hólyagos, vesiculobullosus
vessel	vas, ér
vessel	vas, ér
vestibular neuritis	neuronitis vestibularis,
vestibular neuritis	neuronitis vestibularis,
vestibulum	előcsarnok, előtér, vestibulum
vestibulum	előcsarnok, előtér, vestibulum
via	út, bizonyos úton keresztül
via	út, bizonyos úton keresztül
vibration	fremitus, rezgés. vibráció
vibration	fremitus, rezgés. vibráció
vigility	éberség, vigilitás
vigility	éberség, vigilitás
villous	bolyhos, frondosus
villous	bolyhos, frondosus
vinblastine	vinblastin,
vinblastine	vinblastin,
viral	vírusos
viral	vírusos
viral load drop	a szervezetben található vírusszint, vagy vírusok számámak csökkenése, szó szerint: vírus teher csökkenés
viral load drop	a szervezetben található vírusszint, vagy vírusok számámak csökkenése, szó szerint: vírus teher csökkenés
viral meningitis	vírusos agyhártyagyulladás
viral meningitis	vírusos agyhártyagyulladás
viremia	virémia, vírusok vérben való jelenléte
viremia	virémia, vírusok vérben való jelenléte
virgin	szűz
virgin	szűz
virion	Teljes vírus részecske a sejten kívül, amely tartalmazza a DNSt vagy RNSt a protein burkon belül., virion
virion	Teljes vírus részecske a sejten kívül, amely tartalmazza a DNSt vagy RNSt a protein burkon belül., virion
virus	vírus
virus	vírus
viscera	zsigerek
viscera	zsigerek
visceral	viszcerális, zsigeri
visceral	viszcerális, zsigeri
viscosity	viszkozitás,
viscosity	viszkozitás,
vision	visus, látás
vision	visus, látás
visual	vizuális, látó, látással kapcsolatos
visual	vizuális, látó, látással kapcsolatos
visual disturbances	látászavarok
visual disturbances	látászavarok
visual field defect	scotoma, látótérkiesés
visual field defect	scotoma, látótérkiesés
vital	életfontosságú, vitális
vital	életfontosságú, vitális
vital capacity	vitálkapacitás
vital capacity	vitálkapacitás
vitamin B1	aneurin, B1-vitamin
vitamin B1	aneurin, B1-vitamin
vitamin B12	nitrokobalamin, B12c vitamin
vitamin B12	nitrokobalamin, B12c vitamin
vitamin B2	laktoflavin, riboflavin, B2-vitamin
vitamin B2	riboflavin, B2 vitamin
vitamin B2	laktoflavin, riboflavin, B2-vitamin
vitamin B2	riboflavin, B2 vitamin
vitamin B3	niacin,
vitamin B3	niacin,
vitamin C	C-vitamin, aszkorbinsav
vitamin C	C-vitamin, aszkorbinsav
vitamin D2	kalciferol, D2-vitamin
vitamin D2	ergokalciferol, D2-vitamin
vitamin D2	kalciferol, D2-vitamin
vitamin D2	ergokalciferol, D2-vitamin
vitamin D3	cholecalciferol, D3-vitamin
vitamin D3	cholecalciferol, D3-vitamin
vitamin E	tokoferol, tocopherol
vitamin E	tokoferol, tocopherol
vitamin H	biotin, H-vitamin
vitamin H	biotin, H-vitamin
vitamin K2	farnokinon, K2-vitamin
vitamin K2	farnokinon, K2-vitamin
vitelline sac	szíkhólyag, saccus vitellinus,
vitelline sac	szíkhólyag, saccus vitellinus,
vitiligo	vitiligó, leukoderma, fehérfolt betegség,
vitiligo	vitiligó, leukoderma, fehérfolt betegség,
vitreal body	üvegtest, corpus vitreum
vitreal body	üvegtest, corpus vitreum
VLDL	very low density lipoprotein, nagyon alacsony sűrűségű lipoprotein
VLDL	very low density lipoprotein, nagyon alacsony sűrűségű lipoprotein
vocal	vokális, hanggal kapcsolatos
vocal	vokális, hanggal kapcsolatos
vocal cord	hangszalag, ligamentum vocale
vocal cord	hangszalag, ligamentum vocale
volar	voláris, tenyéri
volar	voláris, tenyéri
volume	volumen, térfogat
volume	volumen, térfogat
volvulus	volvulus, bélcsavarodás
volvulus	volvulus, bélcsavarodás
vomit	hányás, vomitus
vomit	hányás, vomitus
vomiting of blood	vérhányás, haematemesis
vomiting of blood	vérhányás, haematemesis
Von Zambusch's disease	lásd: lichen planus
Von Zambusch's disease	lásd: lichen planus
vortex	vortex, örvény
vortex	vortex, örvény
vulva	női külső nemi szervek együttes neve
vulva	női külső nemi szervek együttes neve
Waldenström macroglobulinemia	(WM),
Waldenström macroglobulinemia	(WM),
walking	járás
walking	járás
walking aid	járás segítéséhez használt segédeszköz
walking aid	járás segítéséhez használt segédeszköz
Wallenberg's syndrome	Az arteria inferior posterior cerebelli elzáródása ami ispsilaterális arc fájdalomérzet és hőérzékelés elvesztésével és végtag ataxiával jár és contralaterális törzs és végtag fájdalomérzet és hőérzékelés elvesztésével jár., Waldenberg szindróma,
Wallenberg's syndrome	Az arteria inferior posterior cerebelli elzáródása ami ispsilaterális arc fájdalomérzet és hőérzékelés elvesztésével és végtag ataxiával jár és contralaterális törzs és végtag fájdalomérzet és hőérzékelés elvesztésével jár., Waldenberg szindróma,
wart	papilla, szemölcs, verruca
wart	papilla, szemölcs, verruca
wasting	sorvadás
wasting	sorvadás
water	aqua, víz, hidro-
water	aqua, víz, hidro-
wave	hullám
wave	hullám
waveform	hullámminta (pl. EKG-n)
waveform	hullámminta (pl. EKG-n)
wax	sebum, faggyú
wax	sebum, faggyú
WBC	white blood cell count, fehér vérsejt szám
WBC	white blood cell count, fehér vérsejt szám
webbed fingers	ujjösszenövés, syndactylia
webbed fingers	ujjösszenövés, syndactylia
well established medical use	jól bevált orvosi/gyógyászati használat
well established medical use	jól bevált orvosi/gyógyászati használat
Westergen (We)	ESR, vérsejtsülyedés, erythrocyte sedimentation rate,
Westergen (We)	ESR, vérsejtsülyedés, erythrocyte sedimentation rate,
whiplash injury	a gerinc ?ostorcsapás\ sérülése, A nyak és a nyaki gerinc sérülése, ami hirtelen felgyorsulás, vagy lelassulás eredménye, mint pl. az autóbaleseteknél.
whiplash injury	a gerinc ?ostorcsapás\ sérülése, A nyak és a nyaki gerinc sérülése, ami hirtelen felgyorsulás, vagy lelassulás eredménye, mint pl. az autóbaleseteknél.
whirl	vortex, örvény
whirl	vortex, örvény
white	fehér, albus
white	fehér, albus
white blood cell	leukocyta, fehérvérsejt, leucocyte, Bármely a vér színtelen sejtjeiből, amely maggal és cytoplazmával rendelkezik és a szervezet immunitásában tölt be szerepet,
white blood cell	leukocyta, fehérvérsejt, leucocyte, Bármely a vér színtelen sejtjeiből, amely maggal és cytoplazmával rendelkezik és a szervezet immunitásában tölt be szerepet,
white spot disease	lásd: lichen planus
white spot disease	lásd: lichen planus
whitehead	Kis, fehér, vagy sárgás cisztikus csomók a bőr felszíne alatt, amit a zsírmirigyek eldugulása által okozott zsír felgyülemlés okoz., milia
whitehead	Kis, fehér, vagy sárgás cisztikus csomók a bőr felszíne alatt, amit a zsírmirigyek eldugulása által okozott zsír felgyülemlés okoz., milia
whitish	albicans, fehéres
whitish	albicans, fehéres
WHO	World Health Organisation, Egészségügyi Világszervezet
WHO	World Health Organisation, Egészségügyi Világszervezet
widely	bőven, tágan
widely	bőven, tágan
widest	latissimus, legszélesebb
widest	latissimus, legszélesebb
will	bulia, akarat
will	bulia, akarat
wing	ala, szárny
wing	ala, szárny
Wirsung canal	Wirsung-vezeték, pancreatic duct,
Wirsung canal	Wirsung-vezeték, pancreatic duct,
wise	sapiens, bölcs
wise	sapiens, bölcs
with	cum,
with	cum,
withdrawal	elvonás
withdrawal	elvonás
withholding	visszatartás, retenció
withholding	visszatartás, retenció
without a disease	sine morbo,
without a disease	sine morbo,
Wolff-Parkinson-White syndrome	Wolff-Parkinson-White szindróma, W.P.W., WPW, A preexcitáció egy formája, amit paroxizmális tachycardia (szapora szívverés) vagy pitvar fibrilláció,  rövid PR és hosszú QRS intervallum jellemez delta hullámmal.
Wolff-Parkinson-White syndrome	Wolff-Parkinson-White szindróma, W.P.W., WPW, A preexcitáció egy formája, amit paroxizmális tachycardia (szapora szívverés) vagy pitvar fibrilláció,  rövid PR és hosszú QRS intervallum jellemez delta hullámmal.
woman	nő, femina
woman	nő, femina
World Health Organisation	WHO, Egészségügyi Világszervezet
World Health Organisation	WHO, Egészségügyi Világszervezet
worm	vermis, féreg
worm	vermis, féreg
worm shaped	vermiformis, féreg formájú
worm shaped	vermiformis, féreg formájú
worm-like	féregszerű, vermiformis
worm-like	féregszerű, vermiformis
wound	seb, vulnus
wound	seb, vulnus
wound healing	sebgyógyulás, sanatio vulneris
wound healing	sebgyógyulás, sanatio vulneris
wound scaring	sebhegedés, cicatrisatio
wound scaring	sebhegedés, cicatrisatio
wounding	sebzés, vulneratio
wounding	sebzés, vulneratio
wrinkling	corrugator, összeráncoló
wrinkling	corrugator, összeráncoló
xanthemia	xanthaemia, megemelkedett vérkarotid-szint carotinaemia karotinémia
xanthemia	xanthaemia, megemelkedett vérkarotid-szint carotinaemia karotinémia
xeno-	idegen-, xeno-
xeno-	idegen-, xeno-
xenophobia	xenofóbia, idegenektől való beteges félelem
xenophobia	xenofóbia, idegenektől való beteges félelem
xeroderma	bőrszárazság, xeroderma
xeroderma	bőrszárazság, xeroderma
xeropthalmia	szemkiszáradás, xerophthalmia
xeropthalmia	szemkiszáradás, xerophthalmia
xerostomia	xerostomia, szájszárazság
xerostomia	xerostomia, szájszárazság
xiphoid process	kardnyúlvány, processus xiphoideus
xiphoid process	kardnyúlvány, processus xiphoideus
yawning	ásítás, oscitatio
yawning	ásítás, oscitatio
yellow	flavus, sárga, xantho-, luteus
yellow	flavus, sárga, xantho-, luteus
yellow fever	sárgaláz, febris flava
yellow fever	sárgaláz, febris flava
yolk sac	szíkhólyag,
yolk sac	szíkhólyag,
z-score	z-érték,
z-score	z-érték,
Zambusch's disease	lásd: lichen planus
Zambusch's disease	lásd: lichen planus
zinc-protoporphyrin	cink-protoporfirin
zinc-protoporphyrin	cink-protoporfirin
zoster	lásd: herpes zoster
zoster	lásd: herpes zoster
zygomatic	zigomatikus, járomcsonttal kapcsolatos
zygomatic	zigomatikus, járomcsonttal kapcsolatos
zygomatic arch	járomív, arcus zygomaticus
zygomatic arch	járomív, arcus zygomaticus
zygomatic bone	járomcsont, os zygomaticus
zygomatic bone	járomcsont, os zygomaticus
\sub Q\	s.c., szubkután, bőr alá
\sub Q\	s.c., szubkután, bőr alá
