abortion rate	düşük oranı
abortionist	düşük yapan kimse
abortive	düşük yaptıran
abortus	düşük ürünü
abrachia	kolun konjenital yokluğu
abrachiocephalia	kol ve başın konjenital yokluğu
abrachius	kolsuz
abrade	eski
abrasio corneae	korneal abrazyon
abrasion	bir bölge yüzeyinin sıyrılması
abrasion grinding	ufalama
abrasive	abrazyon yapan
abrasiveness	bir maddenin sürtünmesiyle yüzeydeki aşınma
abreaction	duygusal rahatlama ve boşalma olayı
abrosia	perhiz
abrupt	aniden
abruptio	ayrılma
abruptio placentae	plasenta dekolmanı
abruption	ayrılma
abruptioplacentae	normal yerleşmiş plasentanın erken ayrılması
abscess	apse
abscission	kesip çıkarma
abscopal	radyasyon almış bir dokunun radyasyon almayan dokuyu etkilemesi
absence	yokluk
absidia	doğada yaygın bulunan bir mantar cinsi
absolute	saf
absolute accommodation	bir gözün diğerinden bağımsız yaptığı tam uyum
absolute adjustment	tam uyum
absolute alcohol	saf alkol
absorb	emerek içine al
absorbable	emilebilir
absorbable suture	emilebilir sütür
absorbance	soğurganlık
absorbefacient	emilime neden olan
absorbent	emici
absorptio	absorpsiyon
absorption	emilim
absorptive	gaz, sıvı, ışık ışını veya ısıyı içine alan
abstinence	yiyecek, içecek, ilaç veya cinsel ilişkinin alışkanlık olmasından kaçma
abstinence syndrome	yoksunluk sendromu
absurd	saçma
absurdity	saçmalık
abterminal	bir kastaki elektrik akımının yönünü gösteren
abtorsion	göz abdüksiyonu
abulia	istemli hareketlerde veya karar verme yeteneğinde olan azalma
abulic	istemli hareketi veya karar verme yeteneği azalan
abulomania	abulomani
abuse	v.kötüye kullan:n.yanlış kullanma
abutment	doğal yada sabit bir dişin sabit veya çıkarılabilir proteze destek olması
ac	aktinyum asetat
acalcerosis	akalserozis
acalcinosis	akalsinozis
acalculia	akalkuli
acampsia	bir eklemin katılığı veya bükülmemesi
acantha	diken veya spinal çıkıntı
acanthaceous	dikenli
acanthamoeba	toprak ve suda yaşayabilen bir amip
acanthesthesia	iğne batırılması gibi bir hissin var olduğu parestezi
acanthial	burun ucuna ait
acanthion	burnun en uç noktası
acantho	omurga çıkıntısı
acanthocephala	dikensi başlı kurt
acanthocheilonema	bir barsak solucanı
acanthocheilonemiasis	bir barsak solucanı enfeksiyonu
acanthocyte	multipl sitoplazmik çıkıntılar ile karakterize eritrosit
acanthocytosis	eritrositlerin çoğunun akantosit haline geldiği nadir durum
acanthoid	diken şekilli
acanthokeratodermia	akantokeratodermi
acantholysis	dikensi hücrelerin komşu hücrelerden ayrılması
acanthoma	epitermde yassı hücrelerin iyi huylu, kötü huylu veya neoplastik olmayan hipertrofisi
acanthometra	akantometra
acanthosis	hücre katının kalınlığının artması
acanthosis nigricans	akantozis nigrikans
acanthotic	akantoz özelliği olan
acapnia	kanda karbondioksit yokluğu
acapsular	kapsülsüz
acarbia	akarbi
acardia	kalbin konjenital yokluğu
acariasis	kenelerle oluşan bir hastalık
acaricide	kene ve sakırga öldüren madde
acarid	acaridae ailesinden bir tür kene
acaridae	bir tür kene
acaridiasis	kenelerle oluşan bir hastalık
acarina	kene ve sakırgaları içeren familya
acarine	keneler takımının bir üyesi
acarinosis	kenelerle oluşan bir hastalık
acarodermatitis	keneler sebebiyle cilt inflamasyonu ve erupsiyonu
acaroid	keneye benzer
acarophobia	küçük parazitlerden ve kaşınmadan korkma
acarpia	sterilite
acarpous	steril
acarus	bir kene cinsi
acaryote	çekirdeksiz
acatalasemia	kanda katalazın herediter yokluğu veya düşüklüğü
acatalepsia	mental retardasyon
acatamathesia	anlama yeteneğinin kaybolması
acataphasia	bir cümleyi doğru kurabilme yeteneğinin koybolması
acataposis	disfaji
acathectic	vücut salgılarının anormal kaybı ile ilişkili olan
acathexia	vücut salgılarının anormal kaybı
acathexis	belirli objelerin, düşüncelerin kişide duygusal cevap oluşmadığı bir akıl hastalığı
acaudal	akaudal
acaudate	akaudal
acaulina	sapsız
accelerans	hızlandırıcı
acceleration	hızlandırma
accelerator	etkiyi hızla artıran
accentric	merkezi olmayan genetikte setromer içermeyen
accentuate	şiddetlendir
accentuation	kuvvetlendirme
accentuator	bir doku, histolojik elementin boya ile birleşmesini sağlayan madde
acceptor	alıcı
accessorius	yardımcı
accessory	yedek
accipiter	accipiter
acclaim	anla
acclimation	iklim,çevre ısısı ve yüksekliğe fizyolojik olarak alışma
acclimatization	iklime alışma
accommodate	yer sağla
accommodation	uyum süreci
accommodative	uyum ile ilgili
accommodometer	akomodometre
accouchement	doğum
accouchement forse	müdahaleli doğum
accoucheur	ebe
accoucheuse	ebe
accrementition	döllenme veya tomurcuklanma ile üreme
accrescent	çoğalan
accreta	accreta
accrete	çoğal
accretiocordis	perikardın komşu ekstrakardiyak yapılara yapışması
accretion	aynı yapıda maddenin kenarlara eklenmesiyle büyüme
acedia	apati
acehalogasteria	yapışık ikizlerde baş,göğüs ve karnın olmaması
acellular	çok hücreli hale gelemeyen
acelom	mozetelyum ile çevrili vücut boşluğu veya şölomun olmaması
acelomate	sölomsuz
acenesthesia	fonksiyonlarının farkında olmama
acentric	periferik
acephalia	asefali
acephalism	baş yokluğu
acephalobrachia	kol ve başın konjenital yokluğu
acephalocardia	yapışkan ikizlerde parazitik bağlanmış olanında baş ve kalbin yokluğu
acephalocheiria	baş ve ellerin konjenital yokluğu
acephalocyst	steril hidatik kist
acephalopodia	baş ve ayakların konjenital yokluğu
acephalorrachia	baş ve omurganın konjenital yokluğu
acephalostomia	başın büyük bir kısmının yokluğu
acephalothoracia	baş ve toraksın yokluğu
acephalous	başsız
acephaly	baş yokluğu
acerate	sivri
aceratosis	akeratoz
acervuline	birleşmiş
acervulus	küçük küme
acescence	ekşilik
acescent	ekşi
acestoma	granülasyon dokusu
acetabulectomy	asetabulektomi
acetabulum	asetabulum
acetaldehyde	asetaldehid
acetaldehydrase	asetaldehidraz
acetate	asetat
acetazolamide	asetazolamid
acetic	asetik
acetic acid	asetik asit
acetic aldehyde	asetaldehid
acetilsalicylic acid	asetilsalisilik asit
aceto acetic acid	asetoasetik asit
acetolysis	asetoliz
acetonasthma	asetoastma
acetone	aseton
acetone body	keton cisimciği
acetonemia	asetonemi
acetonuria	asetonüri
acetyl	asetil kökü
acetylation	asetillenme
acetylcholine	asetilkolin
acetylcholinesterase	asetilkolinesteraz
acetylene	asetilen
achalasia	akalazya
ache	v.ağrı:n.ağrı
achilles reflex	aşil refleksi
achillobursitis	aşillobursit
achlorhydria	aklorhidri
achlorhydric anemia	aklorhidrik anemi
achloropsia	akloropsi
acholia	akoli
acholic	akolik
acholuria	akolüri
achondroplasia	akondroplazi
achromasia	akromazi
achromate	renk körü
achromatic	akromatik
achromatin	akromatin
achromatism	renk körlüğü
achromatopsia	akromatopsi
achromatosis	akromatozis
achromaturia	akromatüri
achromia	akromi
achromic	akromik
achromodermia	akromodermi
achromotrichia	akromotrişi
achylia	aşili
achylia gastrica	gastrik aşili
achylia pancreatica	pankreatik aşili
achylosis	aşili
acid	asit
acid base balance	asid baz dengesi
acid fast	aside dirençli
acid phosphatase	asit fosfataz
acid proof	aside dirençli
acidaminuria	aminoasidüri
acidemia	asidoz
acidification	asitleşme
acidify	asitleştir
acidism	asidizm
acidity	asidite
acidocyte	asidosit
acidocytosis	eozinofili
acidophil	asidofil
acidophil adenoma	asidofil adenom
acidoresistant	aside dirençli
acidosis	asidoz
acidotic	asidotik
aciduria	asidüri
acinitis	asinitis
acinus	asinüs
acne	akne
acne ciliaris	siliyer akne
acne rosacea	akne rozasea
acne vulgaris	akne vulgaris
acneiform	sivilcemsi
acnitis	aknit
acorea	akore
acoria	akori
acoumeter	akometre
acoumetry	akometri
acoustic	akustik
acoustics	sesbilim
acquiescent	uysal
acquired achromia	vitiligo
acquired immune deficiency syndrome	aıds
acrania	akrania
acrid	keskin
acrimony	keskinlik
acrinia	akrinia
acroarthritis	akroartrit
acroasphyxia	akrosiyanoz
acroataxia	akroataksi
acrobystiolith	akrobistiyolit
acrobystitis	akrobistit
acrocephaly	akrosefali
acrocyanosis	akrosiyanoz
acrodermatitis	akrodermatit
acrodermatitis enteropathica	akrodermatitis enteropatika
acrodermatosis	akrodermatoz
acrodynia	akrodini
acrohyperhidrosis	akrohiperhidrozis
acrohypothermic	akrohipotermik
acrohypothermy	akrohipotermi
acrokeratosis	akrokeratoz
acromastitis	akromastit
acromegalic	akromegalik
acromegaly	akromegali
acromelalgia	akromelalji
acromioclavicular	akromiyoklaviküler
acromion	akromiyon
acromionectomy	akromiyonektomi
acromioscapular	akromiyoskapüler
acromycosis	akromikoz
acronyx	akroniks
acroosteolysis	akroosteoliz
acroparalysis	akroparaliz
acropathy	akropati
acrophobia	akrofobi
acrostealgia	akrostealji
acrotic	akrotik
acrotism	nabızsızlık
acrotrophoneurosis	akrotrofonöroz
actin	kasın kasılmasını sağlayan bir protein
actinic	aktinik
actiniform	aktiniform
actinobacillosis	aktinobasilloz
actinodermatitis	aktinodermatit
actinogenesis	aktinogenez
actinogenetic	aktinogenetik
actinology	aktinoloji
actinolyte	aktinolit
actinometer	aktinometre
actinomyces	aktinomiçes
actinomycin	aktinomisin
actinomycosis	aktinomikoz
actinophytosis	aktinofitozis
actinotherapy	ışın tedavisi
action potential	aksiyon potansiyeli
actomyosin	bir kas proteini
acuity	keskinlik
acuminate	sivri uçlu
acupuncture	akupunktur
acupuncture anesthesia	akupunktur anestezi
acus	cerrahi iğne
acute	akut
acute abdomen	akut karın
acute abscess	akut apse
acute alcoholism	akut alkol intoksikasyonu
acute appendicitis	akut apandisit
acute hemolytic anemia	akut hemolitik anemi
acute hemorrhagic anemia	akut hemorajik anemi
acutenaculum	iğne tutucu
acyanoblepsia	asiyanoblepsi
acyanopsia	asiyanoblepsi
acyanotic	asiyanotik
ad lib	isteğe göre
adactylia	adaktili
adamantine	adamantin
adamantinocarcinoma	adamantinokarsinom
adamantinoma	adamantinom
adamantoblast	adamantoblast
adamantoblastoma	adamantinom
adaptometer	adaptometre
addax	bir tür antilop
addict	müptela
addiction	alışkanlık
addictive	alışkanlık yapan
additive	katkısal
adducens	addüktör
adducent	addüktör
adduction	addüksiyon
adductor	addüktör
adem's apple	adem elması
adenectomy	adenektomi
adenectopia	bez ektopisi
adenine	adenin
adenitis	adenit
adenoacanthoma	adenoakantom
adenoangiosarcoma	adenoanjiyosarkom
adenoblast	adenoblast
adenocarcinoma	adenokarsinom
adenocele	adenosel
adenochrome	sürrenal korteks
adenocyte	adenosit
adenoepithelioma	adenoepitelyoma
adenofibrosis	adenofibrozis
adenohypophysis	adenohipofiz
adenoid	adenoid
adenoidectomy	adenoidektomi
adenolipoma	adenolipom
adenolymphoma	adenolenfoma
adenoma	adenom
adenomatosis	adenomatozis
adenomatous	adenomatöz
adenomyoma	adenomyom
adenomyosarcoma	adenomyosarkom
adenomyosis	adenomiyoz
adenomyositis	adenomiyozit
adenopathy	adenopati
adenopharyngitis	adenofarenjit
adenophthalmia	adenoftalmi
adenosarcoma	adenosarkom
adenosine	adenozin
adenosine diphosphate	adenozin difosfat
adenosine triphosphate	adenozin trifosfat
adenotomy	adenotomi
adenotonsillectomy	adenotonsillektomi
adhare	yapış
adherent	yapışık
adhesion	yapışma
adhesiotomy	adheziotomi
adhesive	adezif
adiadochokinesis	adiadokokinezi
adiastol	adiyastol
adipectomy	adipektomi
adipocele	adiposel
adipogenous	adipojen
adipoid	adipoid
adipolysis	adipoliz
adipoma	adipoma
adiponecrosis	yağ nekrozu
adipose	adipoz
adipositis	adipozitis
adiposity	adipozite
adiposuria	adipozüri
aditus	ağız
adjacent	bitişik
adjuvant	adjuvan
adnexectomy	adneksektomi
adnexitis	adneksit
adnexopexy	adneksopeksi
adolescence	adolesans
adolescent	adolesan
adoption	evlat edinme
adrenal	böbreküstü bezi
adrenalectomy	adrenalektomi
adrenaline	adrenalin
adrenarche	adrenarş
adrenergic	adrenerjik
adrenocortical	adrenokortikal
adrenocorticotrophic	adrenokortikotropik
adrenocorticotrophin	adrenokortikotropik hormon
adrenocorticotropic	adrenokortikotropik
adrenogenital	adrenogenital
adrenogenital syndrome	adrenogenital sendrom
adrenogram	adrenogram
adrenography	adrenografi
adrenomedullotropic	adrenomedullotropik
adrenosterone	adrenosteron
adrenotropic	adrenotropik
adrenotropin	adrenotropin
adsorbent	adsorban
adsorption	adsorpsiyon
adtorsion	içe şaşılık
adult	erişkin
adult dose	erişkin dozu
adultery	zina
adulthood	erişkin dönem
adventitia	adventisya
adynamia	adinami
aerate	havalandır
aeration	havalanma
aerobe	aerob
aerobe organism	oksijenli ortamda yaşayan organizma
aerobic	aerobik
aerocele	aerosel
aerocoly	aerokoli
aeroembolism	hava embolisi
aerogastria	aerogastri
aerophagy	aerofaji
aerophilic	aerofil
aerophilous	aerofil
aerophobia	aerofobi
aerosol	aerosol
aerotherapy	aeroterapi
aerothermotherapy	aerotermoterapi
aesculapius	aesculapius
afebril	ateşsiz
afection	duygulanım
affective personality	siklotimik kişilik
afferent	afferent
affinity	afinite
afibrinogenemia	afibrinojenemi
aflatoxin	aflatoksin
african elephant	afrika fili
african manatee	afrika manatisi
african migratory	afrika göçmen
afterimage	afterimage
afunction	işlevsizlik
against the grain	doğasına aykırı
agalactia	süt olmaması
agamas	sırtı dikenli kertenkele
aganglionic	agangliyonik
aganglionosis	agangliyonozis
agar	agar
agar agar	agar agar
agastria	agastri
agastric	agastrik
agenesia	agenezi
agenesis	agenezi
ageusia	ageuzi
agger	kabartı
agglomeration	yığın
agglutinant	aglutinin
agglutinate	aglutine ol
agglutination	aglutinasyon
agglutinin	özel bir antikor
agglutinogen	aglutinojen
agglutinonogen	aglütinin meydana getiren bir madde
aggravate	ağırlaştır
aggregation	agregasyon
aggression	agresyon
aggressive	agresif
aggressivity	agresiflik
agitation	ajitasyon
agitographia	ajitografi
agitolalia	ajitolali
aglossia	aglosi
aglutinative	yapıştırıcı
aglutition	yutamama
aglycone	aglikon
agmatology	kırık bilimi
agnail	şeytan tırnağı
agnathia	agnati
agnogenic	agnojnik
agnosia	agnozi
agonadal	agonadal
agonal	agonik
agonize	kıvran
agony	agoni
agoraphobia	agorafobi
agouties	agutigiller ailesi
agouty	bir tür kemirici
agraffe	agraf
agranulocyte	agranülosit
agranulocytosis	agranülositoz
agranulosis	agranülosiz
agraphia	agrafi
agria	agria
agromania	agromani
agrypnocoma	uyanık koma
ague	sıtma nöbeti
agyria	agiria
aids	aıds
ailment	hastalık
air embolism	hava embolisi
airtight	hava geçirmez
aisthesis	algılama
akari	kene
akathisia	akatizi
akihiloa	bir kuş türü
akinesia	hareketsizlik
akinetic	hareketsiz
aknephascopia	alacakaranlık körlüğü
aktinosferyum	bir gözeli canlı
ala	kanat
ala nasi	burun kanadı
alalia	alali
alaudidae	tarla kuşugiller familyası
albedo retinae	retina ödemi
albinism	doğuştan renk maddesi eksikliği
albino	albino
albugo	albugo
albumen	albumin
albumin	albumin
albuminate	albumin bileşiği
albuminemia	hiperalbuminemi
albuminoid	albuminoid
albuminolysis	proteoliz
albuminometer	albuminometre
albuminosis	albuminozis
albuminuria	albuminüri
albumose	albümoz
albumosuria	albümozüri
alcapton	homogentisik asit
alcaptonuria	alkaptonüri
alcoholemia	alkolemi
alcoholic	alkolik
alcoholic ataxia	alkolik ataksi
alcoholic cirrhosis	alkolik siroz
alcoholism	alkolizm
alcoholist	alkolik
alcoholomania	alkolomani
alcoholometer	alkolometre
alcoholophilia	alkolofili
alcoholuria	alkolüri
aldehyde	aldehid
aldose	aldoz
aldosterone	aldosteron
aldosteronism	aldosteronizm
aldosteronoma	aldosteronoma
alembic	imbik
aleukia	alösemi
aleukocytosis	alökositoz
alexia	aleksi
algology	yosunbilim
algometer	ağrıölçer
algophily	algofili
algophobia	algofobi
algor mortis	ölü soğukluğu
alices	alices
alienation	ruh hastalığı
alienism	psikiyatri
alienist	psikiyatrist
aliment	gıda
alimentary	alimenter
alimentary albuminuria	alimenter albuminüri
alimentary system	sindirim sistemi
alimentation	beslenme
alimentology	beslenme bilimi
aliphatic	alifatik
alkalemia	alkalemi
alkalescent	alkali
alkali	alkali
alkaline	alkalik
alkaline phosphatase	alkalen fosfataz
alkalinity	alkalinite
alkalinuria	alkalinüri
alkalization	alkalileştirme
alkaloid	alkaloid
alkalosis	alkaloz
alkaluria	alkalüri
alkyl	alkil
alkylating agent	alkilleyici ajan
allantiasis	botulizm
allantoic	allantoik
allantois	allantois
allele	alel
allelism	alelizm
allergen	allerjen
allergic	allerjik
allergic asthma	allerjik astım
allergy	allerji
alleviate	yatıştır
alleviation	yatıştırma
allocentric	allosentrik
allograft	homogreft
allokeratoplasty	allokeratoplasti
allopathy	allopati
allophasis	allofazi
allophthalmia	alloftalmi
alloplasia	alloplazi
alloplastic	alloplastik
alloplasty	alloplasti
allotropism	allotropi
alloy	alaşım
allyl	alil
almond oil	badem yağı
alochia	aloşi
alopecia	alopesi
alopecia areata	alopesi areata
alpha	alfa
alpha fetoprotein	alfa fetoprotein
alphos	psoriyazis
alpine swift	ak karınlı saksağan kuşu
alumina	aluminyum oksit
aluminium	aluminyum
aluminosis	aluminozis
alveolar	alveoler
alveolar abscess	alveoler apse
alveolar air	alveol havası
alveoli	alveol
alveolitis	alveolit
alveolodental	alveolodental
alveolus	alveol
alymphocytosis	alenfositoz
alysm	alizm
alysosis	iç sıkıntısı
amalgam	amalgam
amastia	amasti
amaurosis	amorozis
amaurosis fugax	amorozis fugaks
amaurotic	amorotik
amaxophobia	amaksofobi
ambidexter	ambidekster
ambiopia	ambiyopi
ambisexual	hermafrodit
ambivalence	ambivalans
ambivert	ambivert
amblyacousia	ambliakuzi
amblyopia	ambliyopi
amblyoscope	ambliyoskop
ambosexual	biseksüel
ambulance	ambulans
ambulant	dolaşabilen
ambulation	dolaşma
ambulatory	ambulatuar
ambustion	pişik
ambystomidae	küt ağızlıgiller familyası
ameba	amip
amebiasis	amebiyazis
amebic	amebik
amebicide	amebisid
ameboid	amibimsi
ameboma	amebom
ameburia	amibüri
amelanotic	melaninsiz
amelia	ameli
ameliorate	iyileş
ameloblast	ameloblast
amenable	yatkın
amenorrhea	amenore
amenorrheal	amenoreik
american law	amerikan hukuku
ametria	ametri
ametrometer	ametrometre
ametropia	ametropi
ametropic	ametrop
amianthinopsy	amiantinopsi
amicably	dostça
amicrobic	mikropsuz
amidase	amidaz
amide	amid
aminase	aminaz
amine	amin
amino	amino
amino acid	aminoasit
aminoaciduria	aminoasidüri
aminophylline	aminofilin
aminopterin	aminopterin
amitosis	amitoz
amitotic	amitotik
ammonia	amonyak
ammonium	amonyum
ammonium chloride	amonyum klorür
amnalgesia	amnaljezi
amnesia	amnezi
amnesic	amnezik
amnesty international	uluslararası af örgütü
amnihook	amniyotom
amniocentesis	amniyosentez
amniochorial	amniyokoryonik
amniochorionic	amniyokoryonik
amnioclepsis	amnioklepsi
amniogenesis	amniyogenez
amniography	amniyografi
amnioma	amniyom
amnion	amniyon zarı
amnionic	amniyotik
amnionitis	amnionitis
amniorrhea	amniyore
amniorrhexis	amniyoreksi
amnioscope	amniyoskop
amnioscopy	amniyoskopi
amniotic	amniyotik
amniotic sac	amniyon kesesi
amniotome	amniyotom
amniotomy	amniyotomi
amoeba	amip
amorphous	amorf
amoxicillin	amoksisilin
ampere	amper
amperemeter	ampermetre
amphetamine	amfetamin
amphibia	hem karada hem suda yaşayan canlılar
amphoric	amforik
amphoteric	amfoterik
ampicillin	ampisilin
ample	bol
amplitude	amplitüd
amplitude accommodation	gözün dinlenme,tam uyum durumları arasındaki kırıcılık farkı
ampule	ampul
ampulla	ampulla
ampulla of rectum	ampulla rekti
ampulla of uterine tube	pars ampullaris
ampulla of vater	ampulla vateri
ampullar	ampuller
amputate	ampute et
amputation	amputasyon
amyasthenia	amiyasteni
amyelia	amiyeli
amyelotrophy	amiyelotrofi
amygdaloid	amigdaloid
amyl	amil
amyl nitrite	amil nitrit
amylase	amilaz
amylogenesis	amilogenez
amyloid	amiloid
amyloidosis	amiloidoz
amylose	amiloz
amyocardia	amiyokardi
amyoplasia	amiyoplazi
amyoplasia congenita	konjenital amiyoplazi
amyotaxy	amiyotaksi
amyotonia	amiyotoni
amyotonia congenita	konjenital amiyotoni
amyotrophic lateral sclerosis	amyotrofik lateral skleroz
anabolic	anabolik
anabolism	anabolizma
anacidity	anasidite
anacrotic	anakrotik
anacrotism	anakrotizm
anacusia	anakuzi
anadicrotic	anakrotik
anadicrotism	anakrotizm
anaerobe	anaerob
anaerobic	anaerobik
anal	anal
analeptic	analeptik
analgesia	analjezi
analgesic	analjezik
analgia	analji
analogous	analog
analogue	analog
analogy	benzerlik
analysis	analiz
analytic	analitik
analytical	analitik
analyze	analiz et
anamnesis	anamnez
anamnestic	anamnestik
anamniotic	amniyonsuz
anangioplasia	ananjiyoplazi
anaphase	anafaz
anaphoresis	anaforez
anaphoretic	anaforetik
anaphrodisia	frijidite
anaphylactic	anafilaktik
anaphylactin	anafilaktin
anaphylactogen	anafilaktojen
anaphylactoid	anafilaktoid
anaphylatoxin	anafilatoksin
anaphylaxis	anafilaksi
anaplasia	anaplazi
anaplasty	anaplasti
anarthria	afazi
anasarca	anazarka
anastomose	anastomoze et
anastomosis	ağızlaştırma
anastomotic	anastomotik
anatomic	anatomik
anatomical	anatomik
anatomist	anatomi uzmanı
anatomy	anatomi
anatoxin	anatoksin
anatricrotic	anatrikrotik
anatricrotism	anatrikrotizm
anatripsis	ovma
anatriptic	anatriptik
ancestry	ecdat
ancillary	ikincil
ancon	dirsek
anconitis	ankonitis
ancylostoma americanum	necator americanus
ancylostoma duodenale	ankilostoma duodenale
ancylostome	ankilostom
ancylostomiasis	ankilostomiyazis
androgalactorrhea	androgalaktore
androgen	androjen
androgenesis	androgenez
androgenic	androjen
android	android
android pelvis	android pelvis
andrology	androloji
andromania	andromani
andropathy	andropati
androphobia	androfobi
androstenedione	androstenedion
androsterone	androsteron
anelectrode	anod
anemia	anemi
anencephalia	anensefali
anergic	anerjik
anergy	anerji
anesthesia	anestezi
anesthesiologist	anesteziyolog
anesthesiology	anesteziyoloji
anesthetic	anestetik
aneurysm	anevrizma
aneurysmal	anevrizmal
aneurysmectomy	anevrizmektomi
aneurysmoplasty	anevrizmoplasti
anger pectoris	angina pektoris
angiectasia	anjiyektazi
angiectomy	anjiyektomi
angiitis	anjiitis
angina	angina
angina diphtheritica	difteri
angina laryngea	larenjit
angina pectoris	angina pektoris
anginal	anginal
anginal attack	angina atağı
angioblast	anjiyoblast
angioblastoma	hemanjiyoblastom
angiocardiography	anjiyokardiyografi
angioclast	angioklast
angiodystrophia	anjiyodistrofi
angiofibroma	anjiyofibrom
angiogenesis	anjiyogenez
angioglioma	anjiyoglioma
angiogram	anjiyogram
angiography	anjiyografi
angiohemophilia	anjiyohemofili
angioid	anjiyoid
angiokeratoma	anjiyokeratom
angiolipoma	anjiyolipom
angiology	anjiyoloji
angiolymphoma	anjiyolenfoma
angioma	anjiyom
angiomatosis	anjiyomatozis
angiomatosis retinae	retinal anjiyomatozis
angiomegaly	anjiyomegali
angiomyoma	anjiyomyom
angioneurosis	anjiyonöroz
angioneurotic edema	anjiyonörotik ödem
angioparalysis	anjiyoparalizi
angiopathy	anjiyopati
angiophakomatosis	anjiyofakomatoz
angioplast	anjiyoplast
angioplasty	anjiyoplasti
angiosarcoma	anjiyosarkom
angiospasm	anjiyospazm
angiostenosis	anjiyostenoz
angiotensin	anjiyotensin
angiotensin i	anjiyotensin ı
angiotensin ii	anjiyotensin ıı
angiotensinogen	anjiyotensinojen
angiotripsy	anjiyotripsi
angor	angor
angular	anguler
angulation	angulasyon
anhidrosis	anhidrozis
anhydrase	anhidraz
anhydride	anhidrit
anhydrous	anhidroz
anicteric	anikterik
aniline	anilin
anilism	anilin intoksikasyonu
animal phobia	hayvan fobisi
animal physiology	hayvan fizyolojisi
anion	anyon
aniridia	aniridi
anisochromatic	anizokromatik
anisocoria	anizokori
anisocytosis	anizositoz
anisometrope	anizometrop
anisometropia	anizometropi
anisometropic	anizometropik
anisophoria	anizofori
anisopia	anizopi
ankle	ayak bileği
ankylosed	ankiloze
ankylosing spondylitis	ankilozan spondilit
ankylosis	ankiloz
annular	annüler
annulus	annulus
anodal	anodal
anode	anot
anogenital	anogenital
anomalous	anomalili
anomaly	anomali
anoperineal	anoperineal
anophthalmia	anoftalmi
anopia	anopi
anoplasty	anoplasti
anopsia	anopsi
anorectal	anorektal
anorectal abscess	anorektal apse
anorectum	anorektum
anoretic	anoretik
anorexia	iştahsızlık
anorexia nervosa	anoreksiya nervoza
anorexigenic	anoreksijenik
anorthopia	anortopi
anoscope	anoskop
anosmia	anosmi
anovulation	anovülasyon
anovulatory	anovülatuar
anovulatory menstruation	anovulatuar menstrüasyon
anoxemia	anoksemi
anoxia	anoksi
anoxic	anoksik
ant	karınca
antacid	antasit
antagonism	antagonizm
antagonist	antagonist
antagonistic	antagonistik
antagonistic action	antagonist etki
ante partum	ante partum
antecedent	önceki
antegrade	antegrad
antenatal	antenatal
anterior	anterior
anterior chamber	ön kamara
anterograde	anterograd
anteroinferior	anteroinferior
anterointernal	anterointernal
anterolateral	anterolateral
anteroposterior	anteroposterior
anterosuperior	anterosuperior
anteversion	anteversiyon
anteverted uterus	antevert uterus
anthelmintic	antihelmintik
anthracosis	antrakoz
anthrax	şarbon
anthropobiology	antropobiyoloji
anthropoid pelvis	antropoid pelvis
anthropology	antropoloji
anthropometry	antropometri
anti infectious	antienfektif
anti infective	antienfektif
anti inflammatory	antiinflamatuar
antiagglutinin	antiaglutinin
antianaphylaxis	antianafilaksi
antibacterial	antibakteriyel
antibiotic	antibiyotik
antibody	antikor
antibrachium	önkol
anticatalyst	antikatalizör
anticholinergic	antikolinerjik
anticipate	um
anticipatory	beklenen
anticoagulant	antikoagülan
anticomplement	antikompleman
anticonception	kontrasepsiyon
anticonvulsant	antikonvülzan
anticonvulsive	antikonvülzif
antidepressant	antidepresan
antidiuretic	antidiüretik
antidotal	antidotik
antidote	antidot
antidromic	ters
antiemetic	antiemetik
antienzyme	antienzim
antiepileptic	antiepileptik
antifebrile	ateş düşürücü
antigen	antijen
antigen antibody complex	immün kompleks
antigen antibody reaction	antijen antikor reaksiyonu
antiglobulin	antiglobulin
antihemolysin	antihemolizin
antihemophilic	antihemofilik
antihemorrhagic	antihemorajik
antihistamine	antihistamin
antihistaminic	antihistaminik
antihormone	antihormon
antiketogen	antiketojen
antiketogenesis	antiketogenez
antilobium	tragus
antimalarial	antimalaryal
antimetabolite	antimetabolit
antimetropia	antimetropi
antimicrobic	antimikrobiyal
antimitotic	antimitotik
antimony	antimon
antimycotic	antimikotik
antimydriatic	antimidriyatik
antineoplastic	antineoplastik
antineuralgic	antinevraljik
antiotomy	antiotomi
antioxidant	antioksidan
antiparasitic	antiparazitik
antiperiodic	antiperiyodik
antiphagocytic	antifagositik
antiphlogistic	antiflojistik
antipsychotic	antipsikotik
antipuritic	antipuritik
antipyretic	antipiretik
antirheumatic	antiromatizmal
antisepsis	antisepsi
antiseptic	antiseptik
antiserum	antiserum
antisocial	antisosyal
antispasmodic	antispazmodik
antistreptococcal	antistreptokoksik
antitetanic	antitetanik
antithrombin	antitrombin
antitoxic	antitoksik
antitoxin	antitoksin
antitragus	antitragus
antitrismus	antitrismus
antituberculin	antitüberkülin
antituberculotic	antitüberküloz
antitussive	antitussif
antiviral	antiviral
antrectomy	antrektomi
antritis	antrit
antrocele	antrosel
antrostomy	antrostomi
antrotomy	antrotomi
antrotympanitis	antrotimpanit
antrum	antrum
anuclear	anükleer
anuria	anüri
anus	anüs
anxiety	anksiyete
anxiety state	anksiyete hali
anxious	anksiyöz
aorta	aort
aortic	aortik
aortic aneurysm	aort anevrizması
aortic arch	aort kavisi
aortic atresia	aortik atrezi
aortic regurgitation	aort yetersizliği
aortic stenosis	aort darlığı
aortitis	aortit
aortogram	aortogram
aortography	aortografi
aortopulmonary	aortopulmoner
aortotomy	aortotomi
apathetic	apatetik
apathism	apatizm
apathy	apati
apepsia	apepsi
aperient	laksatif
apertura	apertura
aperture	açıklık
apex	apeks
apex beat	apeks atımı
apgar score	apgar skoru
aphagia	afaji
aphakia	afaki
aphasia	afazi
aphonia	afoni
aphrodisiac	afrodizyak
aphtha	aft
aphthous	aftöz
aphthous stomatitis	aftöz stomatit
apical	apikal
apivorous	arıobur
aplasia	aplazi
aplastic	aplastik
aplastic anemia	aplastik anemi
apnea	apne
apneic	apneik
apneic period	apne atağı
apocrine	apokrin
apoenzyme	apoenzim
apolar	apolar
apomorphine	apomorfin
aponeurosis	aponevroz
apophysis	apofiz
apoplexy	apopleksi
apparatus	aygıt
appease	yatıştır
appendectomy	apandektomi
appendicitis	apandisit
appendicular abscess	apendiks apsesi
appendix	uzantı
appetizing	iştah açıcı
applanation	applanation
applaud	alkışla
applicator	aplikatör
apportion	paylaştırım
apposition	yaklaştırma
apraxia	apraksi
apyretic	apiretik
aqueduct	kanal
aqueous	sulu
arachnodactyly	araknodaktili
arachnoid	araknoid
arachnoidea	örümcek ailesi
arachnoiditis	araknoidit
arachnophobia	araknofobi
araphia	arafi
arbitrary	göreli
arbor	ağaç
arbor vitae	arbor vitae
arborization	arborizasyon
arbovirus	arbovirüs
arc	ark
arch	ark
arcuate	kavisli
arcus	ark
arcus aortae	arkus aorta
ardeidae	balıkçılgiller familyası
ardent	hararetli
ardous	güç
areflexia	arefleksi
areola	areola
argentaffinoma	argentafinoma
arginase	arginaz
arginine	arginin
argon	argon
arid	cansız
aromatic	aromatik
arrhenoblastoma	arenoblastom
arrhythmic	aritmik
arrhytmia	aritmi
arsenic	arsenik
artefact	artefakt
arter	arter
arterial	arteriyel
arterialize	kirli kanı temizle
arteriectomy	arteriyektomi
arteriocapillar	arteriyokapiller
arteriogram	arteriyogram
arteriography	arteriyografi
arteriolar	arteriyoler
arteriole	arteriyol
arteriolosclerosis	arteriyoloskleroz
arterioplasty	arteriyoplasti
arteriorrhagia	arteriyoraji
arteriorrhaphy	arteriyorafi
arteriosclerosis	arteriyoskleroz
arteriospasm	arteriyospazm
arteriostenosis	arteriyostenoz
arteriosus	arteriosus
arteriotomy	arteriyotomi
arteriovenous	arteriovenöz
arteriovenous anastomosis	arteriovenöz anastomoz
arteriovenous aneurysm	arteriovenöz anevrizma
arteritis	arterit
artery	arter
arthralgia	artralji
arthritis	artrit
arthrocele	artrosel
arthrodesis	artrodez
arthroedema	artroödem
arthrography	artrografi
arthrogryposis	artrogripozis
arthrolysis	artroliz
arthromeningitis	sinovit
arthrometer	artrometre
arthropathy	artropati
arthroplasty	artroplasti
arthropod	artropod
arthrosclerosis	artroskleroz
arthroscope	artroskop
arthroscopy	artroskopi
arthrosis	artroz
arthrostomy	artrostomi
arthrosynovitis	artrosinovit
arthrotomy	artrotomi
articular	eklemsel
articulate	ifade et
articulation	artikülasyon
artifact	artefakt
artificial	yapay
artificial abortion	istemli abortus
artificial eye	takma göz
artificial respiration	yapay solunum
artiodactyla	çift parlılar
arytenoid	aritenoid
arytenoidectomy	aritenoidektomi
arytenoiditis	aritenoidit
asbestos	asbest
asbestosis	asbestozis
ascariasis	askariyazis
ascaricide	askarisid
ascaris	askaris
ascaris lumbricoides	ascaris lumbricoides
ascites	asit
ascorbic acid	askorbik asit
ascribable	bağlanabilir
ascribe	atfet
asepsis	asepsi
aseptic	aseptik
asexual	aseksüel
asocial	asosyal
aspergilloma	aspergillom
aspergillosis	aspergillozis
aspergillus	aspergillus
aspermia	aspermi
asphyxia	asfiksi
asphyxia neonatorum	neonatal asfiksi
aspirate	aspire et
aspiration	aspirasyon
aspiration biopsy	aspirasyon biyopsisi
aspiration pneumonia	aspirasyon pnömonisi
aspirator	aspiratör
aspire	heveslen
aspirin	aspirin
asporogenic	sporsuz
asporous	sporsuz
assimilation	asimilasyon
astasia	astazi
asterion	asterion
asteroid	asteroid
asthenia	asteni
asthenic	astenik
asthenopia	astenopi
asthenopic	astenopik
asthma	astım
asthmatic	astmatik
astigmatic	astigmatik
astigmatism	astigmatizm
astigmatometer	astigmatometre
astragalus	talus
astragamectomy	astragamektomi
astraphobia	astrafobi
astringent	kanamayı durdururcu
astroblast	astroblast
astroblastoma	astroblastom
astrocyte	astrosit
astrocytoma	astrositom
astrology	astroloji
astyphia	astifi
asuage	hafifletme
asvd therapy	adriamysin, bleomycin, vinblastin ve decarbazin tedavisi
asymmetry	asimetri
asymptomatic	asemptomatik
asynclitism	asinklitizm
asynechia	asineşi
asynergy	asinerji
asystole	asistoli
atactic	ataksik
ataraxia	ataraksi
atavism	atavizm
ataxia	ataksi
ataxic	ataksik
ataxy	ataksi
atelectasia	atelektazi
atelectasis	atelektazi
atheroma	aterom
atheromatosis	ateromatozis
atheromatous	ateromatöz
atheromatous plaque	ateromatöz plak
atherosclerosis	ateroskleroz
athetoid	atetoid
athetosis	atetoz
atlantoaxial	atlantoaksial
atlas	atlas
atmosphere	atmosfer
atom	atom
atomizer	atomizer
atonic	atonik
atony	atoni
atopic	atopik
atopy	atopi
atremia	atremi
atresia	atrezi
atresia ani	anal atrezi
atresic	atrezik
atrial	atriyal
atrial septal defect	atrial septal defekt
atrioventricular	atriyoventriküler
atrium	atriyum
atrophic	atrofik
atrophy	atrofi
atropine	atropin
atropine sulfate	atropin sülfat
attack	v.saldır:n.kriz
attack rate	yayılma hızı
atypia	atipi
atypical	atipik
auburn	kumral
audible	işitilebilir
audiogram	odiogram
audiology	odioloji
audiometer	odiometre
audiometry	odiometri
audiovisual	odiovizüel
auditory	işitsel
auditory agnosia	işitsel agnozi
auditory apparatus	işitme organı
auerbach's plexus	auerbach pleksusu
aura	aura
aural	aural
auricle	aurikula
auricular	auriküler
auriculoventricular	aurioventriküler
aurotherapy	auroterapi
auscultation	oskültasyon
auscultatory	oskültatuar
autism	otizm
autistic	otistik
autoagglutination	otoaglutinasyon
autoagglutinin	otoaglutinin
autoanalysis	otoanaliz
autoantibody	otoantikor
autoantigen	otoantijen
autoclave	otoklav
autograft	otogreft
autoimmune	otoimmün
autoimmunity	otoimmünite
autoinfection	otoenfeksiyon
autoinoculation	otoinokülasyon
autokeratoplasty	otokeratoplasti
autolysis	otoliz
automasia	otomazi
automatic action	otomatik hareket
automaticity	otomatisite
autonomic	otonom
autonomic nervous system	otonom sinir sistemi
autonomy	otonomi
autoplasty	otoplasti
autopsy	otopsi
autosomal	otozomal
autosome	otozom
autotherapy	ototerapi
autotransfusion	ototransfüzyon
autotransplantation	ototransplantasyon
avascular	avasküler
aversion	aversiyon
aves	kuşlar
avirulent	avirulan
avitaminosis	avitaminoz
avoidance	kaçınma
axanthopsia	aksantopsi
axial	aksiyel
axilla	aksilla
axillary	aksiller
axillary abscess	aksiller apse
axipetal	aksipetal
axolotl	dağ göllerinde yaşayan balık türü
axon	sinir uyarılarının ileriye iletilmesi
azoic	azoik
azoospermia	azoospermi
azote	azot
azotemia	azotemi
azygos	azigos
babesiosis	babesiosis
babinski's phenomenon	babinski refleksi
babinski's reflex	babinski refleksi
babinski's sign	babinski belirtisi
bacillus	basil
bacillus anthracis	bacillus anthracis
bacitracin	basitrasin
back bone	omurga
backache	sırt ağrısı
backbone	omurga
backflow	geriakım
bacteremia	bakteremi
bacteri	bakteri
bacterial	bakteriyel
bacterial peritonitis	bakteriyel peritonit
bacterial plaque	bakteri plağı
bactericid	bakterisid
bacterid	bakterid
bacteriemia	bakteremi
bacteriform	bakteri şeklinde
bacteriogenic	bakteriyojen
bacterioid	bakterimsi
bacteriologic	bakteriyolojik
bacteriological	bakteriyolojik
bacteriologist	bakteriyolog
bacteriology	bakteriyoloji
bacteriolysis	bakteriyoliz
bacteriophage	bakteriyofaj
bacteriophagia	bakteriyofaji
bacteriophobia	bakteriyofobi
bacteriophytoma	bakteriyofitom
bacterioscopy	bakteriyoskopi
bacteriosis	bakteriyoz
bacteriostasis	bakteriyostaz
bacteriostatic	bakteriyostatik
bacteriotoxin	bakteriyotoksin
bacteritropin	batkeriyotropin
bacterium	bakteri
bacteriuria	bakteriüri
bacteroid	bakterimsi
bacteruria	bakteriüri
bagassosis	bagasozis
balanitis	balanit
balanoplasty	balanoplasti
balanoposthitis	balanopostit
balanorrhea	balanore
balantidiasis	balantidiyazis
balloon tip	balon ucu
balloon tipped	balon uçlu
ballotement	balotman
balneotherapy	banyo tedavisi
bandage	sargı
barbiturate	barbitürat
barbituric acid	barbitürik asit
barbiturism	barbitürat intoksikasyonu
baritosis	baritozis
barium	baryum
barium enema	baryum lavmanı
barium sulphate	baryum sülfat
barotrauma	barotravma
barr body	barr cisimciği
barrier	bariyer
bartholinitis	bartolinit
bartholin's abscess	bartholin apsesi
bartonellosis	bartonelloz
basal	bazal
basal metabolic rate	bazal metabolizma hızı
basal metabolism	bazal metabolizma
basement membrane	bazal membran
basilar	baziler
basiloma	baziloma
basin	pelvis
basiotribe	baziyotrib
basiotripsy	baziyotripsi
basis cranii	kranyum tabanı
basket cell	file hücre
basocytopenia	bazositopeni
basocytosis	bazositoz
basophil	bazofil
basophil adenoma	bazofil adenom
basophile	bazofil
basophilic	bazofilik
basophilism	bazositoz
bathmotropic	batmotrop
battered child syndrome	hırpalanmış çocuk sendromu
bcg	bcg
bed sore	dekübitus ülseri
bed wetting	enürezis
bedpan	sürgü
bee hive	arı kovanı
behavior	davranış
behaviour	davranış
bence jones albumin	bence jones proteini
bence jones protein	bence jones proteini
beneficial	yararlı
benefit	v.yararlan:n.yarar
benign	benign
benignancy	benignite
benzathine penicillin	benzatin penisilin
benzene	benzen
benzidine	benzidin
benzocaine	benzocaine
benzylpenicillin	penisilin g
bereavement	mahrumiyet
beriberi	beriberi
berylliosis	berilyoz
beryllium	berilyum
beta	beta
bezoar	bezoar
bezold's abscess	bezold apsesi
bicarbonate	bikarbonat
biceps	biseps
biconcave	bikonkav
biconvex	bikonveks
bicuspid	biküspid
bifid spine	spina bifida
bifurcation	bifurkasyon
bigeminy	bigemine
biguanide	biguanid
bilateral	iki yanlı
bile	safra
bile pigment	safra pigmenti
bilharziasis	şistozomiyazis
biliary	biliyer
biliary abscess	biliyer apse
biliary calculus	safra taşı
biliary cirrhosis	biliyer siroz
biliary colic	biliyer kolik
biliary pigment	safra pigmenti
bilingual	iki dilli
bilirubin	bilirubin
bilirubinemia	bilirubinemi
bilirubinuria	bilirubinüri
biliverdin	biliverdin
bimanual	bimanuel
bimanual palpation	bimanuel palpasyon
bimanual percussion	bimanuel perküsyon
binocular	binoküler
biochemistry	biyokimya
biologic	biyolojik
biological	biyolojik
biology	biyoloji
biometrics	biyometri
biometry	biyometri
biomicroscope	biyomikroskop
biomicroscopy	biyomikroskopi
bionecrosis	doku ölümü
biophysics	biyofizik
biopsy	biyopsi
biostatistics	biyoistatistik
biosynthesis	biyosentez
biotin	biyotin
bipolar	bipolar
birth	doğum
birth canal	doğum kanalı
birth control	doğum kontrolü
birth rate	doğum oranı
birthmark	doğum lekesi
bisexual	biseksüel
bismuth	bizmut
bitter	acı
bitterling	acı balık
bivalent	iki değerli
black lemur	akumba
black plague	kara veba
black rhinoceros	afrika gergedanı
blackhead	komedon
bladder stone	mesane taşı
blast	blast
blastocele	blastosel
blastocyst	blastosist
blastocyte	blastosit
blastocytoma	blastositom
blastoderm	blastoderm
blastoma	blastom
blastomere	blastomer
blastomycosis	blastomikoz
blastula	blastula
bleb	kabarcık
bleeder	hemofilili
bleeding	kanama
blepharectomy	blefarektomi
blepharism	blefarizm
blepharitis	blefarit
blepharoadenitis	blefaradenit
blind spot	kör nokta
blister	vezikül
bloat	abdominal distansiyon
bloating	abdominal distansiyon
block	blok
blockade	blokaj
blood	kan
blood agar	kanlı agar
blood brain barrier	kan beyin bariyeri
blood circulation	kan dolaşımı
blood dyscrasia	kan diskrazisi
blood exchange	kan değişimi
blood plasma	kan plazması
blood platelet	trombosit
blood pressure	kan basıncı
blood smear	kan yayması
blood stream	kan dolaşımı
body axis	vücut ekseni
boiling point	kaynama noktası
boll	fronkül
bone abscess	kemik apsesi
bone age	kemik yaşı
bone marrow	kemik iliği
bonesetter	çıkıkçı
borderline case	sınır vaka
bordetella pertussis	bordetella pertussis
botryoid	botriyoid
botulin	botulin
botulism	botulizm
bougie	buji
bouillon	etsuyu
bovidae	boynuzlugiller
bowel	barsak
bowleg	genu varum
bowman's capsule	bowman kapsülü
brachial	brakiyal
brachiocephalic	brakiyosefalik
brachion	kol
brachycephalic	brakisefalik
brachycephaly	brakisefali
bradyarrhytmia	bradiaritmi
bradycardia	bradikardi
bradycardic	bradikardik
bradykinin	bradikinin
bradypnea	bradipne
brain abscess	beyin apsesi
brain drain	beyin göçü
brain mantle	beyin korteksi
brain stem	beyin sapı
brainstem	beyinsapı
branch	dal
braxton hicks's sign	braxton hicks kontraksiyonları
breath sound	solunum sesi
breathe	solu
breech presentation	makat prezantasyonu
bregma	ön fontanel
brink	eşik
broad ligament abscess	ligamentum latum apsesi
broad spectrum antibiotic	geniş spektrumlu antibiyotik
brodie's abscess	brodie apsesi
bromide	bromür
bronchial	bronşiyal
bronchial allergy	bronşiyal allerji
bronchial asthma	bronşiyal astım
bronchiectasis	bronşektazi
bronchiole	bronşiyol
bronchiolitis	bronşiyolit
bronchitis	bronşit
bronchoalveolar	bronkoalveoler
bronchoconstriction	bronkokonstrüksiyon
bronchoconstrictor	bronkokonstrüktör
bronchodilatation	bronkodilatasyon
bronchodilator	bronkodilatör
bronchogram	bronkogram
bronchography	bronkografi
bronchopneumonia	bronkopnömoni
bronchopulmonary	bronkopulmoner
bronchoscope	bronkoskop
bronchoscopy	bronkoskopi
bronchus	bronş
broth	etsuyu
brow	alın
brucella	brusella
brucellosis	bruselloz
brunt	darbe
brutal	kaba
brute	kaba
brute force	kaba kuvvet
buccal	bukkal
buccal absorption	bukkal absorpsiyon
buccal smear	bukkal smear
buffer	tampon
buggery	anal seks
bulbus	bulbus
bulimia	bulimia
bulla	bül
bullous	büllöz
bundle of his	his hüzmesi
buphtalmia	buftalmi
buphtalmos	buftalmi
buphtalmus	buftalmi
bursa	bursa
bursectomy	bursektomi
bursitis	bursit
butyric acid	bütirik asit
bypass	bypass
byssinosis	bisinozis
cachectic	kaşektik
cachet	kaşe
cachexia	kaşeksi
cacosmia	kakosmi
cadaveric rigidity	ölü sertliği
caffeine	kafein
calamine	kalamin
calciferol	kalsiferol
calciferous	kalsiyumlu
calcific	kalsifiye
calcification	kalsifikasyon
calcium	kalsiyum
caliber	çap
calorie	kalori
calory	kalori
calvarium	kalvaryum
calyx	kaliks
canal	kanal
cancer	kanser
cancerogenic	kanserojen
candida albicans	candida albicans
candidiasis	kandidiyazis
cannula	kanül
canthus	kantus
capacity	kapasite
capillaries	kılcal damarlar
capillarity	kapilarite
capillary	kapiler
caprice	kapris
capsitis	kapsitis
capsula	kapsül
capsule	kapsül
capsulectomy	kapsülektomi
capsulotomy	kapsülotomi
caput medusae	kaput meduza
car sickness	taşıt tutması
carbohydrate	karbonhidrat
carbolyc acid	fenol
carbon	karbon
carbon dioxide	karbondioksit
carbon monoxide	karbonmonoksit
carbonic acid	karbonik asit
carbonic anhydrase	karbonik anhidraz
carboxyhemoglobin	karboksihemoglobin
carboxyhemoglobinemia	karboksihemoglobinemi
carboxylase	karboksilaz
carbuncle	karbunkül
carcinoembryonic antigen	karsinoembriyojenik antijen
carcinogen	karsinojen
carcinogenesis	karsinogenez
carcinoid	karsinoid
carcinoma	karsinoma
carcinoma in situ	karsinoma in situ
carcinomatosis	karsinomatozis
carcinosarkoma	karsinosarkom
cardia	kardia
cardiac	kardiyak
cardiac albuminuria	kardiyak albuminüri
cardiac aneurysm	kardiyak anevrizma
cardiac arrest	kardiyak arrest
cardiac arrhythmia	kardiyak aritmi
cardiac massage	kalp masajı
cardiac output	kalp debisi
cardiac souffle	kardiyak üfürüm
cardiac standstill	kardiyak arrest
cardiectomy	kardiyektomi
cardinal	kardinal
cardiocentesis	kardiyosentez
cardiogenic	kardiyojenik
cardiogram	kardiyogram
cardiography	kardiyografi
cardiologist	kardiyolog
cardiology	kardiyoloji
cardiomegaly	kardiyomegali
cardiomyopathy	kardiyomiyopati
cardioplegia	kardiyopleji
cardiopulmonary	kardiyopulmoner
cardiotomy	kardiyotomi
cardiotonic	kardiyotonik
cardiotoxic	kardiyotoksik
cardiovascular	kardiyovasküler
carditis	kardit
carina	karena
carmine	karmen
carotene	karoten
carotenemia	karotenemi
carotenoid	karotenoid
carotid	karotis
carotid angioraphy	karotid anjiyografi
carpal	karpal
carpometacarpal	karpometakarpal
carpopedal	karpopedal
carpopedal spasm	karpopedal spazm
carrier	taşıyıcı
cartilage	kıkırdak
caruncle	karunkül
casease	kazeaz
casein	kazein
caseous	kazeöz
caseous abscess	kazeöz apse
castrate	kısırlaştır
castrated	v.kısırlaştır:adj.kısırlaştırılmış
catabolism	katabolizma
catabolite	yıkım ürünü
catalase	katalaz
catalepsy	katalepsi
cataleptic	kataleptik
catalyse	katalize et
catalysis	kataliz
catalyst	katalizör
catalytic	katalitik
catalytic action	katalitik etki
catalytic agent	katalitik madde
catalyzator	katalizör
catalyzer	katalizör
cataphasia	katafazi
cataphrenia	katafreni
cataphylaxis	katafilaksi
cataplasia	kataplazi
cataplectic attack	kataplektik nöbet
cataplexy	katapleksi
cataract	katarakt
cataractogenic	katarakt yapıcı
cataractous	kataraktlı
catarrhal	akıntılı
catatonia	katatoni
catatonic	katatonik
catatony	katatoni
catecholamine	katekolamin
category	kategori
catgut	katgüt
catgut suture	katgüt
cathartidae	yeni dünya akbabası
catheter	kateter
catheterization	kateterizasyon
cathode	katod
cation	katyon
cauda	kauda
caudal	kaudal
caudal anesthesia	kaudal anestezi
causative	nedensel
cause	v.neden olma:n.neden
cause effect relationship	neden sonuç ilişkisi
caustic	kostik
cauterization	koterizasyon
cauterize	koterize et
cautery	koter
cautious	ihtiyatlı
cavernous	kavernöz
cavitation	kavitasyon
cavity	kavite
cebidae	maymunlar familyası
cecal	çekal
cecitis	çekitis
cecostomy	çekostomi
cecotomy	çekotomi
cecum	çekum
celery	süratli
celiac	çölyak
cell	hücre
cell body	hücre gövdesi
cell division	hücre bölünmesi
cellula	küçük oda
cellular	sellüler
cellulose	selüloz
celom	sölom
cement	sement
centigrade	santigrad
centigram	santigram
centiliter	santilitre
centimeter	santimetre
central	santral
central amaurosis	santral amoroz
central nervous system	santral sinir sistemi
centrifugal	sentrifügal
centrifuge	santrifüj
centriole	sentriol
centripetal	sentripetal
centromere	sentromer
centroplasm	sentroplazma
centrosome	sentrozom
cepaea hortensis	bahçe salyangozu
cephalalgia	baş ağrısı
cephalhematoma	sefalhematom
cephalic	sefalik
cephalin	sefalin
cephalocaudal	sefalokaudal
cephalocele	sefalosel
cephaloma	sefalom
cephalopelvic	sefalopelvik
cephalopoda	kafadan bacaklılar
cephalosporin	sefalosporin
ceptus	alma
ceratin	keratin
ceratitis	keratit
ceratodidae	boynuz dişligiller familyası
ceratodus	akciğerli barramunda
cerclage	serklaj
cerebellar	serebellar
cerebellitis	serebellitis
cerebellum	serebellum
cerebral	beyinsel
cerebral abscess	serebral apse
cerebral agraphia	serebral agrafi
cerebral allergy	serebral allerji
cerebral angiography	serebral anjiyografi
cerebral arteriosclerosis	serebral arteriyoskleroz
cerebral embolism	serebral embolizm
cerebral vascular accident	serebrovasküler olay
cerebroma	serebrom
cerebroside	serebrozid
cerebrospinal	serebrospinal
cerebrovascular	serebrovasküler
cerebrovascular accident	serebrovasküler olay
cerebrum	beyin
ceremonial	törensel
ceruloplasmin	seruloplazmin
cerumen	kulak kiri
cervical	servikal
cervical smear	servikal smear
cervicitis	servisit
cervicoplasty	servikoplasti
cervicovaginitis	servikovajinit
cervidae	geyikgiller familyası
cervix	serviks
cervix uteri	uterus serviksi
cervix vesicae	mesane boynu
cesarean	sezaryen
cesarean section	sezaryen ameliyatı
cestoda	tenya
cestodiasis	sestod enfeksiyonu
cetacea	balina
chalazion	şalazyon
chamber pot	lazımlık
chancre	şankr
chancroid	yumuşak şankr
channel	kanal
character	karakter
character analysis	karakter analizi
characteristic	karakteristik
characteristically	karakteristik olarak
charadriformes	yağmur kuşları
charbon	şarbon
charitableness	yardım severlik
cheir	el
chelate	şelat
cheloid	keloid
chemical	kimyasal
chemical action	kimyasal etki
chemoreceptor	kemoreseptör
chemosis	kemozis
chemosyntesis	kemosentez
chemotherapeutic	kemoterapötik
chemotherapy	kemoterapi
cheyne stokes respiration	cheyne stokes solunumu
chickenpox	suçiçeği
child abuse	çocuğa kötü muamele edilmesi
child abuse syndrome	hırpalanmış çocuk sendromu
child dose	çocuk dozu
child psychiatry	çocuk psikiyatrisi
child psychology	çocuk psikolojisi
childbearing	çocuk doğurma
childbirth	doğum
childhood	çocukluk çağı
chill	soğuk algınlığı nöbeti
chimerical	hayali
chin	çene
chirurgical	cerrahi
chlamydiae	klamidyalar
chloasma	kloazma
chloasma gravidarum	gebelik maskesi
chlorambucil	klorambusil
chloramphenicol	kloramfenikol
chlordiazepoxide	klordiazepoksid
chloride	klorür
chlorinate	klorla
chlorinated	v.klorla:adj.klorlu
chlorine	klor
chloroform	kloroform
chloroma	kloroma
chlorophyll	klorofil
chloroplast	kloroplast
chloroquine	klorokin
chlorpromazine	klorpromazin
chlorpropamide	klorpropamid
choana	koana
choanal atresia	koanal atrezi
cholagogue	kolagog
cholangeitis	kolanjit
cholangiectasis	kolanjiyektazi
cholangiocarcinoma	kolanjiyokarsinom
cholangiography	kolanjiyografi
cholecystectomy	kolesistektomi
cholecystitis	kolesistit
cholecystography	kolesistografi
cholecystokinin	kolesistokinin
cholecystolithiasis	kolesistolityazis
cholecystopathy	kolesistopati
choledochoduodenostomy	koledokoduodenostomi
choledocholithiasis	koledokolityazis
cholelithiasis	kolelityazis
cholepathy	kolepati
cholera	kolera
cholestasis	kolestaz
cholestatic	kolestatik
cholesteatoma	kolesteatom
cholesterin free	kolesterinsiz
cholesterol	kolesterol
cholic acid	kolik asit
choline	kolin
cholinergic	kolinerjik
cholinesterase	kolinesteraz
chondritis	kondrit
chondroblastoma	kondroblastom
chondrocyte	kondrosit
chondroitic acid	kondroitik asit
chondrosarcoma	kondrosarkom
chorda tendinea	korda tendinea
chorea	kore
choreic	koreik
choreic abasia	koreik abazia
choreiform	koreiform
choreoathetosis	koreoatetoz
chorioadenoma	koriyoadenom
chorioamnionitis	koriyoamniyonit
choriocarcinoma	koriyokarsinom
choriomeningitis	koryomenenjit
chorion	koryon
chorionic carcinoma	koryokarsinom
chorioretinitis	koryoretinit
choroid	koroidea
choroidal	koroidal
choroidea	koroidea
choroiditis	koroidit
chromaffin	kromafin
chromatic	kromatik
chromatid	kromatid
chromatin	kromatin
chromatopsia	kromatopsi
chromatosis	pigmentasyon
chromophil	kromofil
chromophobe	kromofob
chromophobe adenoma	kromofob adenom
chromophore	kromofor
chromosomal aberration	kromozom anomalisi
chromosome	kromozom
chromosome analysis	kromozom analizi
chronic	kronik
chronic abscess	kronik apse
chronic appendicitis	kronik apandisit
chronic hemorrhagic anemia	kronik hemorajik anemi
chronicity	kroniklik
chronologic age	kronolojik yaş
chronological	kronolojik
chronometer	kronometre
chvostek's sign	chvostek belirtisi
chylomicron	şilomikron
chymotrypsin	kemotripsin
cicada	ağustos böceği
cicatricial	sikatrisyel
cicatrix	sikatris
cicatrizant	sikatrizan
ciconiformes	leyleksiler
cilia	silia
ciliary	siliger
ciliary body	siliyer cisim
circular	sirküler
circulation	dolaşım
circulatory	sirkülatuar
circumference	çevre
circumflex	sirkumfleks
cirrhosis	siroz
cirrhotic	sirotik
cistern	sisterna
cisterna	sisterna
citrate	v.sitratla:n.sitrat
citrated	v.sitratla:adj.sitratlı
citrated plazma	sitratlı plazma
citric acid	sitrik asit
civet cat	afrika misk kedisi
clamp	klemp
clapotage	klapotaj
classification	sınıflama
claudication	klodikasyon
claustrophobia	klostrofobi
clavicle	klavikula
clavicular	klaviküler
cleft	yarık
cleft palate	yarık damak
climacteric	klimakterik
climacterium	klimakteryum
climate	iklim
climax	doruk
clinic	klinik
clinical	klinik
clinically	klinik olarak
clinician	klinisyen
clip	pens
clitoris	klitoris
cloaca	kloak
clomiphene	klomifen
clonic	klonik
clonus	klonus
clotting	pıhtılaşma
cloudy swelling	bulanık şişme
clump	küme
clumping	kümelenme
co trimoxazole	kotrimoksazol
coagulant	koagülan
coagulase	koagülaz
coagulation	koagülasyon
coagulopathy	koagülopati
coagulum	pıhtı
coalesce	birleş
coarctation	koarktasyon
coarctation of aorta	aort koarktasyonu
cobalt	kobalt
cocaine	kokain
coccidiomycosis	koksidiyomikoz
coccygeal	koksigeal
coccyx	koksiks
cochlea	koklea
cochlear	koklear
codeine	kodein
codex	kodeks
coeliac	çölyak
coelom	sölom
coenzyme	koenzim
coincidence	raslantı
coital	koital
coitus	koitus
cold	soğuk
cold abscess	soğuk apse
cold agglutinin	soğuk aglutinin
cold sore	herpes labialis
cold sweat	soğuk ter
colic	kolik
coliform	koliform
colitis	kolit
collagen	kollajen
collagenase	kollajenaz
collagenous	kollajenöz
collapse	kollaps
collar bone	klaviküla
collateral	kollateral
collateral circulation	kollateral dolaşım
collered flycatcher	ak ayaklı sinekkapan kuşu
collodion	kollodiyon
colloid	kolloid
colloidal	kolloidal
collum	kollum
collyrium	kolir
coloboma	kolobom
colon	kolon
colonization	kolonizasyon
colony	koloni
color blindness	renk körlüğü
colorimeter	kolorimetre
colorimetry	kolorimetri
colostomy	kolostomi
colostomy bag	kolostomi torbası
colostrum	kolostrum
colposcope	kolposkop
colposcopy	kolposkopi
columnar	kolumnar
coma	koma
comatose	komatoz
combination	bileşim
combine	birleştir
comedo	komedon
comissura	komissür
comissure	komissür
comissurotomy	komissürotomi
common bile duct	koledok kanalı
common cold	soğuk algınlığı
comparative anatomy	mukayeseli anatomi
compensation	kompansasyon
compensatory	kompansatuar
compensatory pause	kompansatuar pause
complement	kompleman
complete abortion	komplet abortus
complex	kompleks
complexity	karmaşıklık
complication	komplikasyon
component	bileşen
composition	bileşim
compound	bileşik
compressed air	sıkıştırılmış hava
comprise	içer
compulsive	kompülsif
compulsory	zorunlu
concave	konkav
concavity	konkavlık
concentration	konsantrasyon
concentration camp	temerküz kampı
concession	ödün
concha	konka
concomitant	eşlik eden
conditioned reflex	şartlı refleks
condom	prezervatif
conduction	iletim
condyloma	kondilom
condyloma acuminatum	kondiloma akuminata
cone	koni
confluent	birleşen
confusion	konfüzyon
congenital	konjenital
congenital achromia	albinizm
congenital analgesia	konjenital analjezi
congenital hemolytic anemia	konjenital hemolitik anemi
congested	konjesyone
congestion	konjesyon
conglomerate	küme
congo red	kongo kırmızısı
conization	konizasyon
conjugated	konjuge
conjugation	konjugasyon
conjunctiva	konjunktiva
conjunctival	konjunktival
conjunctivitis	konjunktivit
conscience	vicdan
conscious	bilinçli
consciously	bilinçli bir şekilde
consciousness	bilinçlilik
consensus	fikir birligi
conservative	konservatif
consolidation	birleşme
constipation	konstipasyon
constitutional symptom	genel semptom
constriction	konstriksiyon
constrictive	konstriktif
constrictive pericarditis	konstriktif perikardit
constrictor	konstriktör
constructive	konstrüktif
consultant	konsültan
consultation	konsültasyon
consulting physician	konsültan hekim
consumption coagulopathy	tüketim koagülopatisi
contact	v.temas et:n.temas
contact dermatitis	kontakt dermatit
contagious	bulaşıcı
contagious abortion	infeksiyöz abortus
contain	içer
container	kap
contamination	kirlilik
contiguous	bitişik
contiguous zone	bitişik bölge
continuous suture	kontinü sütür
contour	kontur
contractile	kontraktil
contraction	kontraksiyon
contracture	kontraktür
contraindication	kontrendikasyon
contralateral	kontralateral
contraseption	kontrasepsiyon
contraseptive	kontraseptif
contrast media	kontrast madde
contrast medium	kontrast madde
control animal	kontrol hayvanı
contusion	kontüzyon
convalescence	nekahat
convalescent	nekahat dönemindeki kişi
convergence	konverjans
convergent	konverjan
convergent strabismus	içe şaşılık
convex	konveks
convulsant	konvülzan
convulsion	konvülziyon
convulsive	konvülzif
cooley's anemia	talasemi
coprolalia	koprolali
cor pulmonale	kor pulmonale
coraciforme	gök kuzgunumsu
cord	kord
cornea	kornea
corneal	korneal
corneal reflex	kornea refleksi
coronary	koroner
coronary angiography	koroner anjiyografi
coronary arteriosclerosis	koroner arteriyoskleroz
coronary artery	koroner arter
coronary care	koroner bakım
corpus	korpus
corrective	ıslah edici
correlation	korelasyon
corrosive	korozif
corruptive	bozucu
cortex	korteks
cortical	kortikal
corticosteroid	kortikosteroid
corticosterone	kortikosteron
cortisol	kortizol
cortisone	kortizon
coryza	koriza
cosmetics	güzellik malzemeleri
costa	kosta
costal	kostal
costoclavicular	kostoklaviküler
costovertebral	kostovertebral
cotyledon	kotiledon
cough	v.öksür:n.öksürük
counselling	danışma
counterpulsation	kontrpulzasyon
couple	çift
courage	cesaret
course	gidişat
courtesy	nezaket
couveuse	kuvöz
coverglass	lamel
covert	örtülü
coxa	koksa
coxalgia	koksalji
coxarthrosis	koksartroz
cramp	kramp
craniography	kraniografi
craniotabes	kraniotabes
cranium	kranium
creatinase	kreatineaz
creatine	kreatin
creatinine	kreatinin
cremasteric reflex	kremaster refleksi
crepitant	krepitan
crepitant rale	krepitan ral
crepitation	krepitasyon
crescere	büyü
cresol	krezol
cretinism	kretinizm
cri du chat	cri du chat
cricoid	krikoid
cricoidectomy	krikoidektomi
cricotracheotomy	krikotrakeotomi
criminal abortion	kriminal abortus
criminology	kriminoloji
crisis	kriz
criterion	kriter
critical period of life	klimakteriyum
critical stage	klimakteriyum
critique age	klimakteryum
cross bred	melez
cross eye	şaşılık
cross eyed	şaşı
cross section	transeksiyon
crossed akinesia	çapraz akinezi
croup	krup
crucial	çok önemli
crust	kabuk
cryosurgery	kriyocerrahi
crypt	kript
cryptic	kriptik
cryptomenorrhea	kriptomenore
cryptorchidism	kriptorşizm
cryptorchism	kriptorşizm
crystal	kristal
crystalline penicillin g	kristalize penisilin
crystalloid	kristaloid
cubital	kübital
cuboid	küboid
cuff	manşet
cul de sac	cul de sac
culdocentesis	kuldosentez
culdoscope	kuldoskop
culdoscopy	kuldoskopi
culture medium	kültür ortamı
culture plate	kültür kabı
cumulative	kümülatif
cumulative action	birikim etkisi
curable	kürabl
curassow	ağaç tavuğu
curative	küratif
curettage	kürtaj
curette	küret
curvature	kurvatür
cutaneous	kütanöz
cutaneous absorption	deriden emilim
cutaneous anthrax	deri şarbonu
cutdown	cutdown
cyanocobalamin	siyanokobalamin
cyanosed	siyanoze
cyanosis	siyanoz
cyanotic	siyanotik
cycle	siklus
cyclic albuminuria	siklik albuminüri
cyclitis	siklitis
cyclophosphamide	siklofosfamid
cycloplegia	siklopleji
cyclothymia	siklotimi
cyclothymic personality	siklotimik kişilik
cypcelidae	saksağangiller familyası
cyst	kist
cystadenocarcinoma	kistadenokarsinom
cystadenoma	kistadenom
cystectomy	kistektomi
cystic	kistik
cysticercosis	sistiserkoz
cystine	sistin
cystinosis	sistinozis
cystinuria	sistinüri
cystocele	sistosel
cystoid	kistoid
cystoscope	sistoskop
cystoscopy	sistoskopi
cytogenetics	sitogenetik
cytologic	sitolojik
cytologic smear	sitolojik yayma
cytologist	sitolog
cytology	sitoloji
cytolysis	sitoliz
cytolytic	sitolitik
cytoplasm	sitoplazma
cytoplasmic	sitoplazmik
cytosine	sitozin
cytostatic	sitostatik
cytotoxic	sitotoksik
cytotoxin	sitotoksin
cytotrophoblast	sitotrofoblast
d=derlein's bacillus	döderlein basili
dacryoadenitis	dakriyoadenit
dacryocyst	dakriyosist
dacryocystitis	dakriyosistit
daily dose	günlük doz
daltonism	renk körlüğü
dandruff	kepek
dark adaptation	karanlığa uyum
day nursery	kreş
ddt poisoning	ddt zehirlenmesi
dead birth	ölü doğum
dead space	ölü boşluk
deaf	sağır
deafness	sağırlık
deaminase	deaminaz
deamination	deaminasyon
death rate	ölüm oranı
debridement	debridman
debris	debris
decay	çürü
decidua	desidua
decollement	dekolman
decompensation	dekompansasyon
decompression	dekompresyon
decongestant	dekonjestan
decongestion	dekonjesyon
decongestive	dekonjestan
decubitus	dekübitus
decubitus sore	dekübitus ülseri
deep transverse arrest	derinde transvers duruş
defecation	defekasyon
defect	defekt
defective	defektli
defence	savunma
defence reflex	savunma refleksi
defense mechanism	savunma mekanizması
defibrillation	defibrilasyon
defibrillator	defibrilatör
deficiency	eksiklik
deflection	defleksiyon
deformation	deformasyon
deformity	deformite
degeneration	dejenerasyon
degenerative	dejeneratif
degradation	yıkılma
dehydrated	dehidrate
dehydration	dehidratasyon
dehydrogenase	dehidrojenaz
déja vu	dejavü
delayed reaction	gecikmiş reaksiyon
delayed reflex	gecikmiş refleks
deleterious	zararlı
deletion	delesyon
deliberative	bilinçli
delicious	lezzetli
delirium	deliryum
delirium tremens	deliryum tremens
delivery room	doğum salonu
delphinapteridae	yüzgeçli yunus balığı ailesi
deltoid	deltoid
delusion	delüzyon
demarcation	demarkasyon
dementia	demans
demineralization	demineralizasyon
demonstrative	demonstratif
demyelinated	demiyelinize
demyelination	demiyelinizasyon
denaturation	denatürasyon
denatured	denatüre
dendrite	dendrit
dendrobate	ağaçcıl kurbağa
denervasyon	denervasyon
denomination	ölçü
densitometer	dansitometre
density	yoğunluk
dental	dental
dental abscess	diş apsesi
dental age	diş yaşı
dental alveolus	dental alveol
dental anatomy	dental anatomi
dental plate	diş plağı
dentine	dentin
dentist	diş hekimi
deontology	deontoloji
deoxycorticosterone	deoksikortikosteron
deoxygenation	deoksijenasyon
deoxyribonucleic acid	deoksiribonükleik asit
deoxyribose	deoksiriboz
dependent	bağımlı
depigmentation	depigmentasyon
depigmented	depigmente
depletion	boşalma
depolarization	depolarizasyon
deposit	birikinti
depot preparation	depo preparat
depressant	depresan
depressed	deprese
depresyon	depresyon
deprivation	yoksunluk
derangement	düzensizlik
derivation	derivasyon
derivative	türev
derma	deri
dermabrasion	dermabrazyon
dermal	dermal
dermat	deri
dermatitis	dermatit
dermatologist	dermatolog
dermatology	dermatoloji
dermatomyositis	dermatomiyozit
dermatophyte	dermatofit
dermatosis	dermatoz
dermis	dermis
dermoid	dermoid
desaturated	desatüre
desaturation	desatürasyon
descending	desendan
descriptive anatomy	deskriptif anatomi
desensitization	desensitizasyon
desensitize	desensitize et
desensitized	v.desensitize et:adj.desensitize
desiccant	kurutucu
desmoid	dezmoid
desquamation	deskuamasyon
destruction	destrüksiyon
destructive	destrüktif
detachment	dekolman
deteriorate	kötüleştirme
deterioration	kötüleşme
detestable	tiksindirici
detoxication	detoksikasyon
detoxification	detoksifikasyon
detrimental	zararlı
detrusor	detrusor
devastation	bozukluk
development	gelişme
developmental	gelişimsel
developmental age	gelişimsel yaş
developmental stage	gelişme devresi
deviation	deviasyon
devilfish	ahtapot
devise	geliştir
dextran	dekstran
dextrocardia	dekstrokardi
dextrose	dekstroz
dextroversion	sağa döndürme
diabetes	diabet
diabetes insipidus	diabetes insipidus
diabetes mellitus	diabetes mellitus
diabetic	diabetik
diabetic acidosis	diabetik asidoz
diabetic amaurosis	diabetik amoroz
diacetic acid	asetoasetik asit
diagnose	teşhis et
diagnosis	teşhis
diagnostic	tanısal
dialectic	diyalektik
dialysate	diyalizat
dialyse	diyaliz yap
dialysis	diyaliz
diapedesis	diyapedez
diaper rash	diaper dermatit
diaphoresis	terleme
diaphragm	diyafram
diaphragma	diyafragma
diaphragmatic	diyafragmatik
diaphysis	diyafiz
diarrhea	diyare
diarrheal	diyareik
diastase	diastaz
diastole	diyastol
diastolic	diyastolik
diastolic pressure	diastolik basınç
diathermy	diyatermi
diathesis	diyatez
dicoumarin	dikumarin
dicoumarol	dikumarin
dicrotic	dikrotik
dicrotism	dikrotizm
dicumarin	dikumarin
dicumarol	dikumarin
diearrhea	ishal
diencephalon	diensefalon
diet	diyet
diethylstilbestrol	dietilstilbestrol
dietician	diyetisyen
difference	farklılık
differential diagnosis	ayırıcı tanı
differentiation	ayırım
diffuse	dağıl
diffuse abscess	yaygın apse
diffusion	diffüzyon
digestive	dijestif
digital	dijital
digitalis	dijital
digitalization	dijitalizasyon
digitoksin	dijitoksin
diktyoma	kötücül melonoma
dilatation	dilatasyon
dilatator	dilatör
dilate	genişlet
dilator	dilatör
dilute	dilüe et
diluted	v.dilüe et:adj.dilüe
dilution	dilüsyon
dimercaprol	dimerkaprol
diminute	azalt
diminution	azalma
dimple	gamze
diopter	dioptri
dioptre	dioptri
diphteria	difteri
diphteroid	difteroid
diplegia	dipleji
diplococcus	diplokok
diploid	diploid
diploidy	diploidi
diplopia	diplopi
dipneumona	çift akciğerliler
dipnoi	akciğerli balıklar
dipsomania	dipsomani
dipsomaniac	dipsomanik
dipyridamole	dipiridamol
direct bilirubin	direkt bilirubin
directly	direkt olarak
discharge	akıntı
discoid	diskoid
discomfort	rahatsızlık
discrepancy	zıtlık
discus	disk
disease	hastalık
diseased	hastalıklı
disequilibrium	eşitsizlik
disfunction	disfonksiyon
disfunctional	disfonksiyonel
disgusting	tiksindirici
dishearten	hevesini kır
disinfect	dezenfekte et
disinfecting agent	dezenfektan
disinfection	dezenfeksiyon
disk	disk
dislocation	çıkık
disorder	bozukluk
disorganization	dezorganizasyon
disorientation	dezoryantasyon
disparity	disparite
dispensary	dispanser
disperse	dağıt
dispersion	dispersiyon
displacement	yer değiştirme
disposable syringe	dispozabl enjektör
disproportion	orantısızlık
disruption	yarılma
dissatisfaction	doyumsuzluk
dissect	ayır
dissection	diseksiyon
disseminated	yaygın
dissociation	şaşkınlık
dissolvent	çözücü
distal	distal
distention	distansiyon
distillation	damıtma
distortion	distorsiyon
distress	sıkıntı
disturbance	bozukluk
diuresis	diürez
diuretic	diüretik
diurnal	diurnal
divergence	diverjans
divergent	diverjan
divergent strabismus	dışa şaşılık
diverticulitis	divertikülit
diverticulosis	divertikülozis
diverticulum	divertikül
divided dose	bölünmüş doz
dizygotic	dizigotik
dizziness	baş dönmesi
dizzy	sersem
dizzying	başdöndürücü
doca	doca
doctrine	öğreti
dolichocephalic	dolikosefal
dolichocephaly	dolikosefali
dominant	dominant
donor	donör
dopa	dopa
dopamine	dopamin
dorsal	dorsal
dorsiflexion	dorsofleksiyon
dosage	dozaj
dose	doz
dot	benek
double contrast radiography	çift kontrast radyografi
douche	duş
drain	v.drene et:n.dren
drainage	drenaj
dramatical	dramatik
dramatically	dramatik olarak
drastic	şiddetli
drawback	eksiklik
dread	v.kork:n.korku
dream analysis	rüya yorumu
drepanididae	elbise kuşugiller familyası
dried human plasma	kuru plazma
droplet	damlacık
dropper	damlalık
drowned	boğulmuş
drowsiness	uyuşukluk
drowsy	uyuşuk
drug	ilaç
drug addiction	ilaç alışkanlığı
drug allergy	ilaç allerjisi
drum	timpan zarı
drunkenness	sarhoşluk
drusen	drusen
dry beriberi	kuru beriberi
dry rale	kuru ral
dryness	kuruluk
dubois's abscess	dubois apsesi
duct	kanal
ductus	duktus
ductus arteriosus	duktus arteriyozus
ductus choledochus	koledok kanalı
ductus venosus	duktus venozus
dullness	matite
duodenal	duodenal
duodenectomy	duodenektomi
duodenitis	duodenit
duodenoenterostomy	duodenoenterostomi
duodenography	duodenografi
duodenostomy	duodenostomi
duodenotomy	duodenotomi
duodenum	duodenum
dura mater	dura mater
dwarf	cüce
dwarfism	cücelik
dysacousia	disakuzi
dysarthria	dizartri
dyschromatopsia	diskromatopsi
dyscrasia	diskrazi
dysentery	dizanteri
dysgenesis	disgenezi
dyshidrosis	dishidrozis
dyskinesia	diskinezi
dyslexia	disleksi
dysmenorrhea	dismenore
dysmorphic	dismorfik
dysmorphism	dismorfizm
dysostosis	disostoz
dyspareunia	disparöni
dyspepsia	dispepsi
dysphagia	disfaji
dysphasia	disfazi
dysphonia	disfoni
dysplasia	displazi
dyspnea	dispne
dyspneic	dispneik
dysrhythmia	disritmi
dysrhythmic	disritmik
dysthymia	distimi
dystocia	distosi
dystonia	distoni
dystonic	distonik
dystrophia	distrofi
dystrophy	distrofi
dysuria	dizüri
dysuric	dizürik
ear	kulak
ear drops	kulak damlası
ear trumpet	kulak borusu
earache	kulak ağrısı
eardrum	timpan zarı
early abortion	erken düşük
earth eating	pika
earthropoda	gerçek eklem bacaklılar
ecarteur	ekartör
eccentric	eksantrik
ecchymosis	ekimoz
ecchymotic	ekimotik
eccrine	ekrin
echocardiogram	ekokardiyogram
echocardiographic	ekokardiyografik
echocardiography	ekokardiyografi
echoencephalogram	ekoensefalogram
echoencephalography	ekoensefalografi
echography	ekografi
echolalia	ekolali
echopraxia	ekopraksi
eclampsia	eklampsi
eclamptic	eklamptik
ecmnesia	ekmnezi
ecology	ekoloji
ecomania	ekomani
ecoparasite	ekoparazit
ecosystem	ekosistem
ectasia	ektazi
ecthyma	ektima
ectoderm	ektoderm
ectodermal	ektodermal
ectodermic	ektodermik
ectopia	ektopi
ectopic	ektopik
ectoplasm	ektoplazma
ectopy	ektopi
ectropion	ektropiyon
eczema	ekzema
eczematoid	ekzematoid
eczematous	ekzematöz
edema	ödem
edematous	ödemli
edible	yenebilir
effacement	efasman
effective	efektif
effectiveness	etkililik
efferent	efferent
effervescent	efervesan
efficacy	efikasite
effluent	akıntı
efflux	akma
effluxion	akıntı
effusion	efüzyon
ego	ego
egocentric	egosentrik
egoism	egoizm
egoist	egoist
ejakulate	fırlat
ejakulatio	ejakülasyon
ejakulation	ejakülasyon
ejakulatory	ejakülatuar
ejection	ejeksiyon
elastic	elastik
elastic stocking	elastik çorap
elastin	elastin
elbow	dirsek
elective	elektif
electricity	elektrik
electrocardiogram	elektrokardiyogram
electrocardiograph	elektrokardiyograf
electrocardiography	elektrokardiyografi
electrocauterization	elektrokoterizasyon
electrocautery	elektrokoter
electrocoagulation	elektrokoagülasyon
electrocoagulator	elektrokoagülatör
electrode	elektrod
electroencephalogram	elektroensefalogram
electroencephalograph	elektroensefalograf
electroencephalography	elektroensefalografi
electrolysis	elektroliz
electrolyte	elektrolit
electromyography	elektromiyografi
electron	elektron
electrophoresis	elektroforez
electrophysiologic	elektrofizyolojik
electrophysiology	elektrofizyoloji
electroshock	elektroşok
elephantiasis	elefantiyazis
elevator	elevatör
elimination	eliminasyon
elisa	elısa
elixir	iksir
eliza	elıza
elongation	elongasyon
embolectomy	embolektomi
embolic	embolik
embolic abscess	embolik apse
emboliform	emboliform
embolism	embolizm
embolization	embolizasyon
embolus	embolüs
embrace reflex	moro refleksi
embryo	embriyo
embryology	embriyoloji
embryonal	embriyonel
embryonic	embriyonik
embryopathy	embriyopati
embryotomy	embriyotomi
emerge	çık
emergency	acil durum
emesis	kusma
emetic	kusturucu
emetine	emetin
eminence	tümsek
eminent	seçkin
emmetropia	emmetropi
emotional	duygusal
emotional amenorrhea	emosyonel amenore
empathy	empati
emphysema	amfizem
empiric	ampirik
empyema	ampiyem
emulsion	emülsiyon
enamel	mine
enarthrosis	enartroz
encapsulated	kapsüllü
encapsulation	kapsüllenme
encephalitis	ensefalit
encephalogram	ensefalogram
encephalography	ensefalografi
encephalomeningitis	ensefalomenenjit
encephalomeningocele	ensefalomeningosel
encephalomyelitis	ensefalomiyelit
encephalomyelopathy	ensefalomiyelopati
encephalopathy	ensefalopati
encircle	kuşat
encopresis	enkoprezis
encysted	kapsüllü
encysted abscess	kapsüllü apse
end organ	uç organ
end plate	son plak
end product	son ürün
endarterectomy	endarterektomi
endarteritis	endarterit
endemic	endemik
endoaneurismorraphy	endoanevrizmorafi
endocarditis	endokardit
endocardium	endokard
endocervical	endoservikal
endocervicitis	endoservisit
endocervix	endoserviks
endocranium	dura mater
endocrine	endokrin
endocrinology	endokrinoloji
endocrinopathy	endokrinopati
endoderm	endoderm
endodontics	endodonti
endodontist	endodontist
endogenic	endojen
endogenous	endojen
endometrial	endometriyal
endometrioma	endometriyom
endometriosis	endometriyozis
endometritis	endometrit
endometrium	endometriyum
endomitosis	endomitoz
endoneurium	endonöriyum
endoparasite	endoparazit
endopelvic	pelvis içi
endopericarditis	endoperikardit
endophlebitis	endoflebit
endophtalmitis	endoftalmit
endophyte	endofit
endoplasm	endoplazma
endorser	ciranta
endoscope	endoskop
endoscopy	endoskopi
endospor	endospor
endosteum	endosteum
endostoma	endostom
endothelial	endotelyal
endothelioma	endotelyoma
endothelium	endotel
endothermal	endotermik
endothermy	endotermi
endotoxin	endotoksin
endotracheal	endotrakeal
endurance	dayanıklılık
enema	lavman
engagement	angajman
engorgement	konjesyon
enlargement	büyüme
enophtalmos	enoftalmi
enophtalmus	enoftalmi
enteral absorption	intestinal absorpsiyon
enteric	enterik
enteritis	enterit
enterobiasis	enterobiyazis
enterocele	enterosel
enterococcus	enterokok
enterocolitis	enterokolit
enterogastritis	enterogastrit
enterokinase	enterokinaz
enthusiastic	meraklı
entire	bütün
entirely	tamamen
entitle	hak kazandır
entity	antite
entomology	entomoloji
entoptic	entoptik
entropion	entropiyon
enuresis	enürezis
enuresis nocturna	enürezis nokturna
environment	çevre
environmental	çevresel
enzymatic	enzimatik
enzyme	enzim
eosin	eozin
eosinophil	eozinofil
eosinophilia	eozinofili
eosinophilic	eozinofilik
ependyma	epandim
ependymitis	epandimit
ependymoma	epandimom
ephedrine	efedrin
epicanthus	epikantus
epicardia	epikard
epicardial	epikardiyal
epicardium	epikard
epicondyle	epikondil
epicurean	epikürcü
epidemic	epidemi
epidemical	epidemik
epidemiology	epidemiyoloji
epidermal	epidermal
epidermic	epidermal
epidermis	epiderm
epidermoid	epidermoid
epididymis	epididim
epididymitis	epididimit
epidural	epidural
epidural anesthesia	epidural anestezi
epigastric	epigastrik
epigastric region	epigastriyum
epigastrium	epigastrium
epiglottis	epiglot
epiglottitis	epiglotit
epilation	epilasyon
epilepsia	epilepsi
epilepsy	epilepsi
epileptic	epileptik
epileptic attack	epilepsi nöbeti
epileptiform	epileptiform
epinephrine	adrenalin
epineurium	epinöriyum
epiphora	epifora
epiphysis	epifiz
epiploon	omentum
episclera	episklera
episcleral	episkleral
episcleritis	episklerit
episiotomy	epizyotomi
episodic	epizodik
epispadias	epispadias
epistaxis	epistaksis
epithelial	epitelyal
epithelialization	epitelizasyon
epithelioid	epiteloid
epithelioma	epitelyoma
epithelium	epitel
epithelization	epitelizasyon
epitrochlea	epitroklea
epitrochlear	epitroklear
epulis	epulis
equality	eşitlik
equilibrium	denge
equinocavus	ekinokavus
equinovarus	ekinovarus
equivalence	eşdeğerlik
equivalent	eşdeğer
eradicate	kökünü kazı
eradication	eradikasyon
erect	kaldır
erect position	ayakta dik duruş pozisyonu
erect sitting position	dik oturuş pozisyonu
erectile	erektil
erection	ereksiyon
erg	erg
ergot	ergo
ergotamine	ergotamin
erne	ak kuyruklu kartal
erosion	erozyon
erosive	erozif
erotic	erotik
erotism	erotizm
erotomania	erotomani
erratic	kararsız
error	hata
eruption	erupsiyon
erysipelas	erizipel
erysipeloid	erizipeloid
erythema	eritem
erythema infectiosum	beşinci hastalık
erythema marginatum	eritema marginatum
erythema nodosum	eritema nodozum
erythematous	eritamatöz
erythremia	eritremi
erythroblast	eritroblast
erythroblastosis fetalis	eritroblastozis fetalis
erythrocyte	eritrosit
erythrocyte sedimentation rate	sedimentasyon
erythrocytosis	eritrositoz
erythroid	akyuvar
erythromelalgia	eritromelalji
erythromycin	eritromisin
erythropenia	eritropeni
erythropoiesis	eritropoiez
erythropoietic	eritropoietik
erythropoietin	eritropoietin
esbach's albuminometer	esbach albuminometresi
escalate	tırmandır
esophageal	özofajiyal
esophagitis	özofajit
esophagocele	özofagosel
esophagoduodenostomy	özofagoduodenostomi
esophagoenterostomy	özofagoenterostomi
esophagogastroplasty	özofagogastroplasti
esophagogastrostomy	özofagogastrostomi
esophagography	özofagografi
esophagojejunostomy	özofagojejunostomi
esophagoscope	özofagoskop
esophagoscopy	özofagoskopi
esophagostomy	özofagostomi
esophagotomy	özofagotomi
esophagus	özofagus
esophoria	ezofori
esotropia	ezotropi
essential albuminuria	esansiyel albuminüri
essential amino acid	esansiyel aminoasit
essential anemia	idiopatik anemi
ester	ester
esterase	esteraz
esterification	esterleşme
esterolysis	esteroliz
estradiol	estradiol
estriol	estriol
estrogen	östrojen
estrone	estron
ethambutol	etambutol
ethanol	etil alkol
ether	eter
ethics	etik
ethmoid	etmoid
ethnic	etnik
ethyl	etil
ethyl alcohol	etil alkol
ethylene	etilen
etiologic	etyolojik
etiology	etiyoloji
euphoria	öfori
euphoric	öforik
eustachium	östaki borusu
euthanasia	ötanazi
evacuate	boşalt
evacuation	boşaltma
evaporation	buharlaşma
evidence	kanıt
evisceration	eviserasyon
ewing's sarkoma	ewing sarkomu
exacerbate	alevlen
exacerbation	alevlenme
exaggerate	abart
examination	muayene
exanthem	ekzantem
excentric	eksantrik
excipient	eksipiyan
excision	eksizyon
excitability	uyarılabilirlik
excitable	uyarılabilir
excitation	eksitasyon
excrement	atık
excrete	boşalt
excretion	boşaltım
excretory	ekskretuar
exertional angina	efor anginası
exertional dyspnea	efor dispnesi
exfoliative	eksfolyatif
exitus	ölüm
exocrine	ekzokrin
exogenic	ekzojen
exogenous	ekzojen
exomphalos	omfalosel
exophtalmia	ekzoftalmi
exophtalmic	ekzoftalmik
exophtalmos	ekzoftalmi
exophtalmus	ekzoftalmi
exostosis	ekzostoz
exothermal	ekzotermik
exotoxin	ekzotoksin
exotropia	ekzotropi
expansion	genişleme
expectant mother	gebe kadın
expectorant	ekspektoran
expectoration	ekspektorasyon
experimental	deneysel
experimental animal	deney hayvanı
expirasyon	ekspirasyon
expiratory	ekspiratuar
expire	nefes ver
expired	v.nefes ver:adj.ekspire edilen
explore	araştır
exsudate	eksüda
exsudative	eksüdatif
extension	ekstansiyon
extensor	ekstansör
external	eksternal
external ear	dış kulak
external rotation	eksternal rotasyon
extirpate	ekstirpe et
extirpation	ekstirpasyon
extraarticular	eklem dışı
extracapsular	ekstrakapsüler
extracellular	ekstrasellüler
extracorporeal	ekstrakorporeal
extraction	ekstraksiyon
extrahepatic	ekstrahepatik
extraocular	göz dışı
extrasystole	ekstrasistol
extravasation	ekstravazasyon
extraverted personality	ekstrovert kişilik
extremistic	müfrit
extremity	ekstremite
extrinsic	ekstrensek
extrisinc	ekstrensik
extroversion	ekstroversiyon
extrovert	ekstrovert
eye drop	göz damlası
eye socket	göz çukuru
eyeball	göz küresi
eyebrow	kaş
eyed hawk moth	akşam tavus kelebeği
eyelash	kirpik
eyelid	göz kapağı
facultative aerobe	fakültatif aerob
facultative anaerobe	fakültatif anaerob
falconidae	kartalgiller familyası
falconiformes	kartallar
fallow deer	alageyik
false pelvis	büyük pelvis
false positive reaction	yalancı pozitif reaksiyon
familial amyloidosis	familyal amiloidoz
familial corneal dystrophy	familyal korneal distrofi
familiar with	aşina
familiarity	aşinalık
family	aile
family pedigree	aile ağacı
family planning	aile planlaması
fanconi's anemia	fanconi anemisi
fat	yağ
fat embolism	yağ embolisi
fatal	öldürücü
fate	kader
fatigued	yorgun
fatty acid	yağ asidi
fatty atrophy	yağlı atrofi
fatty degeneration	yağlı dejenerasyon
faucial reflex	öğürme refleksi
favorable	olumlu
feeder	besleyici
feeling	duygu
femoral angiography	femoral anjiyografi
ferment	maya
fertile	verimli
fertility	verimlilik
fetal circulation	fetal dolaşım
fever	vücut ısısı
fibrous adenoma	fibröz adenom
first aid	ilk yardım
fixation point	tespit noktası
flail chest	yelken göğüs
flash point	yanma noktası
flat footed	düztaban
flat pelvis	platipelloid pelvis
flatten	yassılaş
flatter	pohpohla
flexion	burkulma
foley catheter	foley sondası
folic acid	folik asit
folinic acid	folinik asit
follicular angina	foliküler anjin
food allergy	gıda allerjisi
food poisoning	besin zehirlenmesi
footling presentation	ayak prezantasyonu
forensic psychiatry	adli psikiyatri
form	v.oluştur:n.şekil
formal	biçimsel
formation	oluşum
former	önceki
formulation	formulasyon
foster child	evlatlık
fraction	fraksiyon
fracture	kırık
fragmented	parçalanmış
frankly	samimi
fraternity	kardeşlik
freezing point	donma noktası
frequency	frekans
frequently	sıkça
friction rub	sürtünme sesi
friction sound	sürtünme sesi
frontal section	frontal kesit
frozen section	frozen section
furry	paslı
furry tongue	paslı dil
gag reflex	öğürme refleksi
gall bladder	safra kesesi
gallbladder stone	safra kesesi taşı
gallop rhythm	galo ritmi
ganglion blocking agent	gangliyon bloke edici ilaç
gangrenous	kangren
gap	uçurum
gastric	mideyle ilgili
gastric analysis	mide özsuyu analizi
gastric atony	mide atonisi
gastritis	gastrit
gastroesophageal regurgitation	gastroözofajiyal regurjitasyon
gastrointestinal	gastrointestinal
gastropoda	karından ayaklılar
gene pair	gen çifti
general anesthesia	genel anestezi
general anesthetic	genel anestezik
general symptom	genel semptom
genetic carrier	gen taşıyıcı
genetic counselling	genetik danışma
genetic engineering	genetik mühendisliği
genius	dahi
genocide	soykırım
gentian violet stain	jansiyen moru
genupectoral position	diz göğüs pozisyonu
german measles	kızamıkçık
gerontocratic	yaşlı yönetiminde
gestation period	gestasyonel dönem
giemsa's stain	giemsa boyası
give#birth	doğur
glaucus	kemikli balık türü
glisson's capsule	glisson kapsülü
globular anemia	oligositemi
glucose agar	glukozlu agar
glue ear	sekretuar otitis media
glycuronic acid	glikuronat
golgi's apparatus	golgi cisimciği
gonadal agenesis	gonadal agenezi
gonadal aplasia	gonadal aplazi
gram's stain	gram boyası
grave	mezar
gray substance	gri cevher
great white heron	ak balıkçıl
greater omentum	omentum majus
greatness	büyüklük
grievance	sıkıntı
gritti stokes amputation	gritti stokes amputasyonu
gross anatomy	makroskopik anatomi
guinea pig	kobay
gynecoid pelvis	jinekoid pelvis
gyps fulveus	kızıl akbaba
habit	alışkanlık
habit spasm	tik
habitual abortion	habitüel abortus
hair	saç
hair splitting	kılı kırk yaran
hamper	engelle
hapatic	hepatik
hard chancre	sert şankr
harsh	sert
harshness	sertlik
hasty	aceleci
hazardous	zararlı
health	sağlık
healthy	sağlıklı
heart	kalp
heart block	kalp bloğu
heart rate	kalp hızı
heart sound	kalp sesi
heat	v.ısıt:n.ısı
heat stroke	sıcak çarpması
heavy metal poisoning	ağır metal zehirlenmesi
heavy proteinuria	masif proteinüri
heliozoa	güneş hayvancıkları
helix pomatica	bağ salyangozu
hemlock	baldıran
hemlock poison	baldıran zehiri
hemodynamic	hemodinamik
hemolytic anemia	hemolitik anemi
hemorrhagic diathesis	kanama diyatezi
hemorrhagic familial angiomatosis	hemorajik familyal anjiyomatozis
hereditary spherocytosis	herediter sferositoz
hippuric acid	hipürik asit
his bundle	his hüzmesi
histologic accommodation	hücrelerin şeklinde olan değişiklik
hoarse	kısık sesli
homogentisic acid	homogentisik asit
homoptera	eş kanatlılar
honest	dürüst
honesty	dürüstlük
honor	onur
hopeless	umutsuz
horde	sürü
hormon assay	hormon tahlili
hormone	hormon
horse	at
hospital	hastane
hospital staff	hastane personeli
hospitalize	hastaneye yatır
hot	sıcak
hourglass stomach	kum saati mide
household remedy	halk ilacı
hucho hucho	tuna som balığı
human anatomy	insan anatomisi
human physiology	insan fizyolojisi
humanitarian	insancıl
humanities	beşeri bilimler
hunger	açlık
hurt	incit
husky	kısık
hyaluronic acid	hyaluronik asit
hydrochloric acid	hidroklorik asit
hydrogen acceptor	hidrojen alıcı
hydrogen peroxide	hidrojen peroksid
hylobatidae	uzunkollu maymunlar familyası
hyperacanthosis	epidermisin hücre katının kalınlığının artması
hyperchromic anemia	hiperkrom anemi
hypertensive arteriosclerosis	hipertansif arteriyoskleroz
hypochondriac region	hipokondriyum
hypochromic anemia	hipokrom anemi
hypodermic syringe	hipodermik enjektör
hypogastric region	hipogastriyum
hypoglycemia	kan şekeri düşüklüğü
hystricomorpha	oklu kirpimsiler
ice bag	buz torbası
identification	belirleme
idiopathic abscess	idiopatik apse
idiopathic anemia	idiopatik anemi
idiopathic thrombocytopenic purpura	idiopatik trombositopenik purpura
ignorance	cehalet
illegitimate	gayrimeşru
illiterate	okur yazar olmayan
illness	hastalık
imagination	hayal
immune body	antikor
immunologic	immünolojik
imperforate anus	imperforate anüs
inaccessible	erişilemez
inaccurately	yanlış olarak
inadequate	yetersiz
inadvisable	tavsiye edilmez
incapable	yeteneksiz
inclusion body	inklüzyon cisimciği
inclusion conjunctivitis	inklüzyon konjunktiviti
incomparable	mukayese kabul etmez
incomplete abortion	inkomplet abortus
incompliance	uymama
inconsistency	tutarsızlık
incubation	kuluçka
incubation period	inkübasyon dönemi
incubative stage	kuluçka devresi
indicator	indikatör
indirect bilirubin	indirekt bilirubin
individual	birey
indoleacetic acid	indolasetik asit
induced abortion	istemli abortus
indurable	dayanıksız
ineffective	etkisiz
inelastic	esnek olmayan
inequality	eşitsizlik
inevitable	kaçınılmaz
inevitable abortion	durdurulamaz düşük
inexpert	acemi
infant mortality rate	bebek ölüm oranı
infant school	ana okulu
infantile acne	infantil akne
infected	v.enfekte ol:adj.enfekte
infectious abortion	infeksiyöz abortus
inference	çıkarsama
infertile	kısır
infiltration analgesia	infiltrasyon analjezisi
infiltration anesthesia	infiltrasyon anestezisi
inflammation	enflamasyon
inflate	şişir
inflict	acı ver
influence	etkile
inform	bilgi ver
information	bilgi
ingestion	alınım
inhabitant	sakin
inhalation	nefes alma
inhalation anesthesia	inhalasyon anestezisi
inherent	doğasında var olan
inhuman	insanlık dışı
initial dose	ilk doz
inject	enjekte et
injurious	zararlı
injury	incinme
innervate	sinirle donat
innervation	sinirle donatma
innocent	masum
inoculation	aşılama
inquire	araştır
ins and outs	ayrıntılar
insanity	delilik
insatiable	doymaz
insecta	böcekler
insectivora	böcekçiller
insensible perspiration	insensibl terleme
insidious	sinsi
inspect	muayene et
intact	sağlam
intense	kuvvetli
intensity	şiddet
intercostal space	interkostal aralık
interfere	müdahale et
intermediate product	ara ürün
intermittent claudication	intermittan klodikasyon
internal rotation	internal rotasyon
interrupted suture	tek tek dikiş
intervene	müdahale et
intestinal absorption	intestinal absorpsiyon
intestinal amebiasis	amipli dizanteri
intestinal anthrax	barsak şarbonu
intestine	barsak
intra	iç
intracranial aneurysm	intrakranyal anevrizma
intrauterine death	intrauterin ölüm
intrauterine device	rahimiçi araç
intravenous anesthesia	intravenöz anestezi
intravenous bolus	intravenöz bolus
intravenous pyelography	intravenöz piyelografi
intravenously	entrevenöz
introverted personality	introvert kişilik
invade	envaze etme
invasion	envazyon
inverse proportion	ters orantı
ion exchange	iyon değişimi
ionizing radiation	iyonlaştırıcı radyasyon
iridocylectomy	iridosiklektomi
iris	iris
iron deficiency anemia	demir eksikliği anemisi
islet cell adenoma	insuloma
isobaric spinal analgesia	izobarik spinal analjezi
isolation	tecrit
j curve	j eğrisi
jargon	jargon
jaw	çene
jaw bone	mandibula
jealous	kıskanç
jealousy	kıskançlık
jelly	pelte
jellyfish	denizanası
joint	mafsal
juvenile diabetes	juvenil diabet
kapnos	duman
kaposi's sarcoma	kaposi sarkomu
kardia	kalp
katamathesis	derin bilgi
kataphasis	doğrulama
kathexis	zapt et
kathiasis	oturma
kayser fleischer ring	kayser fleischer halkası
kentron	merkez
kephale	baş
kidney	böbrek
kidney pelvis	renal pelvis
kidney stone	böbrek taşı
king vulture	kral akbaba
knee	diz
knee chest position	diz göğüs pozisyonu
koinos	genel
koplik's spot	koplik lekesi
kupffer	kupfer
labor room	ağrı odası
lactation period	laktasyon dönemi
lactic acid	laktik asit
lar gibbon	ak elli jibon
large bowel	kalın barsak
larrey's amputation	larrey amputasyonu
laryngeal reflex	larinks refleksi
lasegue sign	lasegue belirtisi
latent diabetes	latent diabet
latent period	latent dönem
lead encephalopathy	kurşun ensefalopatisi
lead poisoning	kurşun zehirlenmesi
least tern	ak alınlı kuş
leather bottle stomach	linitis plastika
lecithin sphingomyelin ratio	lesitin/sfingomiyelin oranı
left atrium	sol atriyum
legal medicine	adli tıp
lens capsule	lens kapsülü
lepidoptera	pul kanatlılar
lesser omentum	omentum minus
lethal dose	öldürücü doz
liability	sorumluluk
lid reflex	kornea refleksi
life expectancy	beklenen yaşam süresi
life insurance	hayat sigortası
life span	ömür
life style	yaşam biçimi
limax	sülük salyongozu
linear accelerator	radyoterapide kullanılan x ışını cihazı
linguistics	dil bilimi
liquid air	sıvı hava
liquid petrolatum	sıvı vazelin
lithotomy position	litotomi pozisyonu
live birth	canlı doğum
loading dose	yükleme dozu
local anesthesia	lokal anestezi
local anesthetic	lokal anastezik
localized acromegaly	lokal akromegali
low dose	düşük doz
low protein diet	proteinden fakir diyet
low salt diet	tuzsuz diyet
lumbar puncture	lomber ponksiyon
lung abscess	akciğer apsesi
lungfish	akciğerli balık
lungless salamander	akciğersiz semender
luteal phase	luteal faz
lying in period	erken puerperal dönem
lymphatic adenitis	lenfadenit
lymphatic system	lenf sistemi
macrocytic anemia	makrositer anemi
macroscopic anatomy	makroskopik anatomi
magnifying power	büyütme gücü
malacopterygii	yumuşak yüzgeçliler
malic acid	malik asit
malignant acanthoma	epitelyoma
malignant adenoma	adenokarsinom
malpighian	malpigi boruları
mammalia	memeliler
mammary abscess	meme apsesi
mandelic acid	mandelik asit
manganese	manganez
mania	mani
maniac	manyak
maniacal	manik
manic	manik
manic depressive psychosis	manik depresif psikoz
manifestation	manifestasyon
manikin	manken
manipulation	manipulasyon
mankind	insanlık
mannitol	mannitol
manometer	manometre
manual	manuel
manubrium	ağız sapı
manufacturer	üretici
manure	gübre
marasmic	marasmik
marasmus	marasmus
margarine	margarin
margin	sınır
marginal	marjinal
marijuana	marihuana
marriageable age	evlenme çağı
marrow	ilik
marrow puncture	kemik iliği ponksiyonu
marsupialization	marsupializasyon
masculine	maskülen
masculinity	maskülinite
mask of pregnancy	gebelik maskesi
masochism	mazohizm
masochist	mazohist
mass	kitle
massage	masaj
massive	masif
mastadenitis	mastadenit
mastalgia	mastalji
mastectomy	mastektomi
mastitis	mastit
mastoid	mastoid
mastoidectomy	mastoidektomi
mastoiditis	mastoidit
mastoplasty	mastoplasti
masturbation	mastürbasyon
matching	karşılaştırma
material	materyal
maternal	maternal
matrix	matriks
mattress suture	matris sütür
maturation	matürasyon
mature	matür
maturity	matürite
maxilla	maksilla
maxillary	maksiller
maximal	maksimal
maximum	maksimum
mcburney's point	mcburney noktası
mcburney's sign	mcburney belirtisi
measles	kızamık
meatus	meatus
mechanical	mekanik
mechanics	mekanik
mechanism	mekanizma
mechanism of action	etki mekanizması
meconium	mekonyum
medapezam	medapezam
medial	medial
median	medyan
mediastinal	mediastinal
mediastinitis	mediastinit
mediastinum	mediastin
medical	medikal
medical care	tıbbi bakım
medical statistics	biyoistatistik
medication	ilaç
medicine	tıp
medicolegal	medikolegal
medicosocial	medikososyal
medicus	hekim
mediocre	orta derecede
mediterranean anemia	akdeniz anemisi
medroxyprogesterone acetate	medroksiprogesteron asetat
medulla	medulla
medulla spinalis	omurilik
medullar	meduller
medullary	meduller
megacolon	megakolon
megakaryocyte	megakaryosit
megaloblast	megaloblast
megaloblastic anemia	megaloblastik anemi
megalocyte	megalosit
megalomania	megalomani
megalomaniac	megaloman
meiosis	mayoz
meissner's plexus	meissner pleksusu
melancholia	melankoli
melancholiac	melankolili
melancholic	melankolik
melanin	melanin
melanocyte	melanosit
melanoma	melanom
melanosis	melanoz
melena	melena
melting point	erime noktası
membrane	membran
membranous	membranöz
menarche	menarş
meningeal	meningeal
meningioma	menenjiyom
meningism	menengizm
meningitis	menenjit
meningocele	meningosel
meningococcal meningitis	meningokoksik menenjit
meningococcus	meningokok
meningoencephalitis	meningoensefalit
meningomyelitis	meningomiyelit
meningomyelocele	meningomiyelosel
meninx	meninks
meniscus	menisküs
menometrorrhagia	menometroraji
menopausal	menopozal
menopause	menopoz
menorrhagia	menoraji
menorrhalgia	menoralji
menorrhea	menore
menses	mens
menstrual	menstrüel
menstrual period	menstrüasyon periyodu
menstruation	menstrüasyon
mental	mental
mental aberration	mental aberasyon
mental age	zeka yaşı
menthol	mentol
mentoanterior	mentoanterior
mentoposterior	mentoposterior
meperidine	meperidin
meprobamate	meprobamat
mercaptopurine	merkaptopürin
mercurial poisoning	civa zehirlenmesi
mercurialism	civa zehirlenmesi
mercury	civa
mesathelioma	mezotelyom
mescaline	meskalin
mesencephalon	mezensefalon
mesenchyma	mezenkim
mesenchymal	mezenkimal
mesenchyme	mezenkim
mesenteric	mezenterik
mesenteritis	mezenterit
mesentery	mezenter
mesocolon	mezokolon
mesoderm	mezoderm
mesodermal	mezodermal
mesodermic	mezodermal
mesothelial	mezotelyal
mesothelium	mezotelyum
metabolic	metabolik
metabolic acidosis	metabolik asidoz
metabolic alcalosis	metabolik alkaloz
metabolism	metabolizma
metabolite	metabolit
metacarpal	metakarpal
metacarpophalangeal	metakarpofalangeal
metacarpus	metakarp
metachromasia	metakromazi
metachromatic	metakromatik
metachromatism	metakromatizm
metallic	metalik
metalloporphyrin	metaloporfirin
metamorphosis	metamorfoz
metamyelocyte	metamiyelosit
metaphase	metafaz
metaphysis	metafiz
metaplasia	metaplazi
metaraminol	metaraminol
metastasis	metastaz
metastatic	metastatik
metastatic abscess	metastatik apse
metatarsal	metatarsal
metatarsus	metatars
meteorism	meteorizm
meteorology	meteoroloji
methane	metan
methemoglobin	methemoglobin
methemoglobinemia	methemoglobinemi
methemoglobinuria	methemoglobinüri
methenamine	metenamin
methionine	metionin
methotrexate	metotreksat
methoxyfluorane	metoksifluoran
methyl salicylate	metil salisilat
methyldopa	metildopa
methylene blue	metilen mavisi
metric system	metrik sistem
metromenorrhagia	metromenoraji
metronidazole	metronidazol
metronome	metronom
metrorrhagia	metroraji
microabscess	mikroapse
microaerophile	mikroaerofil
microaerophilic	mikroaerofilik
microbe	mikrop
microbial	mikrobiyal
microbic	mikrobik
microbicide	mikrobisid
microbiologist	mikrobiyolog
microbiology	mikrobiyoloji
microcephaly	mikrosefali
micrognathia	mikrognati
microgram	mikrogram
micron	mikron
microorganism	mikroorganizma
microphone	mikrofon
microscope	mikroskop
microscopic	mikroskopik
microscopic anatomy	histoloji
microscopical	mikroskopik
microscopy	mikroskopi
microsurgery	mikrocerrahi
microvillus	mikrovillüs
miction	miksiyon
micturition	miksiyon
midbrain	ortabeyin
midline	orta hat
midwife	ebe
midwifery	ebelik
migraine	migren
migration	migrasyon
migratory	gezici
mild	hafif
miliaria	miliaria
miliary	miliyer
miliary abscess	miliyer apse
milk abscess	süt apsesi
milligram	miligram
milliliter	mililitre
millilitre	mililitre
millimeter	milimetre
millimetre	milimetre
mimic	mimik
mineral	mineral
miner's phthisis	silikoz
minimal	minimal
minimum	minimum
minor	minör
miosis	miyozis
miotic	miyotik
miscarriage	düşük yapma
misinterpretation	yanlış yorumlama
missed abortion	missed abortus
mite	kene
mitochondrium	mitokondriyum
mitosis	mitoz
mitotic	mitotik
mitotic division	mitoz bölünme
mitral	mitral
mitral regurgitation	mitral yetersizlik
mitral stenosis	mitral darlık
mittelschmerz	mittelschmerz
mixture	karışım
mobile	mobil
mobility	mobilite
mobilization	mobilizasyon
modality	modalite
mode	mod
mode of action	etki şekli
mode of administration	uygulama şekli
moderate	orta dereceli
moderation	ılımlılık
modicifation	modifikasyon
moist	nemli
moist rale	yaş ral
moisture	nem
molar	molar
moldy	küflü
molecular	moleküler
molecule	molekül
mollusca	yumuşakçalar
momentary	bir anlık
mongolian spot	mongol lekesi
mongolism	mongolizm
mongoloid	mongoloid
moniliasis	monilyazis
monitorization	monitorizasyon
monoblast	monoblast
monocular	monoküler
monocyte	monosit
monogamy	monogami
mononuclear	mononükleer
monoparesis	monoparezi
monoplegia	monopleji
monopneumona	tek akciğerliler
monotonous	monoton
monotony	monotonluk
monozygotic	monozigotik
mood	mood
moral	ahlaki
morale	moral
moralization	moralizasyon
morbid	morbid
morbidity	morbidite
morgue	morg
morning sickness	sabah bulantısı
morning stiffness	sabah sertliği
moro reflex	moro refleksi
morphine	morfin
morphinomania	morfinomani
morphogenesis	morfogenez
morphologic	morfolojik
morphological	morfolojik
morphology	morfoloji
mortal	mortal
mortality	mortalite
morula	morula
mosaic	mozaik
mosquito	sivrisinek
motacillidae	kuyruksalayangiller familyası
motherhood	annelik
motile	hareketli
motility	motilite
motion	hareket
motion sickness	taşıt tutması
motionless	hareketsiz
motivation	motivasyon
motor	motor
mountain goat	ak dağ keçisi
mountain sickness	dağ hastalığı
mouth	ağız
mouth cavity	ağız boşluğu
mouth opening	ağız açıklığı
mouth part	ağız parçası
mouth to mouth respiration	ağız ağıza solunum
mouthwash	gargara
mucin	müsin
mucinous	müsinöz
mucocele	mukosel
mucocutaneous	mukokütanöz
mucoid	mukoid
mucolysis	mukoliz
mucopolysaccharide	mukopolisakkarid
mucopolysaccharidosis	mukopolisakkaridoz
mucopurulent	mukopürülan
mucosa	mukoza
mucosal	mukozal
mucous	müköz
mucus	mukus
multiform	multiform
multigravida	multigravid
multinuclear	multinükleer
multipara	multipar
multiparity	multiparite
multiparous	multipar
multiple	multipl
multiple birth	çoğul doğum
multiple myeloma	multipl miyelom
multiple pregnancy	çoğul gebelik
mumps	kabakulak
murmur	üfürüm
murphy's sign	murphy belirtisi
muscicapidae	sinekkapangiller familyası
muscle	kas
muscular	müsküler
muscular dystrophia	müsküler distrofi
musculoskeletal	muskuloskeletal
mushroom	mantar
mushroom poisoning	mantar zehirlenmesi
musset's sign	musset belirtisi
mustard	hardal
mutant	mutant
mutation	mutasyon
mute	dilsiz
mutual action	karşılıklı etki
myalgia	miyalji
myasthenia	miyasteni
mycelium	miselyum
mycobacterium	mikobakteri
mycosis	mikoz
mycosis fungoides	mikozis fungoides
mycotic	mikotik
mycotic aneurysm	mikotik anevrizma
mydriasis	midriyazis
mydriatic	midriyatik
myelin	miyelin
myelinated	miyelinli
myelination	miyelinleşme
myelinization	miyelinleşme
myelitis	miyelit
myeloblast	miyeloblast
myeloblastic	miyeloblastik
myeloblastoma	miyeloblastom
myelocele	miyelosel
myelocyte	miyelosit
myelocytic	miyelositik
myeloid	miyeloid
myeloma	miyelom
myelomeningocele	miyelomeningosel
myelopathy	miyelopati
myenteric	miyenterik
myenteric plexus	miyenterik pleksus
myoblast	miyoblast
myocardial	miyokardiyal
myocardiopathy	miyokardiyopati
myocarditis	miyokardit
myocardium	miyokard
myoclonic	miyoklonik
myoclonus	miyoklonus
myofibril	miyofibril
myofibroma	miyofibrom
myoglobin	miyoglobin
myoglobinuria	miyoglobinüri
myoglobulin	miyoglobulin
myogram	miyogram
myography	miyografi
myolemma	miyolemma
myoma	miyom
myomectomy	miyomektomi
myometrium	miyometriyum
myopathy	miyopati
myope	miyop
myopia	miyopi
myoplasm	miyoplazma
myosarcoma	miyosarkom
myosin	miyozin
myosis	miyozis
myositis	miyozit
myotonia	miyotoni
myotonic	miyotonik
myotonic pupillary reaction	miyotonik pupiller reaksiyon
myringitis	miringit
myringoplasty	miringoplasti
myringotomy	miringotomi
mythomania	mitomani
myxedema	miksödem
myxoma	miksoma
nail	tırnak
nalorphine	nalorfin
nanism	cücelik
naphthalene	naftalin
napkin	çocuk bezi
napkin rash	diaper dermatit
narcissism	narsisizm
narcolepsy	narkolepsi
narcoleptic	narkoleptik
narcosis	narkoz
narcotic	narkotik
narcotic addict	uyuşturucu alışkanlığı olan kişi
narcotic antagonist	narkotik antagonist
nasal	nazal
nasolabial	nazolabial
nasolacrimal	nazolakrimal
nasopharyngeal	nazofaringeal
nasopharyngitis	nazofarenjit
nasopharynx	nazofarenks
natal	natal
natremia	natremi
natrium	sodyum
natural	doğal
nausea	bulantı
nautical insurance	deniz sigortası
navel	göbek
nearsightedness	miyopi
neck	boyun
neck rigidity	ense sertliği
necrobiosis	nekrobiyoz
necrophilia	nekrofili
necropsy	otopsi
necrosis	nekroz
necrotic	nekrotik
necrotic acne	nekrotik akne
necrotomy	nekrotomi
needle	iğne
needle holder	iğne tutucu
needling	delme
negative	negatif
negative accommodation	uzağa bakarken silier kasların gevşemesiyle oluşturulan uyum
negativism	negativizm
nelaton catheter	nelaton sondası
neonatal	neonatal
neonatal death	yenidoğan ölümü
neonate	yenidoğan
neonatology	neonatoloji
neophron percnopterus	leş akbabası
neoplasia	neoplazi
neoplasm	neoplazma
neoplastic	neoplastik
neostigmine	neostigmin
nephrectomy	nefrektomi
nephritic	nefritik
nephritis	nefrit
nephrocalcinosis	nefrokalsinoz
nephrogenic	nefrojenik
nephrogenous	nefrojenik
nephrolithiasis	nefrolitiyazis
nephrology	nefroloji
nephroma	nefrom
nephron	nefron
nephropathy	nefropati
nephrosclerosis	nefroskleroz
nephrosis	nefroz
nephrotic	nefrotik
nephrotoxic	nefrotoksik
nerve	sinir
nerve block	sinir bloğu
nerve block anesthesia	sinir bloğu anestezisi
nerve cell	sinir hücresi
nerve ending	sinir ucu
nervosity	asabiyet
nervous	sinirsel
nervous system	sinir sistemi
nettle rash	ürtiker
network	ağ
neural	nöral
neuralgia	nevralji
neurasthenia	nevrasteni
neurilemma	nörilemma
neuritic	nöritik
neuritis	nörit
neuroanatomy	nöroanatomi
neurobiology	nörobiyoloji
neuroblast	nöroblast
neuroblastoma	nöroblastom
neurochemistry	sinirsel kimya
neurochirurgia	nöroşirürji
neurodermatitis	nörodermatit
neurodermatosis	nörodermatoz
neuroendocrine	nöroendokrin
neuroendocrinology	nöroendokrinoloji
neuroepithelial	nöroepitelyal
neuroepithelium	nöroepitelyum
neurofibril	nörofibril
neurofibroma	nörofibrom
neurofibromatosis	nörofibromatozis
neurogenic	nörojenik
neurogenic bladder	nörojen mesane
neuroglia	nöroglia
neuroglioma	nörogliom
neurohumoral	nörohumoral
neurohypophysis	nörohipofiz
neurologic	nörolojik
neurologist	nörolog
neurology	nöroloji
neuroma	nörom
neuromuscular	nöromüsküler
neuromyopathy	nöromiyopati
neuron	nöron
neuronal	nöronal
neuropathy	nöropati
neurophysiology	nörofizyoloji
neuropsychiatry	nöropsikiyatri
neuropsychology	nöropsikoloji
neuroretinitis	nöroretinit
neurosis	nöroz
neurosurgeon	beyin cerrahı
neurosurgery	nöroşirürji
neurosyphilis	nörosifiliz
neurotic	nörotik
neurotoxic	nörotoksik
neurotransmitter	sinir taşıyıcısı
neurotropic	nörotropik
neurovascular	nörovasküler
neurovegetative system	otonom sinir sistemi
neuter	nötr
neutral	nötral
neutralization	nötralizasyon
neutron	nötron
neutropenia	nötropeni
neutrophil	nötrofil
neutrophile	nötrofil
neutrophilia	nötrofili
neutrophilic	nötrofilik
nevus	nevus
newborn	yenidoğan
newborn child	yenidoğan
newgrowth	tümör
niacin	niasin
nickel	nikel
niclosamide	niklozamid
nicotinamide	nikotinamid
nicotine	nikotin
nicotinic acid	niasin
night sweat	gece terlemesi
nightmare	kabus
nightwalking	uyurgezerlik
nikethamide	niketamid
nipping	çimdikleme
nitrazepam	nitrazepam
nitric acid	nitrik asit
nitrite	nitrit
nitrofurantoin	nitrofurantoin
nitrofurazone	nitrofurazon
nitrogen	azot
nitrogen mustard	nitrojen mustard
nitrogenous	azotlu
nitroglycerin	nitrogliserin
nocardiasis	nokardiyazis
nocardiosis	nokardiyazis
nocturia	noktüri
nocturnal	noktürnal
nocturnal enuresis	enürezis nokturna
nodal	nodal
node	düğüm
nodosity	nodozite
nodular	nodüler
nodule	nodül
nomenclature	nomenklatür
nomogram	nomogram
nomography	nomografi
nonacid fast	aside dirençsiz
noncellular	hücresiz
noninvasive	noninvazif
nonpathogenic bacterium	nonpatojen bakteri
nonsporing	sporsuz
noradrenaline	noradrenalin
norepinephrine	noradrenalin
normal	normal
normoblast	normoblast
normochromia	normokromi
normocyte	normosit
normocytic anemia	normositer anemi
normotensive	normotansif
nose	burun
nose drops	burun damlası
nosebleed	burun kanaması
nosocomial	nosokomiyal
nostril	burun deliği
notch	çentik
notched	çentikli
noxious	zararlı
nuclear	nükleer
nuclear stain	çekirdek boyası
nucleated	çekirdekli
nucleic acid	nükleik asit
nucleolus	nükleolus
nucleoprotein	nükleoprotein
nucleotid	nükleotid
nucleus	nükleus
nuclide	nüklid
nulligravida	nuligravid
nullipara	nulipar
nulliparity	nuliparite
nulliparous	nulipar
numb	uyuşuk
numbness	hissizlik
nutrient	besin
nutriment	besin
nutrition	beslenme
nutritional	nutrisyonel
nutritional anemia	nutrisyonel anemi
nutritionist	beslenme uzmanı
nutritious	besleyici
nyctalopia	niktalopi
nycturia	niktüri
nylon	naylon
nymphomania	nemfomani
nymphomaniac	nemfoman
nystagmus	nistagmus
nystatin	nistatin
obese	obez
obeseness	obezite
obesity	obezite
objective	objektif
obligatory	zorunlu
oblique	oblik
obliteration	obliterasyon
obliterative	obliteratif
obscure	belirsiz
observable	gözlenebilir
observation	gözlem
observer	gözlemci
obsession	obsesyon
obsessive	obsesif
obstetric	obstetrik
obstetric amnesia	obstetrik amnezi
obstetrical	obstetrik
obstetrician	doğum uzmanı
obstetrics	obstetriks
obstipation	inatçı kabızlık
obstruction	obstrüksiyon
obstructive	obstrüktif
obturator	obturatör
occipital	oksipital
occiput	oksiput
occlusion	oklüzyon
occlusive	oklüzif
occult	gizli
occult blood	gizli kan
occupation	meslek
occupational	mesleki
ocular	oküler
oculocardiac reflex	okülokardiyak refleks
oculomotor	okülomotor
odontoblast	odontoblast
odontoblastoma	odontoblastom
odontologist	diş hekimi
odontology	odontoloji
odor	koku
oedema	ödem
offspring	döl
ohm	om
oil	yağ
ointment	merhem
old age	yaşlılık dönemi
old world vultures	akbabagiller familyası
olecranon	olekranon
oligemia	oligemi
oligodendroglioma	oligodendrogliom
oligohydramnios	oligohidramnios
oligomenorrhea	oligomenore
oligophrenia	oligofreni
oligospermia	oligospermi
oliguria	oligüri
olivaceous warbler	ak mukallit kuşu
olive	zeytin
omental	omental
omentitis	omentit
omentum	omentum
omphalectomy	omfalektomi
omphalic	omfalik
omphalitis	omfalit
omphalocele	omfalosel
onchocerciasis	onkoserkiyazis
oncogenesis	onkogenez
oncogenic	onkojenik
oncogenous	onkojenik
oncology	onkoloji
onset	başlangıç
ontogenesis	ontogenez
ontogeny	ontogenez
onychomycosis	onikomikoz
oocyte	oosit
oogenesis	oogenez
oogonium	oogonyum
oophorectomy	ooforektomi
oophoritis	ooforit
oophorocystectomy	ooforokistektomi
oophorohysterectomy	ooforohisterektomi
oophoroplasty	ooforoplasti
oophorosalpingectomy	ooforosalpingektomi
oophorosalpingitis	ooforosalpenjit
oosperm	zigot
opacification	opaklaşma
opacity	opasite
opaque	opak
opaqueness	opaklık
open circulatory system	açık dolaşım sistemi
operable	operabl
operating room	ameliyathane
operation	operasyon
operative	operatif
operator	operatör
ophthalmectomy	oftalmektomi
ophthalmia	oftalmia
ophthalmic	oftalmik
ophthalmitis	oftalmit
ophthalmograph	oftalmograf
ophthalmography	ofthalmografi
ophthalmologist	oftalmolog
ophthalmology	oftalmoloji
ophthalmoplasty	oftalmoplasti
ophthalmoplegia	oftalmopleji
ophthalmoscope	oftalmoskop
ophthalmoscopy	oftalmoskopi
opiate	opiat
opisthotonos	opistotonus
opisthotonus	opistotonus
opium	afyon
opsonic	opsonik
opsonin	opsonin
opsonization	opsonizasyon
optic	optik
optic agnosia	vizüel agnozi
optic atrophy	optik atrofi
optic chiasm	optik kiazma
optic disk	optik disk
optical	optik
optical aberration	optik aberasyon
optician	gözlükçü
opticianry	gözlükçülük
optics	optik
optimal	optimal
optimism	iyimserlik
optimum	optimum
optometer	optometre
optometry	optometri
oral	oral
oral dose	oral doz
orbit	orbita
orbita	orbita
orbital	orbital
orbital ridge	orbital ridge
orchidectomy	orşidektomi
orchiditis	orşidit
orchidopexy	orşidopeksi
orchiectomy	orşiektorni
orchitis	orşit
organelle	organel
organic	organik
organism	organizma
organogenesis	organogenez
organomegaly	organomegali
orgasm	orgazm
orientation	oryentasyon
orifice	orifis
origin	orijin
ornithine	ornitin
ornithosis	psittakoz
oropharyngeal	orofaringeal
oropharynx	orofarenks
orthesis	ortez
orthodontia	ortodondi
orthodontist	ortodontist
orthopedia	ortopedi
orthopedic	ortopedik
orthopedics	ortopedi
orthopedist	ortopedist
orthopnea	ortopne
orthoptics	ortoptik
orthostatic	ortostatik
orthostatic albuminuria	ortostatik albuminüri
ortodontics	ortodonti
oscillation	osilasyon
osmol	ozmol
osmolality	ozmolalite
osmolarity	ozmolarite
osmosis	ozmoz
osteitis	osteit
osteoarthritis	osteoartrit
osteoarthropathy	osteoartropati
osteoblast	osteoblast
osteoblastoma	osteoblastom
osteochondritis	osteokondrit
osteochondroma	ostekondrom
osteochondrosarcoma	osteokondrosarkom
osteoclast	osteoklast
osteocyte	osteosit
osteofibroma	osteofibrom
osteogenesis	osteogenez
osteogenetic	osteojenik
osteogenic	osteojenik
osteology	osteoloji
osteolysis	osteoliz
osteolytic	osteolitik
osteoma	osteom
osteomalacia	osteomalazi
osteomyelitis	osteomiyelit
osteonecrosis	osteonekroz
osteopathy	osteopati
osteophlebitis	osteoflebit
osteophyte	osteofit
osteoplastic	osteoplastik
osteoplasty	osteoplasti
osteoporosis	osteoporoz
osteoporotic	osteoporotik
osteosarcoma	osteosarkom
osteosclerosis	osteoskleroz
osteosteatoma	osteosteatom
osteotome	osteotom
osteotomy	osteotomi
otitis	otit
otitis externa	otitis eksterna
otitis interna	otitis interna
otitis media	otitis media
otorhinolaryngology	otorinolaringoloji
otorrhea	otore
otosclerosis	otoskleroz
otoscope	otoskop
otoscopy	otoskopi
ototomy	ototomi
ototoxic	ototoksik
ouabain	ouabain
out patient	ayaktan hasta
outlet	çıkım
ovarian	ovaryen
ovarian agenesis	ovaryan agenezi
ovarian cyst	over kisti
ovarium	over
ovary	over
overdosage	aşırı doz verme
overdose	aşırı doz
overgrowth	aşırı büyüme
ovular	ovüler
ovulation	ovulasyon
ovulatory	ovulatuar
ovum	ovum
oxalate	oksalat
oxalic acid	oksalik asit
oxaluria	oksalüri
oxaluric acid	oksalurik asit
oxidant	oksidan
oxidase	oksidaz
oxidation	oksidasyon
oxide	oksit
oximeter	oksimetre
oximetry	oksimetri
oxygen	oksijen
oxygen acceptor	oksijen alıcı
oxygenase	oksijenaz
oxygenated	oksijenlenmiş
oxygenation	oksijenlenme
oxyhemoglobin	oksihemoglobin
oxytocic	oksitosik
oxytocin	oksitosin
oxyuride	kıl kurdu
ozena	ozena
ozone	ozon
pacemaker	pacemaker - kalp pili
pachyderma	pakiderma
pachymeningitis	pakimenenjit
pachymeninx	dura mater
pad	ped
painful	ağrılı
palate	damak
palatine	palatin
palatitis	palatit
palatoglossal	palatoglossal
palatolabial	palatolabial
palatopharyngeal	palatofaringeal
palatoplegia	palatopleji
paleontology	paleontoloji
palliation	palyasyoni
palliative	palyatif
pallor	solgunluk
palm	avuç içi
palm oil	hurma yağı
palmar	palmar
palmitate	palmitat
palmitic	palmitik
palmitic acid	palmitik asit
palpable	palpabl
palpation	palpasyon
palpebra	göz kapağı
palpebral	palpebral
palpebration	göz kırpma
palpebritis	palpebrit
palpitation	çarpıntı
palsy	felç
panaris	paronişya
pancarditis	pankardit
pancreas	pankreas
pancreatic	pankreatik
pancreaticocholangiography	pankreatikokolanjiyografi
pancreaticoduodenostomy	pankreatikoduodenostomi
pancreaticoenterostomy	pankreatikoenterostomi
pancreaticojejunostomy	pankreatikojejunostomi
pancreatitis	pankreatit
pancytopenia	pansitopeni
pandemia	pandemi
panendoscope	panendoskop
panendoscopy	panendoskopi
panhypopituitarism	panhipopituitarizm
panic	panik
pannus	pannus
pantothenic acid	pantotenik asit
papaverine	papaverin
papilla	papilla
papillary	papiller
papillary cystic adenoma	papiller kistik adenom
papilledema	papilödem
papillitis	papillit
papillocarcinoma	papillokarsinom
papilloma	papillom
papillomatous	papillomatöz
papilloretinitis	papilloretinit
papilomatosis	papillomatozis
papular	papüler
papule	papül
papulovesicular	papüloveziküler
paracardiac	parakardiyak
paracentesis	parasentez
paracentral	parasantral
paradox	paradoks
paradoxic	paradoksik
paradoxical	paradoksik
paraffin	parafin
paralyser	paralizör
paralysis	paralizi
paralytic	paralitik
paramedian	paramedian
paramedical	paramedikal
paramedics	tıbbi teknisyen
paranasal	paranazal
paranoia	paranoya
paranoiac	paranoyak
paranoid	paranoid
paranoid state	paranoid hal
paraparesis	paraparezi
paraplegia	parapleji
paraplegic	paraplejik
parapsychology	parapsikoloji
parapsychosis	parapsikoz
parasite	parazit
parasitic	parazitik
parasitologist	parazitolog
parasitology	parazitoloji
parasternal	parasternal
parasympathetic	parasempatik
parasympatholytic	parasempatolitik
parasympathomimetic	parasempatomimetik
parathormone	parathormon
parathyroid	paratiroid
parathyroidectomy	paratiroidektomi
parathyrotoxicosis	hiperparatiroidi
paravertebral	paravertebral
parenchyma	parankim
parenchymal	parankimal
parenteral	parenteral
parenteral absorption	parenteral absorpsiyon
paresis	parezi
paresthesia	parestezi
parietal	paryetal
parietal pericardium	pariyetal perikard
parietal peritoneum	pariyetal periton
parietofrontal	parietofrontal
parietooccipital	parietooksipital
parietotemporal	parietotemporal
parkinsonism	parkinson hastalığı
paronychia	paronişya
parotid	parotid
parotidectomy	parotidektomi
parotiditis	parotidit
parotis	parotis
parotitis	parotit
paroxysm	paroksizm
paroxysmal	paroksismal
parthenogenesis	partenogenez
partial	parsiyel
partial acromegaly	parsiyel akromegali
particle	partikül
partner	partner
pas	pas
passage	pasaj
passageway	geçiş yolu
passeriformes	ötücü kuşlar
passive	pasif
pasteurization	pastörizasyon
pastil	pastil
pastille	pastil
patella	patella
patellar	patellar
patellar reflex	patella refleksi
patency	açıklık
patent	patent
path	yol
pathogen	patojen
pathogenesis	patogenez
pathogenetic	patojenetik
pathogenic	patojenik
pathogenic bacterium	patojen bakteri
pathogenicity	patojenlik
pathognomonic	patognomonik
pathologic	patolojik
pathologic anatomy	patolojik anatomi
pathologic physiology	patofizyoloji
pathological	patolojik
pathologist	patolog
pathology	patoloji
pathway	yol
patient	hasta
pattern	patern
pause	duraklama
peau d'orange	peau d'orange
pecten	pekten
pectin	pektin
pectoral	pektoral
pectus carinatum	pektus karinatum
pectus excavatum	pektus ekskavatum
pedal	pedal
pediatric	pediyatrik
pediatrician	pediyatrist
pediatrics	pediyatri
pediatrist	pediyatrist
pediatry	pediyatri
pedicel	pedikül
pedicle	pedikül
pedicular	pediküler
pediculate	pediküllü
pediculosis	pediküloz
pediculosis capitis	pediculosis capitis
pediculosis corporis	pediculosis corporis
pedicure	pedikür
pedigree	secere
pedophilia	pedofili
peduncle	pedünkül
pedunculated	pedünküllü
peliosis	purpura
pellagra	pellagra
pellagroid	pellagroid
pellagrous	pellagralı
pellet	pellet
pellicle	pelikül
pellicula	pelikül
pellucid	saydam
pelvic	pelvik
pelvic abscess	pelvis apsesi
pelvic accommodation	pelvik uyum
pelvic arrest	pelvik arrest
pelvic peritonitis	pelviperitonit
pelvicephalometry	pelvisefalometri
pelvimeter	pelvimetre
pelvimetry	pelvimetri
pelvioperitonitis	pelviperitonit
pelviperitonitis	pelviperitonit
pelvirectal	pelvirektal
pelvis	pelvis
pelvis major	büyük pelvis
pelvis minor	küçük pelvis
pelvisacral	pelvisakral
pelviscope	pelviskop
pelviureterography	piyelografi
pemphigoid	pemfigoid
pemphigus	pemfigus
pemphigus vulgaris	pemfigus vulgaris
penetrance	penetrans
penetration	penetrasyon
penicillin	penisilin
penicillin g	penisilin g
penicillinase	penisilinaz
penile	penil
penis	penis
penitis	penitis
pentane	pentan
pentobarbital	pentobarbital
pentose	pentoz
pentosuria	pentozüri
pentothal	pentotal
pepsin	pepsin
pepsinogen	pepsinojen
peptic	peptik
peptidase	peptidaz
peptide	peptid
peptogen	peptojen
peptone	pepton
per anum	per anum
per centile	persantil
per oral	peroral
per os	peroral
per rectum	rektal
percentile	persantil
perceptible	algılanabilir
perception	algı
perchlorhydria	hiperklorhidri
percussion	perküsyon
percussor	perküsör
percutaneous	perkütan
perforated	perfore
perforation	perforasyon
performance	performans
perfusion	perfüzyon
periadenitis	periadenit
perianal	perianal
perianal abscess	perianal apse
periaortic	periaortik
periaortitis	periaortit
periarterial	periarteriyel
periarteritis	periarterit
periarteritis nodosa	periarteritis nodoza
periarticular	periartiküler
pericardiac	perikardiyak
pericardial	perikardiyal
pericardial sac	perikard boşluğu
pericardiectomy	perikardiyektomi
pericardiocentesis	perikardiyosentez
pericardiolysis	perikardiyoliz
pericardiophrenic	perikardiyofrenik
pericardiotomy	perikardiyotomi
pericarditis	perikardit
pericardium	perikard
pericardotomy	perikardiyotomi
pericholangitis	perikolanjit
pericholecystitis	perikolestit
perichondral	perikondral
perichondrial	perikondral
perichondritis	perikondrit
perichondrium	perikondriyum
perichondroma	perikondrom
pericolitis	perikolit
pericranium	perikranyum
pericyte	perisit
perididymis	perididim
perididymitis	perididimit
perikaryon	perikaryon
perilabyrinth	perilabirent
perilabyrinthitis	perilabirentit
perilobar	perilober
perilymph	perilenf
perilymphadenitis	perilenfadenit
perilymphatic	perilenfatik
perimastitis	perimastit
perimeningitis	perimenenjit
perimeter	perimetre
perimetritis	perimetrit
perimetrium	perimetriyum
perimetry	perimetri
perinatal	perinatal
perineal	perineal
perinearium	perinöriyum
perineoplasty	perineoplasti
perineorrhaphy	perineorafi
perineotomy	perineotomi
perineovaginal	perineovajinal
perinephric abscess	perinefrik apse
perinephritis	perinefrit
perinephrium	perinefriyum
perineum	perine
perineural	perinöral
perineuritis	perinörit
periocular	perioküler
period	periyod
periodic	periyodik
periodicity	periyodisite
periodontal	periodontal
periodontia	periodonti
periodontic	periodontal
periodontics	periodonti
periodontitis	periodontit
periodontium	periodontiyum
periodontology	periodontoloji
periophthalmitis	perioftalmit
perioral	perioral
periorbita	periorbita
periorbital	periorbital
periorchitis	periorşit
periost	periost
periosteal	periosteal
periosteitis	periostit
periosteomyelitis	periosteomyelit
periosteum	periost
periostitis	periostit
peripapillary	peripapiller
peripheral	periferik
peripherial	periferik
peripheric	periferik
periphery	perifer
periphlebitis	periflebit
periportal	periportal
perirectal	perirektal
perirectitis	perirektit
perissodactyla	tek parlılar
peristalsis	peristaltizm
peristaltic	peristaltik
peristome	ağızı çeviren bölge
perithelioma	peritelyom
perithelium	peritelyum
peritoneal	peritoneal
peritoneoscope	peritonoskop
peritoneoscopy	peritonoskopi
peritoneum	periton
peritonism	peritonizm
peritonitis	peritonit
peritonization	peritonizasyon
peritonsillar	peritonsiller
peritonsillar abscess	peritonsiller apse
peritonsillitis	peritonsillit
periumbilical	periumbilikal
periurethral	periüretral
periurethritis	periüretrit
perivascular	perivasküler
periwinkle	vinca rosea
perlingual	perlingual
permanent	kalıcı
permanganate	permanganat
permeability	permeabilite
permeable	geçirgen
permeation	yayılma
permeation analgesia	yüzeysel analjezi
pernicious	pernisyöz
pernicious anemia	pernisyöz anemi
perone	fibula
peroneal	peroneal
peroneotibial	peroneotibial
peroral	peroral
peroxidase	peroksidaz
peroxide	peroksid
peroxide of hydrogen	hidrojen peroksid
perpendicular	dikey
persecution	perseküsyon
persistence	sebat
persistent	persistan
personality	kişilik
perspiration	terleme
persuasion	ikna
pertussis	boğmaca
pes	ayak
pes abductus	talipes valgus
pes adductus	talipes varus
pes cavus	talipes cavus
pes planus	düztabanlık
pessary	peser
pessimism	pesimizm
pessimist	pesimist
pesticide	pestisid
pestis	veba
petechia	peteşi
petechial	peteşiyal
pethidine	petidin
petrolatum	vazelin
petroleum	petrol
petrosa	pars petrosa
petrositis	petrozit
ph	ph
phacitis	fakitis
phacoma	fakoma
phacomalacia	fakomalazi
phacometer	fakometre
phacoscope	fakoskop
phacoscopy	fakoskopi
phage	bakteriyofaj
phagocyte	fagosit
phagocythin	fagositin
phagocytic	fagositik
phagocytoblast	fagositoblast
phagocytolysis	fagositoliz
phagocytose	fagositoz
phagocytosis	fagositoz
phakitis	fakitis
phalangeal	falanjiyal
phalanges	falanks
phalangitis	falanjit
phalanx	falanks
phallic	fallik
phallus	penis
phaneroscope	faneroskop
phaneroscopy	faneroskopi
phantasm	hayal
phantom pregnancy	yalancı gebelik
pharmaceutic	farmasötik
pharmaceutical	farmasötik
pharmaceutics	farmasötik bilimi
pharmacist	eczacı
pharmacodiagnosis	farmakodiyagnoz
pharmacodynamics	farmakodinamik bilimi
pharmacognosis	farmakognozi
pharmacognosy	farmakognozi
pharmacologist	farmakolog
pharmacology	farmakoloji
pharmacopeia	kodeks
pharmacotherapy	farmakoterapi
pharmacy	eczacılık
pharyngeal	faringeal
pharyngeal reflex	farenks refleksi
pharyngitis	farenjit
pharyngoamygdalitis	faringoamigdalit
pharyngocele	faringosel
pharyngoesophageal	faringoözofajiyal
pharyngolaryngeal	faringolaringeal
pharyngolaryngitis	faringolarenjit
pharyngoscope	faringoskop
pharyngoscopy	faringoskopi
pharyngospasm	faringospazm
pharyngotonsillitis	faringotonsillit
pharynx	farenks
phase	evre
phasic	fazik
phenacetin	fenasetin
phenobarbital	fenobarbital
phenol	fenol
phenology	fenoloji
phenolphthalein	fenolftalein
phenolsulfonphthalein	fenolsülfonftalein
phenolsulphonphthalein	fenolsülfonftalein
phenomenology	fenomenoloji
phenomenon	fenomen
phenotype	fenotip
phenylalaninase	fenilalaninaz
phenylalanine	fenilalanin
phenylketonuria	fenilketonüri
pheochromocytoma	feokromositoma
philtrum	filtrum
phimosis	fimozis
phimotic	fimotik
phlebectomy	flebektomi
phlebitic	flebitik
phlebitis	flebit
phlebogram	flebogram
phlebograph	flebograf
phlebography	flebografi
phlebophlebostomy	fleboflebostomi
phleboplasty	fleboplasti
phleborrhagia	fleboraji
phleborrhaphy	fleborafi
phleborrhexis	fleboreksis
phlebosclerosis	fleboskleroz
phlebothrombosis	flebotromboz
phlebotome	flebotom
phlebotomy	flebotomi
phlegmon	flegmon
phlegmonous	flegmonlu
phlegmonous abscess	flegmonlu apse
phlegmonous adenitis	adenoflegmon
phlogistic	flojistik
phlyctana	vezikül
phlyctenosis	fliktenoz
phlyctenula	fliktenül
phlyctenule	fliktenül
phlyctenulosis	fliktenüloz
phobia	fobi
phobic	fobik
phobism	fobizm
phobos	korku
phocomelia	fokomeli
phocomely	fokomeli
phonation	fonasyon
phonendoscope	fonendoskop
phonetics	fonetik
phonocardiogram	fonokardiyogram
phonocardiograph	fonokardiyograf
phonocardiography	fonokardiyografi
phonogram	fonogram
phonograph	fonograf
phonography	fonografi
phonology	fonetik
phonometer	fonometre
phonopsia	fonopsi
phonoreceptor	fonoreseptör
phoresis	forez
phosgene	fosgen
phosphatase	fosfataz
phosphate	fosfat
phosphated	fosfatlı
phosphatemia	fosfatemi
phosphatide	fosfatid
phosphaturia	fosfatüri
phosphide	fosfid
phosphite	fosfit
phosphocreatinase	fosfokreatinaz
phosphocreatine	fosfokreatin
phosphoguanidine	fosfoguanidin
phospholipid	fosfolipid
phospholipidemia	fosfolipidemi
phosphopenia	fosfopeni
phosphoprotein	fosfoprotein
phosphorescence	fosforesans
phosphorescent	fosforesan
phosphoric acid	fosforik asit
phosphorism	fosforizm
phosphorous	fosforlu
phosphotransferase	fosfotransferaz
photic	fotik
photism	fotizm
photo	foto
photoallergy	fotoallerji
photobiology	fotobiyoloji
photobiotic	fotobiyotik
photocauterization	fotokoterizasyon
photochemical	fotokimyasal
photochemistry	fotokimya
photocoagulation	fotokoagülasyon
photodermatitis	fotodermatit
photodermia	fotodermatit
photodromy	fotodromi
photodynamics	fotodinamik
photoelectricity	fotoelektrisite
photograph	fotoğraf
photography	fotografi
photolysis	fotoliz
photometer	fotometre
photon	foton
photophobia	fotofobi
photopia	fotopi
photopsia	fotopsi
photopsy	fotopsi
photoptometer	fotoptometre
photoptometry	fotoptometri
photoreaction	fotoreaksiyon
photoreceptive	fotoreseptif
photoreceptor	fotoreseptör
photosensitive	fotosensitif
photosensitivity	fotosensitivite
photosensitization	fotosensitizasyon
photosynthesis	fotosentez
phototaxis	fototaksi
phototherapy	fototerapi
phototoxic	fototoksik
phototropism	fototropizm
phrenic	frenik
phrenocostal	frenokostal
phrenohepatic	frenohepatik
phthiriasis	pediküloz
phthisis	tüberküloz
phylaxis	filaksi
phylogenesis	filogenez
phylogenetic	filogenetik
phylogenic	filogenetik
phylogeny	filogenez
phylum	filum
physical	fiziksel
physician	hekim
physics	fizik
physiognomy	fizyonomi
physiologic	fizyolojik
physiologic action	fizyolojik etki
physiologic anatomy	fizyolojik anatomi
physiologic anemia	fizyolojik anemi
physiological	fizyolojik
physiologist	fizyolog
physiology	fizyoloji
physiopathological	patofizyolojik
physiopathology	patofizyoloji
physiotherapist	fizyoterapist
physiotherapy	fizyoterapi
physostigmine	fizostigmin
phytic acid	fitik asit
phytohezoar	fitobezoar
phytology	fitoloji
pia	pia mater
pia arachnitis	pia araknitis
pia arachnoid	pia araknoid
pia mater	pia mater
pica	pika
pigment	pigment
pigmentary	pigmenter
pigmentation	pigmentasyon
pigmented	pigmentli
pile	tüy
pileous	tüylü
piles	hemoroid
pill	oral kontraseptif
pilocarpine	pilokarpin
pilomotor	pilomotor
pilonidal	pilonidal
pilot study	pilot çalışma
pilula	pilül
pine bunting	ak başlı yelve kuşu
pine marten	ağaç sansarı
pineal	pineal
pinealectomy	pinealektomy
pinealoma	pinealoma
pink eye	epidemik konjunktivit
pinocyte	pinosit
pinocytosis	pinositoz
pinta	pinta
pinworm	kılkurdu
piperazine	piperazin
pipet	pipet
pipette	pipet
pisces	balıklar
pit	çukur
pituitarism	pituitarizm
pituitary	pituiter
pituitary adiposity	hipofizer şişmanlık
pityriasis	pitiryazis
pityriasis rosea	pitiryazis rozea
pityriasis versicolor	pitiryazis versikolor
placebo	plasebo
placenta	plasenta
placenta previa	plasenta previa
placental	plasental
plague	veba
plaintiff	davacı
planning	planlama
planoconcave	planokonkav
planoconvex	planokonveks
planorbis	tabak salyangozu
plant	bitki
plantar	plantar
plantar reflex	plantar refleks
plaque	plak
plasma	plazma
plasmapheresis	plazmaferez
plasmic	plazmik
plasmin	fibrinolizin
plasminogen	plazminojen
plasminogen activator	plazminojen aktivatörü
plasmocyte	plazmosit
plasmocytoma	plazmositom
plasmodium	plazmodyum
plasmodium falciparum	plazmodyum falsiparum
plasmodium malariae	plazmodyum malarya
plasmodium vivax	plazmodyum vivaks
plasmolysis	plazmoliz
plasmopheresis	plazmaferez
plaster	plaster
plastic	plastik
plasticity	plastisite
plastics	plastik cerrahi
platelet	trombosit
platinum	platin
platyhelminth	yassı kurt
platypelloid pelvis	platipelloid pelvis
pleocytosis	pleositoz
pleomorphic	pleomorfik
pleomorphism	pleomorfizm
plethon glutinosus	akciğersiz semender
plethonidae	akciğersiz semenderler familyası
plethora	pletore
plethoric	pletorik
plethysmogram	pletismogram
plethysmograph	pletismograf
plethysmography	pletismografi
pleura	plevra
pleural	plevral
pleurisy	plörezi
pleuritic	plöritik
pleuritis	plörezi
pleurobronchitis	plörobronşit
pleuropericarditis	plöroperikardit
pleuroperitoneal	plöroperitoneal
pleuroperitonitis	plöroperitonit
pleuropneumonia	plöropnömoni
pleuropulmonary	plöropulmoner
plexiform	pleksiform
plexus	pleksus
plica	plika
plica vocalis	ses teli
plicate	kıvrımlı
plicated	kıvrımlı
plication	plikasyon
plug	tıkaç
plumbism	kurşun zehirlenmesi
plurigravida	plurigravid
pluripara	pluripar
pluriparity	pluriparite
pneomoconiosis	pnömokonyoz
pneumatic	pnömatik
pneumatocele	pnömatosel
pneumaturia	pnömatüri
pneumococcal	pnömokoksik
pneumococcosuria	pnömokokkozüri
pneumococcus	pnömokok
pneumocyte	pnömosit
pneumography	pnömografi
pneumohemothorax	pnömohemotoraks
pneumohydrothorax	pnömohidrotoraks
pneumokoniosis	pnömokonyoz
pneumomediastinum	pnömomediyastinum
pneumomycosis	pnömomikoz
pneumonia	pnömoni
pneumonic	pnömonik
pneumonitis	pnömonit
pneumopericardium	pnömoperikardiyum
pneumoperitoneum	pnömoperitoneum
pneumoperitonitis	pnömoperitonit
pneumopyothorax	pnömopiyotoraks
pneumothorax	pnömotoraks
pock	püstül
pock marked	çiçek bozuğu
podagra	podagra
podophyllin	podofilin
pogonion	çene ucu
poikilocyte	poikilosit
poikilocytosis	poikilositoz
poison	v.zehirle:n.zehir
poisoning	zehirlenme
poisonous	zehirli
poisonousness	zehirlilik
polar	polar
polarity	polarite
polarization	polarizasyon
pole	kutup
policlinic	poliklinik
polio	poliomyelit
poliomyelitis	poliomyelit
pollakiuria	pollakiüri
pollen	polen
pollex	baş parmak
pollinosis	saman nezlesi
polyamine	poliamin
polyarteritis	poliarterit
polyarteritis nodosa	poliarteritis nodoza
polyarthritis	poliartrit
polyarticular	poliartiküler
polychromasia	polikromazi
polychromatophil	polikromatofil
polychromatophilia	polikromatofili
polychromia	polikromi
polychromic	polikromik
polyclinic	poliklinik
polycystic	polikistik
polycythemia	polisitemi
polydactylism	polidaktili
polydactyly	polidaktili
polydipsia	polidipsi
polygamy	poligami
polygenic	poligenik
polygonal	çok köşeli
polyhidrosis	polihidroz
polyhydramnion	polihidramniyoz
polyhydramnios	polihidramniyoz
polyhypermenorrhea	polihipermenore
polyhypomenorrhea	polihipomenore
polymenorrhea	polimenore
polymer	polimer
polymerization	polimerizasyon
polymorph	polimorf
polymorphic	polimorf
polymorphism	polimorfizm
polymorphonuclear	polimorfonükleer
polymorphous	polimorf
polyneuritis	polinevrit
polyneuropathy	polinöropati
polynuclear	polinükleer
polyp	polip
polypectomy	polipektomi
polypeptide	polipeptid
polyphagia	polifaji
polyploid	poliploid
polyploidy	poliploidi
polypnea	polipne
polypoid	polipoid
polyposis	polipozis
polyposis coli	polipozis koli
polysaccharide	polisakkarid
polythene	politen
polyuria	poliüri
pomade	pomad
pons	pons
pontocerebellar	pontoserebellar
popliteal	popliteal
popliteus	popliteal kas
poppy	haşhaş
population	popülasyon
population explosion	nüfus patlaması
porcelain	porselen
pore	por
pornographic	pornografik
pornography	pornografi
porous	porlu
porphyria	porfiri
porphyrin	porfirin
porta	porta
porta hepatis	porta hepatis
portacaval	portakaval
portal	portal
portal of entry	giriş yeri
porter	portör
position	pozisyon
position of fetus	fetus pozisyonu
positive	pozitif
positive accommodation	yakına bakarken silier kasların kontraksiyonu ile oluşan uyum
positron	pozitron
posology	pozoloji
posterior chamber	arka kamara
posteroanterior	posteroanterior
posteroinferior	posteroinferior
posteromedial	posteromediyal
posterosuperior	posterosuperior
postganglionic	postgangliyonik
postgraduate	mezuniyet sonrası
posthitis	postit
posthumous	ölüm sonrası
postmature	postmatür
postmaturity	postmatürite
postmenopausal	postmenopozal
postmortem	postmortem
postnasal	postnazal
postnatal	postnatal
postoperative	postoperatif
postpartum	postpartum
postprandial	postprandial
posttraumatic	posttravmatik
postural	postural
postural albuminuria	ortostatik albuminüri
posture	postür
pot	kap
potable	içilebilir
potassemia	potasemi
potassium	potasyum
potency	potens
potent	potent
potential	potansiyel
potentialization	potansiyelizasyon
potentiation	potansiyelizasyon
potion	posyon
pouch	poş
pouch of douglas	douglas kesesi
pound	pound
pous	ayak
powder	toz
practitioner	pratisyen
praecox	prekoks
praevia	previa
pragmatic	pragmatik
pragmatics	pragmatizm
pragmatism	pragmatizm
preanesthesia	preanestezi
preanesthetic	preanestetik
precancerous	prekanseröz
precapillary	prekapiller
precipitant	presipitan
precipitation	presipitasyon
preclinical	preklinik
precocious puberty	erken puberte
precordial	prekordiyal
precordium	prekordiyum
precursor	prekursör
predisposition	yatkınlık
predispozing	predispozan
prednisolone	prednizolon
prednison	prednizon
predominancy	predominantlık
predominant	hakim
preeclampsia	preeklampsi
preganglionic	pregangliyonik
pregnancy	gebelik
pregnanediol	pregnandiol
pregnant	gebe
prejudice	önyargı
preliminary	ilk
premalignant	premalign
premature	prematüre
premature beat	erken vuru
premature menopause	erken menopoz
prematurity	prematürite
premedication	premedikasyon
premenstrual	premenstrüel
premolar	premolar
premorbid	premorbid
prenatal	prenatal
preoperative	preoperatif
preparation	preparat
preparative	hazırlayıcı
preparatory	hazırlayıcı
prepatellar	prepatellar
prepubertal	prepubertal
prepuberty	prepuberte
prepuce	sünnet derisi
preputium	prepusyum
prepyloric	prepilorik
prerenal	prerenal
presacral	presakral
presbyacusis	presbiakuzi
presbyopia	presbiyopi
prescription	reçete
presenile	presenil
presentation	prezantasyon
preservative	prezervatif
pressor	pressor
pressure	basınç
pressure sore	dekübitus ülseri
presystolic	presistolik
pretibial	pretibial
prevalence	prevalans
preventive	önleyici
preventorium	prevantoryum
priapism	priapizm
priapus	penis
pricking	iğnelenme
prilocaine	prilokain
primaquine	primakin
primary	primer
primary abscess	primer apse
primary aldosteronism	primer aldosteronizm
primary amenorrhea	primer amenore
primary anemia	primer anemi
primate	primat
primates	maymunlar
primigravid	primigravid
primigravida	primigravid
primipara	primipar
primitive	primitif
primordial	primordiyal
principle	ilke
prism	prizma
prisma	prizma
prismatic	prizmatik
probe	prob
procaine	prokain
procaine penicillin	prokain penisilin
procarbazine	prokarbazin
procedure	prosedür
process	süreç
proctitis	proktit
proctocolonoscopy	proktokolonoskopi
proctologist	proktolog
proctology	proktoloji
proctoplasty	proktoplasti
proctoscope	proktoskop
proctoscopy	proktoskopi
proctosigmoidectomy	proktosigmoidektomi
proctosigmoiditis	proktosigmoidit
proctosigmoidoscopy	proktosigmoidoskopi
procumbent	yüzükoyun pozisyonda
procuration	vekaletname
prodromal	prodromal
prodromal period	prodromal dönem
prodromal stage	prodromal dönem
prodrome	prodrom
prodromic	prodromal
product	ürün
productive	prodüktif
proenzyme	proenzim
professional	mesleki
profound	derin
progenitor	ata
progeny	sülale
progeria	progeria
progestational	progestasyonel
progesterone	progesteron
progestin	progesteron
progestogen	progestojen
prognathism	prognatizm
prognosis	prognoz
prognostic	prognostik
progression	progresyon
progressive	progresif
progressive muscular dystrophia	progresif müsküler distrofi
prohormone	prohormon
proinsulin	proinsulin
projectile	projektil
prokaryocyte	prokaryosit
prolactin	prolaktin
prolapse	prolapsus
prolapsed rectum	prolabe rektum
prolapsus	prolapsus
proliferate	çoğal
proliferation	proliferasyon
proliferative	proliferatif
prolonged pregnancy	uzamış gebelik
prominence	çıkıntı
promontorium	promontoryum
promontory	promontoryum
pronation	pronasyon
prone	pron
prone position	yüzükoyun pozisyon
pronunciation	telaffuz
propagation	yayma
prophase	profaz
prophylactic	profilaktik
prophylactic dose	profilaksi dozu
prophylaxis	profilaksi
propionic acid	propionik asit
proportion	orantı
propranolol	propranolol
proprioceptive	proprioseptif
proprioceptor	proprioseptor
proptosis	proptozis
prospective	prospektif
prostaglandin	prostaglandin
prostate	prostat
prostatectomy	prostatektomi
prostatic	prostatik
prostatitis	prostatit
prostatocystitis	prostatosistit
prosthesis	protez
prosthetic	prostetik
prostitute	fahişe
protamine sulphate	protamin sülfat
protease	proteaz
protective	koruyucu
protein	protein
proteinase	proteinaz
proteinuria	proteinüri
proteolysin	proteolizin
proteolysis	proteoliz
proteolytic	proteolitik
proteose	proteoz
prothesis	protez
prothrombin	protrombin
protoerythrocyte	eritroblast
proton	proton
protoplasm	protoplazma
protoporphyria	protoporfiri
protoporphyrin	protoporfirin
protoporphyrinuria	protoporfirinüri
prototype	prototip
protozoal	protozoal
protozoan	protozoon
protozoon	protozoon
protract	uzat
protrusion	protrüzyon
protuberance	tümsek
provitamin	provitamin
provocation	provokasyon
provocative	provokatif
proximal	proksimal
proximity	yakınlık
prurigo	prurigo
pruritic	pruritik
pruritus	pruritus
prussian blue	prusya mavisi
psammoma	psammom
psammoma body	psammom cisimciği
pseudohermaphrodite	psödohermafrodit
pseudohermaphroditism	psödohermafroditizm
pseudomembranous	psödomembranöz
pseudopodium	psödopod
psittacosis	psittakoz
psoriasis	psoriyazis
psoriatic	psoriyatik
psychasthenia	psikasteni
psychiatric	psikiyatrik
psychiatrist	psikiyatrist
psychiatry	psikiyatri
psychic	psişik
psychical	psişik
psychics	psikoloji
psychoanalist	psikoanalist
psychoanalysis	psikoanaliz
psychoanalytic	psikoanalitik
psychobiology	psikobiyoloji
psychodrama	psikodrama
psychodynanmics	psikodinamik
psychogenic	psikojen
psychologic	psikolojik
psychological	psikolojik
psychologist	psikolog
psychology	psikoloji
psychometric	psikometri
psychometry	psikometrik
psychomotor	psikomotor
psychoneurosis	psikonöroz
psychopath	psikopat
psychopathia	psikopati
psychopathic	psikopatik
psychopathology	psikopatoloji
psychopathy	psikopati
psychopharmacology	psikofarmakoloji
psychosis	psikoz
psychosomatic	psikosomatik
psychotherapist	psikoterapist
psychotherapy	psikoterapi
psychotic	psikotik
psychotropic	psikotropik
pterion	pterion
ptosis	ptoz
ptotic	ptotik
ptyalin	ptiyalin
pubertas praecox	erken puberte
puberty	puberte
pubic	pubik
pubis	pubis
puceron	akasya biti
pudendal	pudendal
puerpera	lohusa
puerperal	puerperal
puerperant	lohusa
puerperium	puerperiyum
puffiness	şişkinlik
puffy	şişkin
pulmonary	pulmoner
pulmonary abscess	akciğer apsesi
pulmonary acariasis	akciğer akaryazisi
pulmonary artery	akciğer atardamarı
pulmonary circulation	küçük dolaşım
pulmonary edema	akciğer ödemi
pulmonary embolism	pulmoner embolizm
pulmonary phthisis	akciğer tüberkülozu
pulmonary stenosis	pulmoner darlık
pulmonary vein	akciğer toplardamarı
pulmonates	akciğerli salyangozlar
pulmonic	pulmoner
pulmonic regurgitation	pulmoner yetersizlik
pulp	pulpa
pulsatile	pulsatil
pulsation	pulsasyon
pulsative	pulsatil
pulse	nabız
pulsus alternans	pulsus alternans
pulsus bigeminus	bigemin nabız
pulsus paradoxus	pulsus paradoksus
pulverization	pulverizasyon
punch biopsy	punch biyopsi
punctate	benekli
punctum	nokta
pupil	pupilla
pupilla	pupilla
pupillary	pupiller
purgation	purgasyon
purgative	purgatif
purified	pürifiye
purine	pürin
purpura	purpura
purulent	pürülan
pus	püy
pustule	püstül
putrefaction	putrefaksiyon
pycnonotidae	bülbülgiller familyası
pyelitis	piyelit
pyelocystitis	piyelosistit
pyelography	piyelografi
pyelonephritis	piyelonefrit
pyelonephrosis	piyelonefroz
pyemia	piyemi
pyknic	piknik
pyknolepsy	piknolepsi
pyknosis	piknoz
pyknotic	piknotik
pylephlebitis	pileflebit
pylorectomy	pilorektomi
pyloric	pilorik
pyloric stenosis	pilor stenozu
pyloroduodenal	piloroduodenal
pyloroduodenitis	piloroduodenit
pyloroplasty	piloroplasti
pylorospasm	pilorospazm
pylorostenosis	pilorostenoz
pylorostomy	pilorostomi
pylorotomy	pilorotomi
pylorus	pilor
pyocele	piyosel
pyocyanin	piyosiyanin
pyoderma	piyoderma
pyogen	piyojen
pyogenic	piyojen
pyogenous	piyojen
pyosalpinx	piyosalpenks
pyramid	piramid
pyramidal	piramidal
pyrazinamide	pirazinamid
pyretic	piretik
pyretogen	pirojen
pyretogenetic	pirojen
pyretogenic	pirojen
pyretogenous	pirojen
pyridostigmine	piridostigmin
pyridoxine	piridoksin
pyrimethamine	pirimetamin
pyrimidine	pirimidin
pyrogallic acid	pirogallol
pyrogen	pirojen
pyrogenic	pirojen
pyrogenous	pirojen
pyromania	piromani
pyrosis	pirozis
pyrrole	pirol
pyruvate	pirüvat
pyruvic acid	pirüvik asit
pyuria	piyüri
quack	şarlatan
quackery	şarlatanlık
quadrant	kadran
quadrate	dört köşeli
quadriceps	kuadriseps
quadrilateral	dört kenarlı
quadrilocular	dört boşluklu
quadriplegia	kuadripleji
quadruple	dörtlü
quadruplet pregnancy	dördüz gebelik
qualified	kalifiye
qualitative	kalitatif
qualitative analysis	kalitatif analiz
quality	nitelik
quantitative	kantitatif
quantitative analysis	kantitatif analiz
quantity	miktar
quantum	kuantum
quarantine	karantina
quarantine period	karantina süresi
quartz	kuvars
quaternary	kuaterner
quicksilver	civa
quiescent	durgun
quinacrine	kinakrin
quinidine	kinidin
quinine	kinin
quotient	oran
rabiate	kuduz hastası
rabid	kuduz hastası
rabies	kuduz
race	ırk
rachitic	raşitik
rachitis	raşitizm
rachitism	raşitizm
rad	rad
radial	radyal
radiation	radyasyon
radiation accident	radyasyon hasarı
radiation sickness	radyasyon hastalığı
radical	radikal
radio opaque	radyo opak
radioactive	radyoaktif
radioactivity	radyoaktivite
radiodermatitis	radyodermatit
radiogram	radyogram
radiograph	radyograf
radiography	radyografi
radioimmunoassay	radyoimmünoassay
radioisotope	radyoizotop
radiolaria	ışınlılar
radiologic	radyolojik
radiologist	radyolog
radiology	radyoloji
radionecrosis	radyonekroz
radionuclide	radyonüklid
radiopaque	radyopak
radioscopy	radyoskopi
radiotherapeutic	radyoterapötik
radiotherapist	radyoterapist
radiotherapy	radyoterapi
radioulnar	radioulnar
radium	radyum
radius	radius
radix	kök
rale	ral
ramify	dallanmak
ramulus	dalcık
ramus	dal
range of accommodation	en az kırıcılıkla görüntülenen iki cisim arasındaki uzaklık
ranula	ranula
rape	tecavüz
rape victim	tecavüz kurbanı
raphe	rafe
rapid	hızlı
rash	döküntü
rat	sıçan
rat goliath	afrika cırlak faresi
ratio	oran
rational	mantıklı
rationalization	rasyonalizasyon
ray	ışın
raynaud's phenomenon	raynaud fenomeni
reabsorption	reabsorpsiyon
reaction	reaksiyon
reactivation	reaktivasyon
reactive	reaktif
reagent	belirteç
reality	gerçek
reanimate	yeniden canlandırma
reanimation	reanimasyon
reapperance	yeniden ortaya çıkma
reasonable	makul
rebound	rebound
recall	hatırlama
recanalization	rekanalizasyon
receptor	reseptör
recessive	resesif
recipient	alıcı
reciprocal	resiprokal
reciprocating	resiprokan
recognition	tanıma
recombinant	rekombinan
recombination	rekombinasyon
reconstruction	rekonstrüksiyon
reconstructive	rekonstrüktif
rectal	rektal
rectal alimentation	rektal alimentasyon
rectal exit	anüs
rectitis	rektit
rectoabdominal	rektoabdominal
rectoanal	rektoanal
rectocele	rektosel
rectococcygeal	rektokoksigeal
rectocolitis	rektokolit
rectocolonic	rektokolonik
rectogenital	rektogenital
rectoperineal	rektoperineal
rectopexy	rektopeksi
rectoplasty	rektoplasti
rectoscope	rektoskop
rectoscopy	rektoskopi
rectosigmoid	rektosigmoid
rectosigmoidectomy	rektosigmoidektomi
rectosigmoidoscopy	rektosigmoidoskopi
rectouterine	rektouterin
rectovaginal	rektovajinal
rectovesical	rektovezikal
rectum	rektum
rectus	rektus
recumbency	sırt üstü yatma
recumbent	sırt üstü yatmış
recurrence	rekürens
recurrent	reküren
red blood cell	eritrosit
red pulp	kırmızı pulpa
redness	kızarıklık
reducible	redüktabl
reductant	indirgeyici
reductase	redüktaz
redundancy	fazlalık
redundant	fazlalık
reflection	yansıma
reflex	refleks
reflex act	refleks hareket
reflex akinesia	refleks akinezi
reflex arc	refleks arkı
reflux	reflü
refraction	refraksiyon
refractive	refraktif
refractometer	refraktometer
refractometry	refraktometri
refractory	refrakter
regeneration	rejenerasyon
regimen	rejim
region	bölge
regional	rejyonel
regional anatomy	bölgesel anatomi
regional anesthesia	bölgesel anestezi
regression	gerileme
regressive	regresif
regular	düzenli
regulated	regüle
regulation	regülasyon
regurgitation	regurjitasyon
rehabilitation	rehabilitasyon
rehydration	rehidrasyon
reinfection	reenfeksiyon
reinforcement	kuvvetlendirme
rejection	rejeksiyon
relation	ilişki
relative	relatif
relative accommodation	belirli bir mesafede iki gözle bakış için gerekli olan uyum
relaxation	relaksasyon
relaxin	relaksin
relief	dindirme
remediable	tedavi edilebilir
remedial	iyileştirici
remedy	ilaç
remission	remisyon
remittance	havale
remittent	remitan
remnant	kalıntı
removal	uzaklaştırma
renal	renal
renal adenoma	renal adenom
renal albuminuria	renal albuminüri
renal calculus	böbrek taşı
renal colic	renal kolik
renal diabetes	renal glukozüri
renal pelvis	renal pelvis
renin	renin
renovascular	renovasküler
reparable	onarılabilir
reperfusion	reperfüzyon
repetitive	tekrarlanan
replacement	replasman
replication	replikasyon
reproducible	tekrarlanabilir
reproductive	reprodüktif
reserpine	rezerpin
reservoir	depo
reservoir of infection	enfeksiyon kaynağı
residual	rezidüel
residual air	rezidüel hava
residue	kalan kısım
resin	reçine
resistance	rezistans
resistant	rezistan
resonance	rezonans
resorption	rezorpsiyon
respiration	solunum
respirator	respiratör
respiratory acidosis	respiratuar asidoz
respiratory alkalosis	respiratuar alkaloz
respiratory center	solunum merkezi
respiratory sound	solunum sesi
respiratory standstill	solunum durması
response	cevap
rest	istirahat
restenosis	restenoz
restless	huzursuz
restlessness	huzursuzluk
restoration	normal haline gelme
resuscitation	resüsitasyon
resuscitative	resüsitatif
retardation	retardasyon
retention	retansiyon
retention of urine	idrar retansiyonu
reticular	retiküler
reticular fibre	ağsı tel
reticulocytosis	retikülositoz
reticuloendothelial	retiküloendotelyal
reticuloendothelial system	retiküloendotelyal sistem
reticuloendothelioma	retiküloendotelyom
reticulosis	retiküloz
retina	retina
retinal	retinal
retinal detachment	retina dekolmanı
retinitis	retinit
retinoblastoma	retinoblastom
retinochoroiditis	retinokoroidit
retinography	retinografi
retinopapillitis	retinopapillit
retinopathy	retinopati
retinoscope	retinoskop
retinoscopy	retinoskopi
retinosis	retinoz
retractile	retraktil
retraction	retraksiyon
retractor	retraktör
retrobulbar	retrobulber
retrocecal abscess	retroçekal apse
retrograde	retrograd
retrograde amnesia	retrograd amnezi
retrograde pyelography	retrograd piyelografi
retrolental	retrolental
retroperitoneal	retroperitoneal
retroperitoneum	retroperiton
retropharyngeal	retrofaringeal
retroposition	retropozisyon
retrospective	retrospektif
retrosternal	retrosternal
retroversioflexion	retroversiyofleksiyon
retroversion	retroversiyon
retroversion of uterus	uterus retroversiyonu
retroverted	retrovert
reversal	tersine dönme
reversibility	reversibilite
reversible	reversibl
rh sensitization	rh sensitizasyon
rhabdomyoma	rabdomiyom
rhabdomyosarcoma	rabdomiyosarkom
rhabdosarcoma	rabdomiyosarkom
rhachis	omurga
rheumatic	romatizmal
rheumatism	romatizma
rheumatismal	romatizmal
rheumatoid	romatoid
rheumatoid arthritis	romatoid artrit
rheumatoid spondylitis	romatoid spondilit
rheumatology	romatoloji
rhexis	reksis
rhinitis	rinit
rhinocerotidae	gergedangiller familyası
rhinolalia	rinolali
rhinolaryngitis	rinolarenjit
rhinopharynx	nazofarenks
rhinophyma	rinofima
rhinoplasty	rinoplasti
rhinorrhea	rinore
rhinoscope	rinoskop
rhinoscopy	rinoskopi
rhizopoda	kök ayaklılar
rhodopsin	rodopsin
rhombencephalon	rombensefalon
rhomboid	romboid
rhonchus	ronküs
rhythm	ritm
rhytmic	ritmik
rib	kosta
riboflavin	riboflavin
ribonuclease	ribonükleaz
ribonucleic acid	ribonükleik asit
ribose	riboz
ribosome	ribozom
rice water stool	pirinç suyu feçes
rickets	raşitizm
rickettsia	riketsia
ridge	kabartı
rifampicin	rifampisin
rifampin	rifampisin
rifamycin	rifamisin
right atrium	sağ atriyum
rigid	rijid
rigidity	rijidite
rigor	rigor
rigor mortis	ölü sertliği
ring abscess	ring apse
ringing	çınlama
risus sardonicus	risus sardonicus
rod	rod
rodent	kemirici
rodentia	kemirgenler
rodenticide	rodentisid
roentgenogram	röntgenogram
roentgenography	röntgenografi
roentgenologist	röntgen uzmanı
romberg's sign	romberg belirtisi
root	kök
rosacea	rosacea
roseola	roseola
rosette	rozet
rotation	rotasyon
rotator	rotator
rough	kaba
roundworm	yuvarlak solucan
route	yol
rovsing's sign	rovsing belirtisi
rubber	kauçuk
rubella	rubella
rubeola	kızamık
rubor	rubor
rudimentary	rudimenter
rumination	ruminasyon
run around	dolama
runaround	dolama
rupia	rupia
rupture	rüptür
rupture of an aneurysm	anevrizma rüptürü
rupture of membranes	membran rüptürü
ruptured	rüptüre
rusty sputum	paslı balgam
sac	kese
saccharase	sükraz
saccharic acid	sakarik asit
saccharide	sakkarid
saccharin	sakarin
saccharine	şekerli
saccharose	sakkaroz
saccular	sakküler
sacral	sakral
sacral anesthesia	sakral anestezi
sacralization	sakralizasyon
sacrococcygeal	sakrokoksigeal
sacrococcyx	sakrokoksiks
sacroiliac	sakroiliak
sacroiliitis	sakroileit
sacrospinal	sakrospinal
sacrouterine	sakrouterin
sacrovertebral	sakrovertebral
sacrum	sakrum
sadism	sadizm
sadist	sadist
sadistic	sadistik
safe period	güvenli dönem
sage	adaçayı
sagittal	sagittal
sagittal section	sagittal kesit
salicylate	salisilat
salicylic acid	salisilik asit
salicylism	salisilat zehirlenmesi
saline	saline
saliva	tükürük
salmo fontinalis	dere alabalığı
salmo irideus	çelik baş alabalık
salmo lacustris	göl alası
salmo salar	som balığı
salmo schasta	gök kuşaklı alabalık
salmo trutta	deniz alası
salmon	alabalık
salmonella	salmonella
salmonellosis	salmonelloz
salmons	alabalıkgiller familyası
salpingectomy	salpingektomi
salpingitis	salpenjit
salpingography	salpengografi
salpingooophorectomy	salpengo ooforektomi
salpingooophoritis	salpengo ooforit
salpingoplasty	salpengoplasti
salpingoscope	salpengoskop
salpingoscopy	salpengoskopi
salpinx	salpenks
salt	tuz
saltless	tuzsuz
saltness	tuzluluk
salty	tuzlu
saluresis	salürezis
saluretic	salüretik
sanatorium	sanatoryum
sand viper	akdeniz kum engerek yılanı
sanguineous	kanlı
sanitarium	sanatoryum
saphena	safen ven
saphenectomy	safenektomi
saprophyte	saprofit
saprophytic	saprofitik
saprozoic	saprozoik
sarcoadenoma	sarkoadenom
sarcoblast	sarkoblast
sarcocarcinoma	sarkokarsinom
sarcoid	sarkoid
sarcoidosis	sarkoidoz
sarcolemma	sarkolemma
sarcoma	sarkom
sarcomatosis	sarkomatoz
sarcomatous	sarkomatöz
sarcoplasm	sarkoplazma
satellite	satellit
satisfaction	tatmin
saturation	satürasyon
saturnism	kurşun zehirlenmesi
sauna	sauna
saw toothed	testere dişli
scab	kabuk
scabby	kabuklu
scabies	uyuz
scalp	skalp
scalpel	skalpel
scaphoid abdomen	çökük karın
scapula	skapula
scapular	skapuler
scapuloclavicular	skapuloklaviküler
scapulovertebral	skapulovertebral
scar	skar
scarlatina	kızıl
scarlatiniform	skarlatiniform
scarlet fever	kızıl
scarring	skarlaşma
schema	şema
schematic	şematik
schistosome	şistozom
schizoid	şizoid
schizont	şizont
schizophrenia	şizofreni
schizophreniac	şizofren
schizophrenic	şizofren
schizophreniform	şizofreniform
school phobia	okul fobisi
sciatic	siyatik
sciatica	siyatalji
scintigram	sintigram
scintigraphy	sintigrafi
scissors	makas
sclera	sklera
scleradenitis	skleradenit
scleral	skleral
scleral spur	skleral spur
sclerectomy	sklerektomi
sclerema	sklerem
scleritis	sklerit
scleroconjunctivitis	sklerokonjunktivit
sclerocornea	sklerokornea
scleroderma	skleroderma
sclerodermatitis	sklerodermatit
scleroplasty	skleroplasti
scleroprotein	skleroprotein
sclerosant	sklerozan
sclerose	sertleş
sclerosis	skleroz
sclerotherapy	skleroterapi
sclerotic	sklerotik
scolex	skoleks
scollosis	skolyoz
scopolamine	skopolamin
scorbutus	skorbüt
scorpion	akrep
scotoma	skotom
scotomatous	skotomlu
scotometer	skotometre
scotometry	skotometri
scotopia	skotopi
scraper	kazıyıcı
scrofulous abscess	soğuk apse
scrotal	skrotal
scrotum	skrotum
scruff	ense
scuacco heron	alaca balıkçıl kuşu
scurf	kepek
scurfy	kepekli
scurvy	skorbüt
sea sickness	deniz tutması
sebaceous	sebase
seborrhea	sebore
seborrheic	seboreik
sebum	sebum
secobarbital	sekobarbital
secondary	sekonder
secondary aldosteronism	sekonder aldosteronizm
secondary amenorrhea	sekonder amenore
secondary anemia	sekonder anemi
secretagogue	sekretagog
secretin	sekretin
secretion	sekresyon
secretory	sekretuar
sedation	sedasyon
sedative	sedatif
sedentary	sedanter
sediment	sediment
sedimentation	sedimentasyon
sedimentation rate	sedimentasyon
segment	segment
segmental	segmental
segmentation	segmentasyon
seizure	nöbet
sella	sella
sella turcica	sella turcica
semantic	semantik
semen	meni
semicircle	yarım daire
semicoma	yarı koma
semiflexion	semifleksiyon
semilunar	semilunar
seminoma	seminom
seminormal	seminormal
semiology	semiyoloji
semisynthetic	yarı sentetik
semitransparent	yarı saydam
senile	senil
senility	senilite
senna	senna
sensible perspiration	sensibl terleme
sensitive	sensitif
sensitivity	sensitivite
sensitization	sensitizasyon
sensorimotor	sensorimotor
sensorium	sensoryum
sensory	duyusal
sensual	duygusal
sentimental	duygusal
sepsis	sepsis
septal	septal
septate	septalı
septic	septik
septicemia	septisemi
septum	septum
sequel	sekel
sequela	sekel
sequelae	sekeller
sequestration	sekestrasyon
serious	ciddi
serofibrinous	serofibrinöz
serologic	serolojik
serologist	serolog
serology	seroloji
seronegative	seronegatif
seropositive	seropozitif
serosa	seroza
serositis	serozit
serotonin	serotonin
serous	seröz
serum	serum
serum sickness	serum hastalığı
service	v.hizmet ver:n.hizmet
sesame	susam
sesamoid	sesamoid
sessile	sapsız
sessile polyp	sapsız polip
sex	cinsiyet
sex chromosome	seks kromozomu
sex linkage	sekse bağlılık
sex linked	sekse bağlı
sex ratio	cinsiyet oranı
sexless	cinsiyetsiz
sexual	cinsel
sexual act	cinsel birleşme
sexual activity	cinsel faaliyet
sheath	kılıf
shedding	dökülme
shelf	sahanlık
shell ibis	açık gagalı leylek
shift to the left	sola kayma
shift to the right	sağa kayma
shigella	şigella
shigellosis	şigelloz
shirt stud abscess	shirt stud apse
shock	şok
shoulder	omuz
shoulder blade	skapula
shrinkage	büzüşme
shunt	şant
sialaden	tükürük bezi
sialadenitis	sialadenit
sibilant	sibilan
sibilant rale	sibilan ral
siccative	kurutucu
sick	hasta
sick abed	yatalak hasta
sick room	hasta odası
sickle cell	orak hücre
sickle cell anemia	orak hücreli anemi
sickling	oraklaşma
side effect	yan etki
side reaction	yan etki
sideropenia	sideropeni
sideropenic	sideropenik
siderosis	sideroz
siderotic	siderotik
siderous	demirli
sigmoid	sigmoid
sigmoidectomy	sigmoidektomi
sigmoiditis	sigmoidit
sigmoidoscope	sigmoidoskop
sigmoidoscopy	sigmoidoskopi
sigmoidostomy	sigmoidostomi
sigmoidotomy	sigmoidotomi
significant	önemli
silica	silis
silicate	silikat
silicon	silisyum
silicone	silikon
silicosis	silikoz
silk suture	ipek sütür
silver	gümüş
similarity	benzerlik
simplicidentata	yalın dişliler
simulation	simülasyon
simultaneous	simultane
sinciput	alın
singultation	hıçkırık tutması
singultus	hıçkırık
sinoatrial	sinoatriyal
sinus	sinüs
sinus arrhytmia	sinüzal aritmi
sinus venosus	sinüs venozus
sinusal	sinüzal
sinusitis	sinüzit
sinusoid	sinüzoid
sirup	şurup
sitotoxin	sitotoksin
situs	situs
skatole	skatol
skeletal	iskeletsel
skeleton	iskelet
skiameter	skiametre
skiametry	skiametri
skiascope	skiaskop
skiascopy	skiaskopi
skin	deri
skull	kafatası
sleeping sickness	uyku hastalığı
sleeplessness	uykusuzluk
sleeptalking	uykuda konuşma
sleepwalker	uyur gezer
sleepwalking	somnambulizm
slide	lam
slimy salamander	akciğersiz semender
slow lori	maymungiller ailesi
sluggishness	uyuşukluk
small bowel	ince barsak
smallpox	çiçek hastalığı
smear	yayma
smegma	smegma
sneezing	aksırma
sociability	sosyabilite
social	toplumsal
sociocultural	sosyokültürel
sociologist	sosyolog
sociology	sosyoloji
sociomedical	sosyomedikal
sociopath	sosyopat
sociopathy	sosyopati
soda	soda
sodium	sodyum
sodoku	sodoku
soft chancre	yumuşak şankr
soft palate	yumuşak damak
solarium	solaryum
sole	ayak tabanı
solid	solid
solubility	eriyebilirlik
soluble	eriyebilir
solute	eriyen madde
solution	solüsyon
solvable	eriyebilir
solvent	solvent
somatic	somatik
somatization	somatizasyon
somatology	somatoloji
somatometry	somatometri
somatotrophin	somatotropin
somatotropin	somatotropin
somnambulance	somnambulizm
somnambulism	somnambulizm
somnambulist	uyurgezer
somniloquism	uykuda konuşma
somnolence	somnolans
sonocardiometry	sonokardiyometri
sonorous	yüksek sesli
souffle	üfürüm
spalding's sign	spalding belirtisi
span	süre
spark	kıvılcım
spasm	spazm
spasmodic	spazmodik
spasmogenic	spazm yapıcı
spasmolysis	spazmoliz
spasmolytic	spazmolitik
spasmotoxin	spazmotoksin
spasmous	spazm şeklinde
spastic	spastik
spasticity	spastisite
spatula	spatül
specialist	uzman
specialization	uzmanlık
specialty	uzmanlık
specific	spesifik
specific action	spesifik etki
specimen	numune
spectacles	gözlük
spectrometer	spektrometre
spectrometry	spektrometri
spectrophotometer	spektrofotometre
spectrophotometric analysis	spektrofotometrik analiz
spectrophotometry	spektrofotometri
spectroscope	spektroskop
spectroscopy	spektroskopi
spectrum	spektrum
speculum	spekulum
speech center	konuşma merkezi
sperm	sperm
sperma	sperm
spermatic	spermatik
spermaticidal	spermatisid
spermatid	spermatid
spermatocide	spermatisid
spermatocyte	spermatosit
spermatogenesis	spermatogenez
spermatogonium	spermatogonium
spermatozoid	spermatozoon
spermatozoon	spermatozoon
spermicidal	spermatisid
spermicide	spermatisid
spermine	spermin
spermiogenesis	spermiogenez
spermiogram	spermiogram
spermium	spermatozoon
sphenofrontal	sfenofrontal
sphenoid	sfenoid
sphenoidal	sfenoidal
sphenomandibular	sfenomandibuler
sphenomaxillary	sfenomaksiler
sphenopalatine	sfenopalatin
sphenoparietal	sfenoparyetal
sphenorbital	sfenorbital
sphenozygomatic	sfenozigomatik
sphere	sfer
spheric	sferik
spherical	sferik
spherocyte	sferosit
spherocytosis	sferositoz
spheroid	sferoid
spheroidal	sferoid
sphincter	sfinkter
sphincteric	sfinkterik
sphingolipid	sfingolipid
sphingolipidosis	sfingolipidoz
sphingomyelin	sfingomiyelin
sphingosine	sfingozin
sphygmomanometer	sfigmomanometre
sphygmomanometry	sfigmomanometri
sphyra	malleus
spicule	spikül
spider nevus	spider nevus
spina bifida	spina bifida
spinach	ıspanak
spinal	spinal
spinal analgesia	spinal analjezi
spinal anesthesia	spinal anestezi
spinal column	spinal kolon
spindle	iğ
spine	omurga
spinothalamic	spinotalamik
spiral	spiral
spiramycin	spiramisin
spirillum	spirillum
spirituous	alkollü
spirochetal	spiroketal
spirochete	spiroket
spirography	spirografi
spirometer	spirometre
spirometry	spirometri
splanchnic	splanknik
spleen	dalak
splenectomy	splenektomi
splenic	splenik
spleniform	spleniform
splenitis	splenit
splenocele	splenosel
splenocolic	splenokolik
splenocyte	splenosit
splenography	splenografi
splenoid	splenoid
splenomegaly	splenomegali
splenoportography	splenoportografi
splenorenal	splenorenal
splint bone	fibula
splinter hemorrhage	splinter hemoraji
spondylarthritis	spondilartrit
spondyle	omur
spondylitis	spondilit
spondylolisthesis	spondilolistezis
spondylolysis	spondiloliz
spondylosis	spondiloz
spondylosyndesis	spondilosindezis
sponge	spanç
spongioblast	spongioblast
spongioblastoma	spongioblastom
spongiocyte	spongiosit
spongiocytoma	spongiositom
spongiositis	spongiosit
spontaneous	spontan
spontaneous abortion	spontan abortus
sporadic	sporadik
sporangium	sporangium
spore	spor
sporicidal	sporisid
sporicide	sporisid
sporification	sporlanma
sporogenesis	sporogenez
sporoplasm	sporoplazma
sporotrichosis	sporotrikoz
sporozoon	sporozoon
sporulation	sporlanma
sporule	sporcuk
spot	benek
spray	sprey
sprue	spru
spurious	yalancı
spurious pregnancy	yalancı gebelik
sputum	balgam
squamata	pullu sürüngenler
squamous	skuamöz
squamous cell carcinoma	skuamöz hücreli karsinom
squamous epithelium	yassı epitel
squint	şaşılık
squint eyed	şaşı
stabile	stabil
stability	stabilite
stabilization	stabilizasyon
stable	stabil
stage	evre
staging	evreleme
stainable	boyanabilir
staining	boyama
stammerer	kekeme
stammering	kekemelik
standstill	durma
stannum	kalay
stapes	stapes
staphyledema	uvula ödemi
staphylitis	uvula iltihabı
staphylocide	stafilosid
staphylococcal	stafilokoksik
staphylococcemia	stafilokoksemi
staphylococcic	stafilokoksik
staphylococcus	stafilokok
staphylodermatitis	stafilokok dermatiti
staphylolysin	stafilolizin
staphyloma	stafilom
staphylotome	stafilotom
staphylotomy	stafilotomi
staphylotoxin	stafilokok toksini
starch	nişasta
starchy	nişastalı
starvation	açlık
stasis	staz
static	statik
stationary	sabit
statistics	istatistik
stature	boy
status	durum
status asthmaticus	status astmatikus
status epilepticus	status epileptikus
stearic acid	stearik asit
stearrhea	steatore
steatoma	steatom
steatorrhea	steatore
steatosis	steatoz
stellate	stellat
stem cell	kök hücre
stenosed	stenozlu
stenosis	stenoz
stenotic	stenotik
stercobilin	sterkobilin
stercobilinogen	sterkobilinojen
stereogram	stereogram
stereoisomer	stereoizomer
stereoscope	stereoskop
stereoscopy	stereoskopi
stereotaxis	stereotaksi
stereotaxy	stereotaksi
stereotypy	stereotipi
sterile	steril
sterility	sterilite
sterilization	sterilizasyon
sterilize	sterilize et
sterilizer	sterilizatör
sternal	sternal
sternidae	deniz kırlangıcı ailesi
sternoclavicular	sternoklaviküler
sternocleidal	sternoklaviküler
sternocostal	sternokostal
sternoscapular	sternoskapuler
sternotomy	sternotomi
sternum	sternum
steroid	steroid
sterol	sterol
stertorous respiration	hırıltılı solunum
stethoscope	stetoskop
stethoscopy	stetoskopi
stibium	antimon
sticky	yapışkan
stiffness	sertlik
stigma	stigma
stigmatism	stigmatizm
stilbestrol	dietilstilbestrol
stillbirth	ölü doğum
stillborn	ölü doğan
stimulant	stimülan
stimulate	stimüle et
stimulation	stimülasyon
stimulator	stimulan
stimulus	stimulus
stirrup	stapes
stitch abscess	sütür apsesi
stocking	çorap
stoma	stoma
stomach	mide
stomachache	mide ağrısı
stomachalgia	mide ağrısı
stomal	stomal
stomatitis	stomatit
stool	feçes
stool softener	laksatif
strabism	strabismus
strabismic	stramismik
strabismometer	strabizmometre
strabismus	strabismus
strabotomy	strabotomi
strainer	süzgeç
strangulated	strangule
strangulation	strangulasyon
stratification	tabakalaşma
stratified	çok katlı
stratified epithelium	çok katlı epitel
stratified squamous epithelium	çok katlı yassı epitel
streptococcal	streptokoksik
streptococcemia	streptokoksemi
streptococcic	streptokoksik
streptococcus	streptokok
streptodermatitis	streptokok dermatiti
streptodornase	streptodornaz
streptokinase	streptokinaz
streptokinase streptodornase	streptokinaz streptodornaz
streptolysin	streptolizin
streptomycin	streptomisin
stress	stres
stretcher	sedye
stretching	gerilme
stria	stria
striated	strialı
stricture	striktür
stridor	stridor
strigidae	baykuşgiller familyası
stroke	inme
stroma	stroma
stromal	stromal
strongylosis	strongilozis
strophanthin	strofantin
structural	yapısal
structure	yapı
strumous abscess	soğuk apse
strychnine	striknin
stump	güdük
stupor	stupor
stuporous	stuporda
stuttering	kekemelik
sty	hordeolum
stye	hordeolum
styloglossal	stiloglossal
stylohyoid	stilohiyoid
stylomandibular	stilomandibuler
stylomaxiliary	stilomaksiller
subabdominal	subabdominal
subacute	subakut
subapical	subapikal
subarachnoid	subaraknoid
subcapsular	subkapsüler
subchronic	subkronik
subclavian	subklavyen
subclinical	subklinik
subcostal	subkostal
subcrepitant	sukrepitan
subcrepitant rale	sukrepitan ral
subcutaneous	subkütan
subdiaphragmatic	subdiyafragmatik
subdivision	alt bölüm
subdural	subdural
subendocardial	subendokardiyal
subendothelial	subendotelyal
subepicardial	subepikardiyal
subepithelial	subepiteliyal
subfebrile	subfebril
subicteric	subikterik
subjective	subjektif
sublimate	süblime et
sublimation	süblimasyon
sublingual	sublingual
sublingual absorption	dilaltı absorpsiyon
subluxation	subluksasyon
submandibular	submandibuler
submucosa	submukoza
submucous	submukoz
subnormal	subnormal
subphrenic abscess	subfrenik apse
subscapular	subskapuler
substance	substans
substernal	substernal
substrate	substrat
subtotal	subtotal
successive	ardışık
sucking reflex	emme refleksi
suckle	emzir
sucrase	sükraz
sucrose	sükroz
suction amnioscope	suction amniyoskop
sudamen	sudamen
sudamina	sudamina
suffocation	boğulma
suffocative	boğucu
suicide	intihar
sulcus	sulkus
sulfadiazine	sülfadiazin
sulfaguanidine	sülfaguanidin
sulfamethoxazole	sülfametoksazol
sulfapyridine	sülfapiridin
sulfate	sülfat
sulfonamide	sülfonamid
sulfur	kükürt
sulphate	sülfat
sulphonamide	sülfonamid
sulphonylurea	sülfonilüre
sulphuric acid	sülfürik asit
sunburn	güneş yanığı
sunstroke	güneş çarpması
supercilium	kaş
superego	süperego
superficial	yüzeysel
superimposition	süperpoze olma
superinfection	süperenfeksiyon
superior	superior
superolateral	superolateral
supervisor	supervizör
supination	supinasyon
supine	supin
supplement	supleman
supplemental	suplemental
supplementary	suplemental
suppository	supozituvar
suppression	supresyon
suppressor	supresör
suppuration	süpürasyon
suppurative	süpüratif
supraclavicular	supraklaviküler
suprahepatic abscess	suprahepatik apse
supraorbital	supraorbital
suprapubic	suprapubik
suprapubic puncture	suprapubik ponksiyon
suprasternal	suprasternal
suralimentation	hiperalimentasyon
surface	yüzey
surface analgesia	yüzeysel analjezi
surface anesthesia	yüzeyel anestezi
surgeon	cerrah
surgery	cerrahi
surgical	cerrahi
survey	araştırma
susceptibility	duyarlılık
susceptible	duyarlı
suspensory	asıcı
sutura	sutura
suturation	sütür koyma
suture	sütür
swan ganz catheter	swan ganz kateteri
sweetbread	sakatat
sweetening agent	tatlandırıcı
sycosis	sikozis
symbiosis	simbiyoz
symbiotic	simbiyotik
symmetric	simetrik
symmetrical	simetrik
symmetry	simetri
sympathectomy	sempatektomi
sympathetic	sempatik
sympatheticomimetic	sempatomimetik
sympathicolytic	sempatolitik
sympathicomimetic	sempatomimetik
sympathomimetic	sempatomimetik
symphysis	simfiz
symposium	sempozyum
symptom	semptom
symptom complex	sendrom
symptomatic	semptomatik
symptomatology	semptomatoloji
synapse	sinaps
synapsis	sinapsis
synaptic	sinaptik
synchronism	senkronizm
synchronous	senkron
synclitism	sinklitizm
syncope	senkop
syncytiotrophoblast	sinsityotrofoblast
syncytium	sinsityum
syndactylia	sindaktili
syndesis	artrodez
syndrome	sendrom
synechia	sineşi
synergic	sinerjik
synergism	sinerji
synergistic	sinerjik
synergistic action	sinerjik etki
synergy	sinerji
synovia	sinovya
synovial	sinoviyal
synovitis	sinovit
synovium	sinovyum
synthesis	sentez
synthetic	sentetik
synthetical	sentetik
syphilis	sifiliz
syphilitic	sifilitik
syphilitic acne	sifilitik akne
syphilitic adenopathy	sifilitik adenopati
syphilitic aneurysm	sifilitik anevrizma
syringe	enjektör
syringomyelia	siringomiyeli
syringomyelitis	siringomiyelit
syrup	şurup
systematic	sistematik
systematic anatomy	sistematik anatomi
systemic	sistemik
systemic circulation	sistemik dolaşım
systole	sistol
systolic	sistolik
tactile agnosia	taktil agnozi
tarry stool	melena
tartaric acid	tartarik asit
tawny owl	alaca baykuş
teleostei	kemikli balıklar
teleostomi	tükel ağızlılar
terminal arteriole	terminal arteriyol
test tube baby	tüp bebek
testicular agenesis	testiküler agenezi
tetanus antitoxin	tetanos serumu
thecal abscess	tekal apse
therapeutic abortion	terapötik abortus
theraphy	tedavi
thermogenic action	pirojen etki
thoracic aorta	torasik aort
thoracic cage	göğüs kafesi
thorax	göğüs
thready pulse	filiform nabız
threatened abortion	düşük tehdidi
thymallus thymallus	gölge balığı
tissue culture	doku kültürü
tongue spatula	dil basacağı
tooth decay	diş çürümesi
topographic anatomy	topografik anatomi
total dose	toplam doz
toxic amaurosis	toksik amoroz
trace element	eser element
trained reflex	şartlı refleks
transverse section	transvers kesit
traumatic alopecia	travmatik alopesi
traumatic aneurysm	travmatik anevrizma
tree frog	ağaç kurbağası
tree frogs	ağaç kurbağasıgiller
tree snake	ağaç yılanı
tree toad	ağaç kurbağası
treepipit	ağaç incir kuşu
trendelenburg's position	trendelenburg pozisyonu
trichloroacetic acid	trikloroasetik asit
triplet pregnancy	üçüz gebelik
trousseau's sign	trousseau belirtisi
true pelvis	küçük pelvis
tubal abortion	tubal abortus
tube baby	tüp bebek
tuberculous abscess	soğuk apse
tuberculous meningitis	tüberküloz menenjit
turkish saddle	türk eyeri
twin pregnancy	ikiz gebelik
umbilical cord	umbilikal kord
universal donor	evrensel donör
upper arm	üst kol
upright position	ayakta dik duruş pozisyonu
uremic amaurosis	üremik amoroz
uric acid	ürik asit
urinary apparatus	boşaltım sistemi
urinary bladder	mesane
urinary calculus	üriner taş
urine specimen	idrar örneği
urodela	amfibyumların kuyruklu olanları
uterine atony	uterus atonisi
uterine contraction	uterus kontraksiyonu
vacuum extractor	vakum aleti
vagal attack	vagal atak
vaginal discharge	vajinal akıntı
vaginal smear	vajinal smear
valsalva's maneuver	valsalva manevrası
valve replacement	kapak replasmanı
vasovagal attack	vagal atak
vegetable physiology	bitki fizyolojisi
ventricular septal defect	ventriküler septal defekt
vertebral column	vertebral kolon
vesicoureteric reflux	vezikoüreteral refleks
vinca alkaloid	vinka alkaloidi
vincent's angina	vincent anjini
viperidae	engerekgiller familyası
visceral anatomy	organ anatomisi
visceral pericardium	visseral perikard
visceral peritoneum	visseral periton
visual agnosia	vizüel agnozi
visual axis	görme ekseni
visual purple	rodopsin
vitelline sac	yumurt kesesi
vitreous body	vitreus
vitreous chamber	vitreus boşluğu
volitional act	istemli hareket
volumetric analysis	volüm analizi
vomiting reflex	kusma refleksi
vultur monochus	rahip akbaba
waldeyer's ring	waldeyer halkası
wandering abscess	gezici apse
web space abscess	web space apse
wet brain	beyin ödemi
wheeze sound	wheezing
whiskered tern	ak bıyıklı deniz kırlangıcı
white blood cell	akyuvar
white headed saki	ak başlı maymunu
white matter	ak madde
white rhinoceros	ak gergedan
white stork	ak leylek
white substance	beyaz cevher
white toothed shrew	ak kuyruklu soreks
white wagtail	ak kuyruksallayan kuşu
white whale	ak balina
white winged black tern	ak kanatlı deniz kırlangıcı
white winged lark	ak kanatlı tarla kuşu
whooping cough	boğmaca
wild ass	afrika yaban eşeği
wire suture	tel dikiş
withdrawal bleeding	çekilme kanaması
withdrawal symptom	yoksunluk semptomu
wood alcohol	metil alkol
woodpecker	ağaçkakan
x ray	x ray
x ray pelvimetry	radyopelvimetri
x ray photograph	röntgen filmi
yellow spot	sarı nokta
yolk sac	yumurta kesesi
young adult	genç erişkin
\n\\\\\\gele's rule\\\	nägele kuralı
Anthrax	?arbon
Anthrax	?arbon
Diabetes mellitus	?ekerli Diabet-Diabetes Mellitus
Schistosomiasis	?istosomiazis
Emerg.Assist.and Travma.Hosp.	Acil Yardım ve  Trav. Hast.
MCH / FP Center	AÇS / AP  Merkezi
MCHFP	AÇSAP
Gn.Dir.of MCH/FP	AÇSAP Gen.Müd.
Investments of MCH/FP	AÇSAP Yatırımları
Lung	Akciğer
Acute nephritis	Akut Nefrit
Acute poliomyelitis	Akut Poliomyelit
Acute poliomyelitis	Akut Poliomyelit
Late effects of acute poliomyelitis	Akut Poliomyelit'in geç etkileri
Late effects of acute poliomyelitis	Akut Poliomyelit'in geç etkileri
Active rheumatic fever	Akut Romatizma
Acute Respiratory Infections	Akut Solunum Yolları enfeksiyonları
Alcoholism	Alkol Alışkanlığı
Regional Dir.of Main Equip.,Supply	Ana Donatım İkmal Bölge Md.
Mother and Child Health	Ana ve Çocuk Sağlığı
Anatolia Nursing	Anadolu Hemşirelik
Anaemias	Anemiler
Anaesthesia	Anestezi
Ankylosis and acquired musculoskeletal deformities	Ankilos ve Sonradan olma Kemik-Kas Biçimsizl.
Empyema and abscess of lung	Anpiyem ve Akciğer Absesi
Appendicitis	Apandisit
Res.Plan.Coord.Council	APK.Kurulu Başkanlığı
Traditional birth attendant	Ara ebesi
Diseases of arteries, arterioles and capillaries	Arter, Arteryol ve Kapillerin Hastalıkları
Arthritis and spondylitis	Artrit ve Spondilit
Assistant	Asistan Hekim
Accident caused by firearm missiles	Ateşli Silah Mermilerinin Neden Olduğu Kazalar
Dep.of Europe Community Coor.	ATK Daire Bşk.
Salaries	Aylıklar
Malignant neoplasm of buccal cavity and pharynx	Ağız Boşluğu ve Farenks Habis Urları
Oral Re-hydration Liquid - a sugar/salt solution	ağızdan sıvı tedavisi (AST)
Hypertrophy of tonsils and adenoids	Bademcik ve Adenoidlerin Hipertrofisi
bacterial diseases	Bakteri Hastalıkları
bacterial diseases	Bakteri Hastalıkları
Bacteriolog. tests (*)	Bakteriyolojik Testler(*)
Intestinal obstruction and hernia	Barsak Tıkanması ve Fıtık
Tbc. of intestines, peritoneum and mesenteric glands	Barsaklar, Periton ve Mezanter Ganglionu Tbc.
Tbc. of intestines, peritoneum and mesenteric glands	Barsaklar, Periton ve Mezanter Ganglionu Tbc.
Bacillary dysentery and amoebiasis	Basilli ve Amipli Dizanteri
Bacillary dysentery and amoebiasis	Basilli ve Amipli Dizanteri
\Neuroses, personality disorders	bağlı olmayan diğer akıl bozuklukları\
Anoxic and hypoxic conditions not else where classified	Başka Yerlere Girmeyen Anoksi ve Hipoksi Hal.
Body Mass Index (BMI)	Beden Kitle İndeksi (BKİ)
Brain	Beyin
Biochemistry	Biyokimya
Biologist	Biyolog
Infections of kidney	Böbrek Enfeksiyonları
Kidney Health and Dialyss Ctr. Hosp.	Böbrek Sağlığı ve Diyaliz Mrk.Hast.
Institute of Hygiene of Region	Bölge Hıfzıssıhha Enstitüsü
Whooping Cough	Boğmaca
Whooping cough	Boğmaca
Bronchitis, emphysema and asthma	Bronşit, Amfizem ve Astım
Brucella	Brusella
Brucellosis	Brusella
All other infective and parasitic diseases	Bütün Diğer Enfeks.ve Parazit Hastalıkları
All other accidents	Bütün Diğer Kazalar
Malignant neoplasm of other and unspecified sites	Bütün Diğer ve Belirtilmeyen Yerl. Habis Urlar
Cervix Uteri	Cervix Uteri
Malignant neoplasm of cervix uteri	Cervix Uteri Habis Uru
Environmental Health	Çevre Sağlığı
Smallpox	Çiçek
Child Diseases Hospital	Çocuk Hastalıkları Hast.
Contrimacsazole	CONTRİMAKSAZOLE
Leprosy Dispensary	Cüzam Savaş Dispanseri
Purchase of Inventory	Demirbaş Alımları
Skin	Deri
Infections of skin and subcutaneous tissue	Deri ve Deri Altı Dokusu Enfeksiyonu
Other diseases of skin and subcutaneous tissue	Deri ve Deri Altı Dokusunun Diğer Hastalıkları
Dermatology-Veneral Diseases Disp.	Deri-Tenasül Hst.Dispanseri
Malignant neoplasm of skin	Derinin Habis Uru
Investment of Supporting Services	Destek Hizm.Yatırımları
Diphtheria	Difteri
Diphtheria	Difteri
Beds of Dispansery Hospital	Dispanser ve Revir Yatağı
Diabetes Hospital	Diyabet Hastanesi
Diaphragm, foam,jelly	Diyafram, köpük, jel
Dietetition	Diyetisyen
Dysentery	Dizanteri
Dysentery	Dizanteri
Dysentery	Dizanteri
Other and unspecified abortion	Diğer Düşükler
Accidental poisoning by oth. solid and liquid substances	Diğer Katı ve Sıvı Maddelerle Olan Zehirl.
Other Profession Lesson	Diğer Meslek Dersleri
Other nephritis and nephrosis	Diğer Nefrit ve Nefrozlar
Other pneumonia	Diğer Pnomoni ?ekilleri
Other Health Pers.	Diğer Sağlık Prs.
Other transport accidents	Diğer Taşıt Kazaları
Other viral diseases	Diğer Virüs Hastalıkları
Dental Diseases Hospital	Diş Hastanesi
Dentist	Diş Hekimi
Dental Prosthesis	Diş Protez
Diseases of teeth and supporting structures	Diş ve Dişleri Destekleyen Dokuların Hastl.
Other diseases of circulatory system	Dolaşım Sisteminin Diğer Hastalıkları
Other congenital anomalies of circulatory system	Dolaşım Sisteminin Doğuştan Gelme Anomalileri
Directorate of Equipment of Region	Donatım Bölge Müdürlüğü
Directorate of Equipment of Province	Donatım İl Müdürlüğü
Birth injury and difficult labour	Doğum Travması ve Güç Doğum
Maternity and Child Center	Doğum ve Çocuk Bakımevi
Other sepsis of birth and the puerperium	Doğum ve Diğer Lohusalık Enfeksiyonları
FERTILITY	DOĞURGANLIK
Life expectancy at birth	Doğuşta Yaşam Beklentisi
All other congenital anomalies	Doğuştan Gelme Diğer Bütün Anomaliler
Congenital syphilis	Doğuştan Gelme Frengi
World Bank Project Services	Dün.Bnk.Prj.Hizmetleri
Religion services	DİN HİZMETLERİ
Foreign Credit (Curative Services)	Dış Kredi(Ted.Hiz.Gn.Md.)
Dep.of External Affairs	Dış İlişkiler Daire Bşk.
Midwife	EBE
Pharmacist	Eczacı
ECG	EKG
Non-articular rheumatism , rheumatism unspecified	Eklem dışı ve  Belirlenemeyen Romatizma
Endoscopic exam.	Endoskopik Muayene
Infectious hepatitis	Enfeksiyoz Hepatit
Enteritis	Enterit
Enteritis	Enterit
Enteritis and other diarrhoeal diseases	Enteritis ve İshal ile Seyreden Diğer Hst.
Enteritis and other diarrhoeal diseases	Enteritis ve İshal ile Seyreden Diğer Hst.
Epilepsy	Epilepsi
Erysipelas	Erizipel
Erysipelas	Erizipel
Early syphilis, symptomatic	Erken Frengi, Semptomatik
Male sterilisation	Erkeğin kanallarının bağlanması
Investment of Educational Services	EĞitim Hizm.Yatırımı
Training-Educ. serv.	EĞİTİM VE ÖĞRETİM HİZM.
Filarial infection	Filerya Enfeksiyonu (Fil hastalığı)
Phys.therapy,-Radiotherapy	Fizik Tedavi-Radyoterapi
Other syphilis	Frenginin Diğer ?ekilleri
Gastritis and duodenitis	Gastrit ve Duedonit
Accidental poisoning by gases and vapours	Gaz ve Buharla Olan Kaza Sonucu Zehirl.
Haemorrhage of pregnancy and childbirth	Gebelik ve Doğum Kanamaları
Toxaemias of pregnancy and the puerperium	Gebelik ve Lohusalık Hali Toksemileri
Oth. comp.of pregnancy, birth and the puerperium	Gebelik, Doğum ve Lohusalık Hali Diğer Komp.
Other tuberculosis including late effects	Geç Etkileri Dahil Diğer Tbc. ?ekilleri
Other tuberculosis including late effects	Geç Etkileri Dahil Diğer Tbc. ?ekilleri
Tranzient Hyper phenylalaninamia	Geçici Hiper-fenilalaninemi
General Hospital	Genel Hastane
Gn.admistrative serv.	GENEL İDARE HİZMETLERİ
Withdrawing	Geri Çekme
Withdrawal	Geri çekme
Glaucoma	Glokom
Gonococcal infections	Gonokok Enfeksiyonları
Eye Diseases Hospital	Göz Hastanesi
Chest Hearth.Vasc.Syst.Surg.Cent.	Göğ. Kalp ve Damar Cer.Mrk.
Chest Diseases Hospital	Göğüs Hastalıkları Hast.
Influenza	Grip
Thyrotoxicosis with or without goitre	Guatr'lı yada Guatr'sız Tirotoksikoz
Food poisoning	Gıda Zehirlenmesi(Bakteri Kaynaklı)
Food poisoning	Gıda Zehirlenmesi(Bakteri Kaynaklı)
Larynx	Gırtlak
Pill	Hap
Injury resulting from operations of war	Harp Harekatinin Neden Olduğu Yaralanma
DISEASES	HASTALIKLAR
Hospital	Hastane
Health Control Center of Airport	Hava Limanı Sağ.Dnt.Mrk.
Nurse	HEMŞİRE
Hepatitis A	Hepatit A
Hepatitis B	Hepatit B
Hydatidosis	Hidatik (Ekinokok, kist, tümör kaynaklı)
Hypertensive disease	Hipertansiyon
Service Capacity	Hizmet Alımları
Gn.Dir.of Border and Marine	Hud.ve Sah.Sağ.Gn.Md.
Health Control  Center of Border	Hudut Sağlık Denetim Mrk.
Law Consultancy	Hukuk Müşavirliği
Relapsing fever	Hummai Racia
Crude birth	Kaba Doğum
Crude Death	kaba ölüm
Other forms of heart diseases	Kalbin Diğer Hastalıkları
Congenital anomalies of heart	Kalbin Doğuştan Gelme Anomalileri
Persistant Hyper phenylalaninamia	Kalıcı Hiper-fenilalaninemi
Blood Center	Kan Merkezi
Other diseases of blood and blood-forming organs	Kan ve Kan Yapıcı Organların Diğer Hastalıkları
Blood Station	Kan İstasyonu
Anchylostomiosis	Kancalı Kurt-Ankilostoma
Cancer	Kanser
Dep.of Cancer Control	Kanser Sav.Dai.Bşk.
Dep.of Cancer Control	Kanser Savaş Daire Bşk.
Liver	Karaciğer
Cirrhosis of liver	Karaciğer Sirozu
Cardiology Institute	Kardiyoloji Enstitüsü
\Homicide and injury purposely inflicted	Kasıtlı ve Adli Müdahale Son.Adam Öld.ve Yar.
Cataract	Katarakt
Accidental falls	Kaza Sonucu Düşmeler
Accidental drowning and submersion	Kaza Sonucu Suda Boğulma ve Suya Batma
Malignant neoplasm of bone	Kemigin Habis uru
Bone Diseases Hospital	Kemik Hastalıkları Hast.
Tuberculosis of bones and joints	Kemik ve Eklem Tüberkülozu
Tuberculosis of bones and joints	Kemik ve Eklem Tüberkülozu
Bone Marrow	Kemik İliği
Oth.diseases of musculoskeletal sys.,connective tissue	Kemik-Kas Sistemi ve Bağ Dok. Diğer Hast.
Suicide and self inflicted injury	Kendini Öldürme ve Kendi Kendini Yaralama
Cholera	Kolera
Cholera	Kolera
Colon	Kolon
Condom	Kondom (Prezervatif)
Village Health Station	Köy Sağlık Evi
Chronic rheumatic heart disease	Kronik Romatizmal Kalp Hastalığı
Rabies	Kuduz
Rabies	Kuduz
Rabies	Kuduz
Measles	Kızamık
Measles	Kızamık
Scarlet Fever	Kızıl
Red Crescent	Kızılay
Laboratory	Laboratuvar
Laparoscopy	LAPAROSKOPİ
Malignant neoplasm of larnyx	Larenks Habis Uru
Oth.neoplasms of Iymphatic and haemotopoietic tissue	Lenfatik ve Kan Yapıcı Dokunun Habis Urları
Leprosy	Lepra
Leprosy	Lepra
Leprosy Hospital	Lepra Hastanesi
Harbor-City Bacteriology Institution	Liman-Şehir Bakt.Mües.
Sepsis of puerperium	Lohusalık Humması
Leukaemia	Lösemi
Purchase of Machinery, Equipment	Mak.Teçh.ve Taşıt Alım.
Medical Care	Medikal Bakım
Breast	Meme
Diseases of breast	Meme Hastalıkları
Malignant neoplasm of breast	Memenin Habis Uru
Meningococcal infection	Menengokoksik Enfeksiyon (Bulaşıcı Menenjit)
Meningococcal infection	Menengokoksik Enfeksiyon (Bulaşıcı Menenjit)
Meningococceal Inf.	Menenjit
Meningitis	Menenjit (Bulaşıcı ve Parazitik Kayn. Olmayan)
Tbc. of meninges and cetral nervous system	Menenjlerin ve Merkezi Sinir Sis.Tüberkülozu
Tbc. of meninges and cetral nervous system	Menenjlerin ve Merkezi Sinir Sis.Tüberkülozu
Syphilis of central nervous system	Merkezi Sinir Sistemi Frengisi
Bladder	Mesane
Occupational Diseases Hospital	Meslek Hastalıkları Hastanesi
Stomach	Mide
Peptic ulcer	Mide Ülseri
Malignant neoplasm of stomach	Midenin Habis Uru
Motor vehicle accidents	Motorlu Taşıt Kazaları
Multiple sclerosis	Multiple Sclerosis
Microsurgery	MİKRO-ŞİRÜRJİ
\Injury undetermined whether accidentally	Nedeni Bilinmeyen Yaralanma
Neonatal mortality	Neonatal ölüm
Delivery without mention of complication	Normal, Komplikasyonsuz Doğum
Deaths	Ölen
Oncology Hospital	Onkoloji Hastanesi
Otitis media and mastoiditis	Orta Kulak İltihabı ve Mastoiditis
Orthopedics	Ortopedi
Osteomyelitis and periostitis	Osteomyelit ve Periyostit
Malignant neoplasm of oesophagus	Özefagusun Habis Uru
Paratyphoid fever	Paratifo
Paratyphoid fever and other salmonella infections	Paratifo ve Diğer Salmonella Enfeksiyonları
Paratyphoid fever and other salmonella infections	Paratifo ve Diğer Salmonella Enfeksiyonları
Pathology	Patoloji
Other causes of perinatal morbidity and mortality	Perinatal Hastalık Nedenleri
Gn.Dir.of Personnel	Personel Gen.Müd.
Gn.Dir.of Personnel	Personel Genel Md.
Conditions of placenta and cord	Placenta ve Kordon Afetleri(Yenidoğan çin)
Poliomyelitis	Polio
Post-Neonatal mortality	Post -Neonatal ölüm
Practitioner	PRATİSYEN hekim
Primary	Primer/Birincil
Prostate	Prostat
Hyperplasia of prostate	Prostat Hiperplazisi
Malignant neoplasm of prostate	Prostatın Habis Uru
Psychologist	Psikolog
Senility without mention of psychosis	Psikozdan Sözedilmeksizin htiyarlık
Psychoses	Psikozlar
Refik Saydam Institute of Hygiene	R.Saydam Hıfz.Mrk.Bşk.
Radiology	Radyoloji
IUD	Rahim İçi Araç
Ref.Saydam Inst.of Hygiene	Ref.S.veHıfz.M.B.
Rectum	Rektum
Malignant neoplasm of intestine, except rectum	Rektum hariç Barsağın Habis uru
Malig. neoplasm of rectum and restosigmoid juction	Rektum ve Rekto-Sigmoid Birl. Yeri Habis Url.
Reticuloendotelial	Retikiloendotelyal
Reticuloendotelial	Retikiloendotelyal
Periodic abstinence	Ritm
X-ray	Röntgen
Mental Diseases Hospital	Ruh Sağ. ve Hast.Hastanesi
Mental Dispensary	Ruh Sağlığı Dispanseri
IUD Insertion	RİA UYGULAMASI
IUD+MR	RİA+MR
Cholelithiasis and cholecystitis	Safra Taşı ve Kolesistit
Health Control Center of Coast	Sahil Sağlık Denetim Mrk.
Accidents mainly of industrial type	Sanayi ve şkollarında Meydana Gelen Kazalar
Yellow fever	Sarı Humma
Health Services	SAĞLIK HİZM.
Sanitarian	SAĞLIK MEMURU
Gn.Dir.of Health Education	Sağlık Eğt.Gen.Müd.
Health Protection Place (quarantine)	Sağlık Koruma Yeri
Health Center	Sağlık Merkezi
Health Professional High School	Sağlık Meslek Lisesi
Directorate of Health	Sağlık Müdürlüğü
Health Center (without Bed)	Sağlık Ocağı
Health Project	Sağlık Projesi
Investment of Health Project	Sağlık Projesi Yatırımı
Benign neoplams and neoplams of unspecified nature	Selim Urlar ve Tabiatı Belirtilmeyen Urlar
Symptoms and other ill-defined conditions	Semptomlar ve yice Tanımlanmayan Diğer Dur.
District Polyclinic	Semt Polikliniği
Cerebrovascular disease	Serebrovasküler Hastalıklar
Other diseases of digestive system	Sindirim Sisteminin Diğer Hastalıkları
Other diseases of nervous system and sense organs	Sinir Sis. ve Duyu Organlaının Diğer Hastl.
Tuberculosis of respiratory system	Solunum Sistemi Tüberkülozu
Tuberculosis of respiratory system	Solunum Sistemi Tüberkülozu
Acute respiratory infections	Solunum Sisteminin Akut Enfeksiyonu
Other diseases of respiratory system	Solunum Sisteminin Diğer Hastalıkları
Social Worker	Sosyal Çalışmacı
Spina bifida	Spina Bifida
Social Insu.Inst.	SSK
Sterilization(tubal.Ligation)	Sterilizasyon
Streptococcal sore throat and scarlet fever	Streptokoksik Anjin ve Kızıl
Streptococcal sore throat and scarlet fever	Streptokoksik Anjin ve Kızıl
Surveillance Services	SÜRVEYANS HİZMETLERİ
Malaria	Sıtma
Malaria	Sıtma
Malaria	Sıtma
Malaria Institute	Sıtma Enstitüsü
Malaria Control Laboratory	Sıtma Kontrol Laboratuvar
Malaria Laboratory	Sıtma Laboratuvarı
Dep.of Malaria Control	Sıtma Sav.Daire Bşk.
Department of Malaria Control	Sıtma Savaş Daire Bşk.
Discharged	Taburcu
Gn.Dir.of Curative Services	Tedavi Hizmetleri Gn.Md.
Investment of Curative Services	Tedavi Hizmetleri Ytr.
Res.Plan.Coord.Council	Teftiş Kurulu Bşk.
Technique services	TEKNİK HİZMETLER
Adaptations to Primary Health Services	TEMEL SAĞLIK HİZMETLERİ ADAPTASYON EĞİTİMİ
Gn.Dir.of Primary Health Care	Temel Sağlık Hiz.Gn.Md.
Tetanus	Tetanoz
Tetanus	Tetanoz
Typhoid fever	Tifo
Typhoid fever	Tifo
Typhus and other rickettsioses	Tifüs ve Diğer Riketsia Hastalıkları
Non - toxic goitre	Toksik Olmayan Guatr
Public Health	Toplum Sağlığı
Trachoma	Trahom
Malignant neoplasm of trachea, bronchus and lung	Trakea, Bronşlar ve Akc.Hab.Url.
Transfers	Transferler
Other herminthiases	Trematod, cestod Enfes.Trisinler,Diğ,Bag.Enf.
Trypanosomiasis	Tripanazoma
Tuberculosis	Tüberküloz
Purc. of Consumption Properties	Tük.Mal.ve Malz.Alım.
Female sterilisation	Tüplerin Bağlanması
Medical Secretary	Tıbbi Sekreterlik
Med. Technologist	Tıbbi Teknolog
Abortion induced for legal indications	Tıbbı ve Adli Endikasyonlarla Yaptırılan Düşük
Other diseases of genito-urinary system	Üro-Genital Sistemin Diğer Hastalıkları
Inv.Product Research Recagn.Cont.S.	Ürt.Arş.Teşh.Kont.H.Ytr.
Other malignant neoplasm of uterus	Uterusun Diğer Habis Urları
Accidental poisoning by drugs and medicoments	Uyuşturucu ve Diğer laç Zehirlenmeleri
Physician	UZMAN hekim
Plague	Veba
Plague	Veba
Venous thrombosis and embolism	Vena Trombozu ve Emboli
Dep.of TBC Control	Verem Savaş Daire Bşk.
Tuberculosis Dispensary	Verem Savaş Dispanseri
Veterinerian	Veteriner
Viral pneumonia	Virüs Pnomonisi
Viral encephalitis	Virütik Ansefalit
Avitaminoses and other nutritional deficiency	Vitaminsizlikler ve Diğer Beslenme Yetersizl.
Accidents caused by fires	Yangınların Neden Olduğu Kazalar
Exp.Building,Installat.Large Repairs	Yapı Tes.-B.Onarım Gid.
Asistant services	YARDIMCI HİZMETLER
Cleft palate and cleft lip	Yarık Damak ve Yarık Dudak
Patient-days	Yatılan Gün
Other endocrine and metabolic diseases	İç Salgı Bezleri ve Metabolizmanın Diğer Hast.
Dep.of Adminis.-Financial Affairs	İda.ve Ml.İşl.Daire Bşk.
Calculus of urinary system	İdrar Sistemi Taşları
Haemolytic diseasa of newborn	Yenidoğanın Hemolitik Hastalığı
Unknown	Yeri Bilinmeyen
Public Health Laboratory of Province	İl Halk Sağ.Laboratuvarı
Drug dependence	İlaç Alışkanlığı
Gn.Dir.of Pharmacy and Pharm	İlaç ve Eczacılık Gn.Md.
Public Health Laboratory of District.	İlçe Halk Sağlık Laboratuvarı
First Aid and Emer.Nurs.	İlk Yrd.Acil.Bak.H.
Inflammatory diseases of eye	İltahaplı Göz Hastalıkları
Incidence	İnsidans
Travelling Expenses	Yolluklar
Ischaemic heart disease	İskemik Kalp Hastalığı
Yüksek  htisas  Hospital	Yüksek İhtisas Hastanesi
Ovarium	Yumurtalık
Pneumonia	Zatürre
Mental retardation	Zeka Geriliği
Veneral Diseases Hospital	Zührevi Hastalıklar Hast.
Bites of suspicion animals	Şüpheli Hayvan Isırıkları
Angular Tip	Açılı Uç
Acute Cardiac Ischemia Time-Insensitive Predictive (ACI-TIPI)	Akut Kardiyak İskemi Zaman Duyarsız Tahmin Cihazı
Flow Diagram	Akış Diyagramı
Forehead Lamp	Alın Lambası
Motherboard	Anakart
Anode Heating Capacity	Anod Isı Kapasitesi
Apertures	Apertür
Apnea	Apne
Laryngoscope	Aringoskop
Arrhythmia	Aritmi
Hanger Bar	Askılık
Aspiration Catheter	Aspirasyon Kateteri
Foot Pedal	Ayak Pedalı
Release And Capture Mechanism	Ayrılma ve Tutma Mekanizması
Band Width	Bant Genişliği
Pressure Gradient	Basınç Gradiyenti
Cerebral Hemorrhage	Beyin Kanaması
Bipap (Bi-Level Positive Airway Pressure)	Bibap
Automated Computerized Perimeter	Bilgisayarlı Otomatik Görme Alanı Cihazı
Scalpel Handle	Bistüri Sapı
Cervix	Boyun
Bronchoscopy	Bronkoskopi
Bronchoscopic Alligator Forceps	Bronkoskopik Alligatör Forsebs
C-Arm Mount	C-Kol Statifi
Glass Window Plug	Cam Pencere Tıpa
Life-Saving Tube	Cankurtaran Tüpü
Diagonal Size	Çapraz Büyüklük
Clars Mirror	Clar Aynası
Refuse Bag	Çöp Torbası
Cardio-Pulmonary Resuscitation	CPR
Cranio-Caudal	CRAN/CAUD
External Fixation Light	Dahili Fiksasyon Işığı
Wave Length	Dalga Boyu
Vein Diameter	Damar Çapı
Defibrillation Protection	Defibirilasyon  Koruması
Disinfection	Dezenfeksiyon
Digital Angiography System	Digital Anjiografi Sistemi
Digital Imaging Unit	Dijital Görüntüleme Ünitesi
Tongue Depressor	Dil Basacağı
Distal Illumination	Distal Aydınlatma
Notched Lens	Dişli Lens
Physicians Stool	Doktor Taburesi
Touch-Sensitive Programming	Dokunmatik Programlama
Upholster Material	Döşeme Materyali
Straight Forward Telescope	Düz Ve Ileri Görüşlü Teleskop
Stress Test	Efor Test
Exercise ECG System	Eforlu Ekg Sistemi
ECG	EKG
Electric Output	Elektrik Çıkışı
Power Cut	Elektrik Kesintisi
Electrosurgery Unit	Elektrokoter Ünitesi
Scope Holders For Endoscopes	Endoskop Koyma Yeri
Electronystagmography	ENG
Injection Cannula	Enjeksiyon Kanülü
Instrument Guide	Enstrüman Kılavuzu
Threshold Tests	Eşik Testleri
Frequency Doubling Technology Perimetry	FDT
Being Unplugged	Fişten Çıkmak
Frequency Response	Frekans Cevabı
Real-Time ECG	Gerçek Zaman EKGsi
Input Impedance	Giriş Empedansı
Obstruction Free Light Transmission	Gölgesiz Aydınlatma
Visual Field	Görme Alanı
Image Intensifier	Görüntü Kuvvetlendirici
Ophthalmology	Göz Hastalıklarını Inceleyen Bilim
Halogen Lamp	Halojen Lambası
Sliding	Hareketli-Kızaklı
Patient Tracking File	Hasta Takip Dosyası
Bedside Table	Hastabaşı Komodini
Bed-Head Unit	Hastabaşı Ünitesi
Towel Forceps	Havlu Forseps
Nurse Call System	Hemşire Çağrı Sistemi
Service Sufficiency Certificate	Hizmet Yeterlilik Belgesi
Heart Pulse Rate Variance	HRV( Kalp Atım Hızı Değişkenliği)
IBM-Compatible	IBM Uyumlu
Heart Rate Slope	Kalp  Hizi Eğimi
Heart Pulse Tone Sound	Kalp Atım Ton Sesi
Circular Heart Pulse Graphic	Kalp Atımı Dairesel Grafiği
Channel Invasive Blood Pressure	Kanal İnvaziv Kan Basıncı
Hemorrhage	Kanama
Cardio Pulmonary Exercise Device	Kardio Pulmoner Egzersiz Cihazı
Muscle Artifact Eliminating Filter	Kas Kasılmalarından Kaynaklanan Artifakları Giderici Filtre
Groin	Kasık
Catheter Room	Kateter Odası
Non-Skid Rubber Tip	Kaydırmayan Lastik Uç
Brow Rest	Kaş Desteği
ORL(Oto-Rhino-Laryngology)	KBB (Kulak-Burun-Boğaz)
Keyhole Opening	Keyhole Açıklığı
Kinetic Test	Kinetik Test
Armrest	Kolçak
Castor	Koltuk, Masa Gibi Mobilyalara Takılan Tekerlek
Guard-Rail	Korkuluk (Sedye Korkuluğu)
Corrosion-Resistant Material	Korozyona Dirençli
Treadmill Slope	Koşu Bandı Eğimi
Ear Irrigation Unit	Kulak Irrigasyon Ünitesi
Ear Speculum, Specula (P.)	Kulak Spekulumu
Pointed, Sharp	Künt
Lead Covered Glass	Kurşunlu Cam
Lead Covered Apron	Kurşunlu Önlük
Distortion-Free	Kırpışmasız
Curved	Kıvrımlı
Laryngectomy Scissors	Laryngectomy Makası
Rubber Telescope Guide	Lastik Teleskop Kılavuzu
Rubber Head Rigid Suction Tubing	Lastik Uclu Rijid Emme Tüpü
Late Potential	LP(Geç Potansiyel)
Magnetic Locking Mechanism	Manyetik Kilitleme
Hinge	Menteşe
Central Locking/Steering System	Merkezi Kilitleme/Seyir Sistemi
Monoplane Angiography	Monoplan Angiografi
Monopolar Cutting And Coagulation	Monopolar Kesme Ve Koagülasyon
Patient Chair	Muayene Koltuğu
Naso-Pharyngoscope	Nazofarengoskop
Nystagmus Spectacles	Nistagmus Gözlüğü
Ophthalmoscope	Oftalmaskop
Optical Coherence Tomography	Optik Koherens Tomografi
Optical Forceps	Optikal Forsebs
Urinal	Ördek
Otoendoscope	Otoendoskop
Autoclaveable	Otoklavlanabilir
Automatic Injector	Otomatik Enjektör
Otoscope	Otoskop
Cotton Carrier	Pamuk Taşıyıcı
Dressing Trolley	Pansuman Arabası
Dressing Forceps	Pansuman Forsepsi
Fiber Optic Cool Light Transmission	Parlama Yapmayan Fiber Optik Aydınlatma
Rust-Proof	Paslanmaz
Stainless Steel	Paslanmaz Çelik
Peanut Grasping Bronchoscopic Forceps	Peanut Kavramak Için Kullanılan Bronkoskopik Forsebs
Perfuser Connection Rod	Perfüzör Bağlantı Çubuğu
Pupil Diameter	Pupil Çapı
Right Anterior Oblique/ Left Anterior Oblique	RAO/LAO
Prong	Retractor Dişi
(Retinal Nerve Fiber Layer)	RNFL
X-Ray Generator	Röntgen Jeneratörü
Stretcher	Sedye
Mattress	Sedye Şiltesi
Secretion Jam	Sekresyon Kavanozu
Serum Hanger	Serum Askısı
Serum Post	Serum Direği
Superluminescent Diode	SLD
Left Ventricular	Sol Ventrikül
Respirator	Solunum Cihazı
Cold Light Source	Soğuk Işık Kaynağı
Coolant Medicine Cupboard	Soğutuculu İlaç Dolabı
Water-Proof	Su Geçirmez
Bedpan	Sürgü
Sliding Board	Sürgülü Bord
Backrest	Sırt Kısmı
Sealing Cap	Sızdırmaz Conta
Baseline Wander Eliminating Filter	Taban Hattı Düzeltme Filtresi
Buffer System	Tampon Sistemi
Scanning Detection Sensitivity	Tarama Algılama Hassasiyeti
Scanning Depth	Tarama Derinliği
Scanning Tests	Tarama Testleri
Thermal Paper	Termal Kağıt
Inverse Trendelenburg Position	Ters Trendelenburg Pozisyonu
Earthed Socket	Topraklı Priz
Dust-Proof Cover	Toz Koruyucu Kılıf
Tracheostomy	Trakeostomi
Thrombocyte Prediction Instrument (TPI)	Trombolit Tahmin Cihazı
Grasping Rail	Tutucu Ray
Non-Flammable	Tutuşmaya Karşı Dirençli
Serrated	Tırtırlı
Conformity Certificate	Uygunluk Belgesi
Video Electronystagmography Tests	Videoelektronistagmografık (VENG) Testler
X-Ray Permeable	X-Işınlarını Geçiren
Flex Suction Tube	Yalıtılmış Emme Tüpü
With Side Grasping Teeth	Yan Isıran Dişli
Side-Rail	Yan Korkuluk (Yatak Korkuluğu)
Overbed Meal Table	Yatak Üstü Yemek Sehpası
Drug And Cure Trolley	İlaç Tedavi Arabası
Inhalation / Exhalation	İnspiryum/ Ekspiryum
Name Plate	İsimlik
High-Resolution	Yüksek Çözünürlük
Flexible Foreign Bodies	Yumuşak Yabancı Cisimler
Isolated ECG Trigger Output	İzoleli EKG Tetikleme Çıkışı
account for	açıklama getirmek
active pharmaceutical ingredients	ilaç etkin maddeleri
active substance	aktif madde
additive	katkı maddesi
administrated	uygulamak (ilaç)
aeration	aerasyon
air handling unit	hava işleme ünitesi
all intents and purposes	hangi açıdan bakılırsa bakılsın
ambient temperature	ortam sıcaklığı
analgesic medicines	analjezik ilaçlar
ancillary	yan, yardımcı
aqueous pores	sulu gözenekler
aseptic processing	aseptik işlem
aseptically	aseptik olarak
atomised liquid	atomize edilmiş sıvı
audit trail	denetleme tarihçesi
autoclave	otoklav
backing paper	koruyucu kağıt
benchmark	karşılaştırmalı değerlendirme
biopharmaceuticals	biyoeczacılık
Blending	Parçalayarak karıştırma
blood stream	kan dolaşımı
breathing apparatus	soluma tertibatı
bring about	meydana getirmek
bulk product	dökme ürün
bulky	hacimli
carbon compound	karbon bileşiği
carton cardboard	karton mukavva
cartonner	mukavva
catalyst	katalizör
check sheet	denetim çizelgesi
clean steam generator	Temiz buhar jeneratörü
clean-in-place	yerinde temizlik
cleaning agents	temizlik maddeleri
close-coupled	yakın bağlantılı
coating	kaplama
Code of Federal Regulations	Federal Yönetmelik Kuralları
coloring agents	renklendiriciler
commensurate	orantılı
comminuted	ufalanmış
common technical document (CTD)	Ortak Teknik Doküman
component	bileşen
compressed air	sıkıştırılmış hava
Compression	Sıkıştırma
container	muhafaza (birincil ambalaj)
contaminants	kirleticiler
cooling agent	soğutucu madde
corrugated board	oluklu mukavva
cough mixtures	öksürük şurubu
cross contamination	çapraz kontaminasyon
degradation	bozunma
delivery system	taşıyıcı sistem
dialysis solutions	diyaliz solüsyonları
dies	kalıplar
dispensing	dağıtım
distillation	damıtma
downstream	işlem sonrası
droplet	damla
droplet size	damlacık büyüklüğü
drug administration	ilaç uygulaması
drug delivery systems	ilaç taşıyıcı sistemler
drug product	müstahzar
drug release	ilaç salımı
drug substance	etkin madde
dry blend	kuru harman
dry heat	kuru ısı
dry powder inhaler	kuru toz inhalasyon aleti
dwell time	durma süresi
effluent	akışkan atık
excipients	ara maddeler
failure mode and effects analysis	Hata Türleri ve Etkileri Analizi
fault tree analysis	hata ağacı analizi
feed-water	besleme suyu
fire fighting	yangınla mücadele
fluidised bed dryer	akışkan yataklı kurutucu
fluting	oluk açma
food and drug administration	gıda ve ilaç dairesi
gastric juices	Mide özsuları
global	küresel
granulating solution	granülasyon çözeltisi
growth medium	yetiştirme ortamı
guide	kılavuz
gut	bağırsak
Hazard	Tehlike
hazard analysis and critical control point	tehlike analizi ve kritik kontrol noktası
hazard operability analysis	tehlike işletilebilirlik analizi
heat transfer fluid	ısı transfer akışkanı
high-efficiency particulate air	yüksek verimli partikül hava filtresi
homogenisers	homojenizatör
immediate release	çabuk salımlı
impregnated	emdirilmiş
increasing scale	ölçeğe göre artan
infusion	enfüzyon
ingredient	içerik
invasive	invazif
ion exchange	iyon değişimi
irradiation	irradiyasyon
jacket vessel	muhafaza kabı
labile	dayanıksız
leaflet	prospektüs
local treatment	lokal tedavi
lubricant	yağlayıcı madde
lyophilised	liyofilize
mammalian	memeli
master batch	Katkı granülü
medium	ortam
metered dose inhaler	ölçülü inhalasyon aleti
mitigate	yumuşatmak
monomeric	monomerik
motive force	harekete geçirme kuvveti
nail	çivi
non-aqueous	suda çözülmeyen
non-viable	cansız
novel	yeni geliştirilmiş
ointment	merhem
overarching	kapsayıcı
overlacquer	üst vernik
palatable	lezzetli
paper strip	kağıt şerit
parenteral	parenteral
parenterals	parenteraller
pharmaceutical dosage forms	farmasötik dozaj formları
phytochemicals	bitkisel ilaçlar
powdered herbs	toz haline getirilmiş bitkiler
pre-filled syringe	kullanıma hazır dolu enjektör
Preliminary hazard aanlysis	Ön Tehlike Analizi
prescription drug	reçeteli ilaç
primary manufacturing	birincil üretim
Process Analytical Technology	Proses Analitik Teknoloji
process water	proses suyu
processing rooms	işlem odaları
product life cycle	ürün hayat çevrimi
punched	zımbalanmak
purified water	saflaştırılmış su
reagent	reaktif
reconciliation	karşılaştırma
reconstitution	sulandırma
recovery rate	kazanım oranı
referred to as	olarak anılacaktır
Regulation	Yönetmelik
regulatory submission	ruhsat başvurusu
requisite	zorunlu
restricted access barriers	sınırlı erişim bariyerleri
reverse osmosis	ters ozmoz
sanitizasyon	sanitizasyon
scale	tortulanma
sealing	kaplama
sealing line	sızdırmazlık hattı
segregation	ayrı depolama
shrink wrap	şrink filmi
site of action	faaliyet bölgesi
solvent extraction	çözücü ekstraksiyonu
starch	nişasta
starting materials	başlangıç maddeleri
static build-up	statik güçlendirme
steriliser	sterilizasyon aleti
sterility assurance level	Sterilite Güvence Seviyesi
storage tank	bekletme tankı
strip	bant
superheat	kızgın ısı
suppository	fitil
sustained release	yavaş salınımlı
systemic circulation	büyük kan dolaşımı
take a reading	ölçüm yapmak
tape vinyl	vinil bant
Temperature maintenance	idame sıcaklığı
terminal sterilisation	terminal sterilizasyon
terminally	son olarak
thermoforming	ısıl şekillendirme
tight junction	sıkı bağlantı
timber	kereste
trains	tertibat
transdermal patch	transdermal flaster
transgenic	transgenik
tub	kap
uncoated	kaplanmamış
unpalatable	nahoş (yenilmesi zor)
upstream	işlem öncesi
utility systems	fenni ve sıhhi tesisat şebekesi
vessel	kap
vial	flakon
Wet granulation	ıslak granülasyon
whole cell	tam hücre
wound	yara
yeasts and moulds	mayalar ve küfler
