( Bruton-type hypogammaglobulinaemia):	φυλοσύνδετη αγαμμασφαιριναιμία τύπου Bruton
5-hydroxytryptamine:	5-υδροξιτρυπταμίνη
β thromboglobulin:	β-θρομβοσφαιρίνη
β2 microglobulin:	β2-μικροσφαιρίνη
γδ T cells:	γδ Τ-κύτταρα
aberrant clone:	απαγορευμένος κλώνος
ABO blood group system:	σύστημα ομάδων αίματος ΑΒΟ
absorption:	απορρόφηση
absorption:	προσρόφηση
accessory cell:	συνοδά κύτταρα
activated lymphocyte:	ενεργοποιημένο λεμφοκύτταρο
activated macrophage:	ενεργοποιημένο μακροφάγο
active immunity:	ενεργητική ανοσία
active immunization:	ενεργητική ανοσοποίηση
acute lymphoblastic leukaemia (ALL):	οξεία λεμφοβλαστική λευχαιμία
acute myeloblastic leukaemia (ΑΜL):	οξεία μυελοβλαστική λευχαιμία
acute phase reactants:	ουσίες οξείας φάσης
acute respiratory distress syndrome (ARDS):	σύνδρομο οξείας αναπνευστικής ανεπάρκειας
Addison's disease:	νόσος του Addison
addressin:	αντρεσίνη
adenosine deaminase deficiency:	ανεπάρκεια απαμινάσης της αδενοσίνης
adhesion molecules:	μόρια προσκόλλησης
adjuvant arthritis:	αρθρίτιδα από ανοσοενισχυτικό
adjuvant disease:	νόσημα από ανοσοενισχυτικό
adjuvant granuloma:	κοκκίωμα από ανοσοενισχυτικό
adjuvant:	ανοσοενισχυτικό
adjuvanticity:	ανοσοενισχυτικότητα
adoptive immunity:	θετή ανοσία
adoptive transfer:	θετή μεταφορά
adult T cell leukaemia/lymphoma:	λευχαιμία/λέμφωμα ενηλίκων από Τ-κύτταρα
AET-rosette test:	δοκιμασία ΑΕΤ-ροδάκων
affinity labelling:	σήμανση συγγένειας
affinity maturation:	ωρίμανση συγγένειας
affinity:	συγγένεια
agammaglobulinaemia:	αγαμμασφαιριναιμία
agglutination:	συγκόλληση
agglutinin:	συγκολλητίνη
agranulocytosis:	ακοκκιοκυττάρωση
AIDS-related complex (ARC):	σύμπλεγμα σχετιζόμενο με το AIDS
albumin:	λευκωματίνη
allelic exclusion:	αποκλεισμός αλληλίων
allergen:	αλλεργιογόνο
allergic alveolitis:	αλλεργική κυψελιδίτιδα
allergic encephalomyelitis:	αλλεργική εγκεφαλομυελίτιδα
allergic response:	αλλεργική απάντηση
allergic rhinitis:	αλλεργική ρινίτιδα
allergy:	αλλεργία
alloantigens:	αλλοαντιγόνα
alloantiserum:	αλλοαντιορός
allogeneic (allogenic):	αλλογονικός
allograft rejection:	απόρριψη αλλομοσχεύματος
allograft:	αλλομόσχευμα
allotope:	αλλότοπος
allotype:	αλλότυπος
allotypic determinant:	αλλοτυπικός καθοριστής
alternative pathway C3 convertase:	C3-κομβερτάση της εναλλακτικής οδού
alternative pathway:	εναλλακτική οδός
aluminium adjuvants:	ανοσοενισχυτικά αργιλίου
alveolar macrophage:	κυψελιδικά μακροφάγα
amyloidosis:	αμυλοείδωση
anamnestic response:	αναμνηστική απάντηση
anaphylactic shock:	αναφυλακτική καταπληξία
anaphylactoid reaction:	αναφυλακτοειδής αντίδραση
anaphylatoxin inactivator:	αδρανοποιητής αναφυλατοξίνης
anaphylatoxins:	αναφυλατοξίνες
anaphylaxis:	αναφυλαξία
anergy:	ανεργία
ankylosing spondylitis:	αγκυλωτική σπονδυλίτιδα
annexin:	αννεξίνη
anti globulin test:	βλέπε antiglobulin test
anti idiotype antibody:	αντιιδιοτυπικό αντίσωμα
anti idiotype vaccine:	αντιιδιοτυπικό εμβόλιο
anti neutrophil cytoplasmic antibody (ANCA):	αντισώματα έναντι του κυτταροπλάσματος των ουδετεροφίλων
anti nuclear antibody:	αντιπυρηνικό αντίσωμα
anti venom:	αντιοφικός ορός
antibody (ab):	αντίσωμα
antibody combining site: θέση	σύνδεσης αντισώματος
antibody deficiency syndrome:	σύνδρομο ανεπάρκειας αντισωμάτων
antibody excess:	περίσσεια αντισώματος
antibody half-life:	χρόνος ημίσειας ζωής αντισώματος
antibody-dependent cell-mediated cytotoxicity (ADCC):	αντισωματοεξαρτώμενη δια κυττάρων επιτελούμενη
antigen (ag):	αντιγόνο
antigen - antibody complex:	σύμπλεγμα αντιγόνου - αντισώματος, συν. ανοσοσύμπλεγμα
antigen - binding capacity:	ικανότητα σύνδεσης αντιγόνου
antigen - binding site:	θέση σύνδεσης αντιγόνου
antigen adjuvent (immunological adjuvent):	ανοσοενισχυτικό
antigen excess:	περίσσεια αντιγόνου
antigen gain:	\κέρδος\ αντιγόνου (απόκτηση νέων επιτόπων)
antigen presentation:	παρουσίαση αντιγόνου
antigen proccessing:	επεξεργασία αντιγόνου
antigen-presenting cell (APC):	αντιγονοπαρουσιαστικό κύτταρο
antigenic competition:	αντιγονικός ανταγωνισμός
antigenic deletion:	αντιγονική εξάλειψη
antigenic determinant:	αντιγονικός καθοριστής
antigenic drift:	αντιγονική απόκλιση
antigenic modulation:	αντιγονική διαμόρφωση
antigenic profile:	αντιγονικό προφίλ
antigenic reversion:	αντιγονική αναστροφή
antigenic shift:	αντιγονική εκτροπή
antigenic variation:	αντιγονική ποικιλότητα
antigenicity (συν. immunogenicity):	αντιγονικότητα (ανοσογονικότητα)
antiglobulin test:	δοκιμασία αντισφαιρίνης
antinuclear antibody:	βλ. anti nuclear antibody
antiserum:	αντιορός
antitoxin:	αντιτοξίνη
antivenom:	βλ. anti venom
apoptosis:	απόπτωση
aquired immune deficiency syndrome (AIDS):	σύνδρομο επίκτητης ανοσιακής ανεπάρκειας
aquired immunity:	επίκτητη ανοσία
Arthus reaction:	αντίδραση Arthus
artificially acquired immunity:	τεχνητά επίκτητη ανοσία
association constant:	σταθερά σύνδεσης
asthma:	άσθμα
ataxia telangiectasia:	τηλαγγειεκτασική αταξία
atopic hypersensitivity:	ατοπική υπερευαισθησία
atopic:	ατοπικός
atopy:	ατοπία
attenuated vaccine:	εξασθενημένο εμβόλιο
autoantibody:	αυτοαντίσωμα
autoantigen:	αυτοαντιγόνο
autochthonous:	αυτόχθονος
autofluorescence:	αυτοφθορισμός
autograft:	αυτομόσχευμα
autoimmune disease:	αυτοάνοσο νόσημα
autoimmunity:	αυτοανοσία
autologous:	αυτόλογος
autoradiography:	αυτοραδιογραφία
autoreactive lymphocytotoxic antibody:	αυτοαντιδρόν λεμφοκυτταροτοξικό αντίσωμα
autosensitization:	αυτοευαισθητοποίηση
avidity:	ισχύς σύνδεσης αντιγόνου - αντισώματος
axenic:	αξενικός
azurophil granule:	αζουρόφιλο κοκκίο
B lymphocyte receptor:	υποδοχέας Β-λεμφοκυττάρου
B lymphocyte repertoire:	ρεπερτόριο Β-λεμφοκυττάρων
B lymphocyte:	Β-λεμφοκύτταρο
bacille Calmette-Guerin (BCG):	βάκιλλος Calmette-Guerin
bacterial agglutination:	βακτηριακή συγκόλληση
bacteriolysis:	βακτηριόλυση
bacteriophage neutralization test:	βλ. phage neutralization test
bare lymphocyte syndrome:	σύνδρομο γυμνού λεμφοκυττάρου
basement membrane antibody:	αντίσωμα έναντι βασικής μεμβράνης
basophil degranulation test:	δοκιμασία αποκοκκίωσης βασεοφίλων
basophil leucocyte:	βασεόφιλο λευκοκύτταρο
beige mouse:	μπεζ ποντικός
Bence-Jones protein:	πρωτείνη Bence-Jones
benign monoclonal gammopathy:	καλοήθης μονοκλωνική γαμμαπάθεια
berylliosis:	βηρυλλίωση
bi-specific antibody molecule:	βλ. bispecific antibody molecule
binding constant:	σταθερά σύνδεσης
binding site:	θέση σύνδεσης
biochemical sequestration:	βιοχημική απομόνωση
biotin/avidin/streptavidin system:	σύστημα βιοτίνης/αβιδίνης/στρεπταβιδίνης
bird fancier's lung:	πνεύμονας των πτηνοτρόφων
bispecific antibody molecule:	αντισωματικό μόριο διπλής ειδικότητας
blast cell:	βλαστικό κύτταρο
blast transformation:	βλαστική μεταμόρφωση
blocking antibody:	δεσμευτικό αντίσωμα
blood group substance:	ουσίες ομάδων αίματος
blood group:	ομάδα αίματος
bone marrow:	μυελός των οστών
booster dose:	αναμνηστική δόση
bovine gamma globulin (BGG):	βόειος γ-σφαιρίνη
bovine serum albumin (ΒSA):	λευκωματίνη βόειου ορού
Boyer chamber:	θάλαμος Boyer
bradykinin:	βραδυκινίνη
brochus associated lymphoid tissue (BALT):	λεμφικός ιστός των βρόγχων
Bruton type hypogammaglobulinaemia:	υπογαμμασφαιριναιμία τύπου Bruton
buffy coat:	λευκή στιβάδα
Burkitt's lymphoma:	λέμφωμα του Burkitt
bursa of Fabricius:	θύλακας του Fabricius
bursectomy:	θυλακεκτομή
byssinosis:	βυσσίνωση
bystander lysis:	παρατυγχάνουσα λύση
bystander phenomena:	παρατυγχάνοντα φαινόμενα
C reactive protein:	C-αντιδρώσα πρωτείνη
C region:	C-περιοχή
C1 inhibitor (C1INH):	αναστολέας της C1-εστεράσης
calcineurin:	καλσινευρίνη
capping:	καλύπτρα
capsular polysaccharide:	πολυσακχαρίτης ελύτρου
carbon clearance test:	δοκιμασία κάθαρσης άνθρακα
cardiolopin antibodies:	αντικαρδιολιπινικά αντισώματα
carrier specificity:	ειδικότητα φορέα
carrier:	φορέας
cascade reaction:	αντίδραση καταρράκτη
Ηassall's corpuscles:	σωμάτια Hassall
CD antigens:	CD-αντιγόνα
cell cooperation:	κυτταρική συνεργασία
cell-mediated immunity (CMI):	κυτταροεξαρτώμενη ανοσία
cell-mediated immunity deficiency syndromes:	σύνδρομα ανεπάρκειας της κυτταροεξαρτώμενης ανοσίας
cellular immunity:	κυτταρική ανοσία
central lymphoid organs:	κεντρικά λεμφικά όργανα
centrally acting adjuvants:	κεντρικά δρώντα ανοσοενισχυτικά
centroblast:	κεντροβλάστης
centrocyte:	κεντροκύτταρο
challenge:	πρόκληση
chaperonins:	συνοδές πρωτεϊνες
Chediak-Higashi syndrome:	σύνδρομο Chediak-Higashi
chemiluminencence:	χημειοφωταύγεια
chemoattractant:	χημειοελκτικός
chemokine receptor:	υποδοχέας χημειοκινών
chemokines:	χημειοκίνες
chemokinesis:	χημειοκίνηση
chemotaxis:	χημειοταξία
chimera:	χίμαιρα
chimerism:	χιμαιρισμός
chromium release assay:	δοκιμασία απελευθέρωσης χρωμίου
chronic granulocytic leukaemia:	χρόνια κοκκιοκυτταρική λευχαιμία
chronic granulomatous disease (CGD):	χρόνια κοκκιωματώδης νόσος
chronic lymohocytic leukaemia (CLL):	χρόνια λεμφοβλαστική λευχαιμία
chronic mucocutaneous candidiasis:	χρόνια βλεννοδερματική καντιτίαση
chronic myeloid leukaemia (CML):	χρόνια μυελογενής λευχαιμία
cisternal space:	χώρος δεξαμενής
class I MHC antigens:	αντιγόνα του Μείζονος ΣυμπλέγματοςΙστοσυμβατότητας τάξης Ι
class II MHC antigens:	αντιγόνα του Μείζονος ΣυμπλέγματοςΙστοσυμβατότητας τάξης ΙΙ
class switching:	μεταστροφή τάξης
classical complement pathway:	κλασσική οδός ενεργοποίησης συμπληρώματος
clonal anergy:	κλωνική ανεργία
clonal deletion:	κλωνική εξάλειψη
clonal selection theory:	θεωρία της επιλογής των κλώνων
clonotype:	κλωνότυπος
co-operation:	βλ. cooperation
co-precipitation:	βλ. coprecipitation
co-stimulatory molecules:	βλ. costimulatory molecules
cobra venom:	δηλητήριο κόμπρας
Ηodgkin's disease:	νόσος του Hodgkin
coeliac disease:	κοιλιοκάκη
coelomocyte:	μεσοδερμοκύτταρο
coisogenic strain ( συν. congenic strain ):	συνισογενές (ισογενές στέλεχος)
cold antibody:	ψυχροαντίσωμα
cold haemoglobinuria:	ψυχροαιμοσφαιρινουρία
collagen induced arthritis:	αρθρίτιδα επαγώμενη από κολλαγόνο
collectins:	συλλεκτίνες
colony forming unit (CFU):	μονάδα σχηματισμού αποικίας
colony stimulating factors:	παράγοντες διεγερτικοί αποικιών
colostrum:	πύαρ
combined immunodeficiency:	συνδυασμένη ανοσοανεπάρκεια
combining site:	θέση σύνδεσης
committed cell:	δεσμευμένο κύτταρο
common variable antibody deficiency:	βλ. common variable immuno-deficiency
common variable immunodeficiency:	κοινή ποικίλλουσα ανοσοανεπάρκεια
complement activation:	ενεργοποίηση συμπληρώματος
complement control protein superfamily (CCP):	υπεροικογένεια ρυθμιστικών πρωτεϊνών του συμπληρώματος
complement deficiency states:	ανεπάρκειες συμπληρώματος
complement fixation inhibition test:	δοκιμασία αναστολής σύνδεσης συμπληρώματος
complement fixation test (CFT):	δοκιμασία σύνδεσης συμπληρώματος
complement fixation:	σύνδεση συμπληρώματος
complement fixing antibody:	αντίσωμα συνδέον το συμπλήρωμα
complement inhibitors:	αναστολείς συμπληρώματος
complement:	συμπλήρωμα
complementarity determining regions (CDR):	περιοχές καθορίζουσες τη συμπληρωματικότητα
complete Freund's adjuvant (CFA):	πλήρες ανοσοενισχυτικο Freund
comveratase:	κομβερτάση
concanavalin A (Con A):	κονκαναβαλίνη Α
concomitant immunity:	συνοδός ανοσία
congenic strain:	ισογενές στέλεχος
conglutination:	συσσυγκόλληση
conglutinin:	συσσυγκολλητίνη
conjugate:	συζεύκτης
constant region:	σταθερή περιοχή
contact dermatitis:	δερματίτιδα εξ επαφής
contact hypersensitivity:	υπερευαισθησία εξ επαφής
convalescent serum:	ορός αναρρωνύοντος
conventional animals:	συμβατικά ζώα
conventional B lymphocyte:	συμβατικό Β-λεμφοκύτταρο
Coomb's test:	δοκιμασία Coomb's
cooperation:	συνεργασία
coprecipitation:	συγκαθίζηση
costimulatory molecules:	συνδιεγερτικά μόρια
counter current immunoelecrophoresis (CIE):	αντίθετη ανοσοηλεκτροφόρηση
cowpox:	δαμαλίτιδα
cross absorption:	διασταυρούμενη απορρόφηση
cross matching:	διασταύρωση
cross reacting antibody:	αντίσωμα με διασταυρούμενες αντιδράσεις
cross reacting antigen:	αντιγόνο με διασταυρούμενες αντιδράσεις
cross reactive group (CREG):	ομάδα με διασταυρούμενες αντιδράσεις
cross sensitivity:	διασταυρούμενη ευαισθησία
cross tolerance:	διασταυρούμενη ανοχή
cryoglobulin:	κρυοσφαιρίνη
Cunningham plaque technique:	τεχνική πλάκας Cunningham
cutaneous basophil hypersensitivity:	δερματική βασεόφιλη υπερευαισθησία
cutaneous sensitization:	δερματική ευαισθητοποίηση
cyclophilin:	κυκλοφιλίνη
cyclophosphamide:	κυκλοφωσφαμίδη
cyclosporin A (CyA):	κυκλοσπορίνη Α
cytokine receptor superfamily:	υπεροικογένεια υποδοχέων κυτταροκινών
cytokines:	κυτταροκίνες
cytolytic T lymphocyte:	κυτταρολυτικό T-λεμφοκύτταρο
cytotoxic T lymphocyte:	κυτταροτοξικό T-λεμφοκύτταρο
cytotoxicity tests:	δοκιμασίες κυτταροτοξικότητας
dander antigen:	αντιγόνο λεπιών δέρματος
dark zone:	σκοτεινή ζώνη
decay accelerating factor (DAF):	παράγοντας επιταχύνων τη διάσπαση
decomplementation:	αδρανοποίηση συμπληρώματος
defensin:	ντεφενσίνη
delayed cell-mediated reaction:	επιβραδυνόμενη δια κυττάρων επιτελούμενη αντίδραση
delayed cutaneous reaction:	επιβραδυνόμενη δερματική αντίδραση
delayed hypersensitivity:	βλ. delayed-type hypersensitivity
delayed-type hypersensitivity (DTH):	υπερευαισθησία επιβραδυνομένου τύπου
density gradient certifugation:	φυγοκέντρηση πρανούς πυκνότητας
dentritic cell:	δενδριτικό κύτταρο
desensitization: βλ. και hyposensitization,	απευαισθητοποίηση
despecification:	απεξειδίκευση
determinant:	καθοριστής
dextrans:	δεξτράνες
Di George syndrome:	σύνδρομο Di George
dialysis:	διαπήδηση
diphtheria antitoxin:	διφθεριτική αντιτοξίνη
diphtheria toxoid:	διφθεριτικό τοξοειδές
direct immunofluorescence:	άμεσος ανοσοφθορισμός
disodium cromoglycate:	χρωμογλυκολικό δινάτριο
dissociatiοn constant (Kd):	σταθερά διάστασης
diversity:	ποικιλότητα
domain:	πεδίο
dot blotting:	αποτύπωση κηλίδας
double diffusion test:	δοκιμασία διπλής διάχυσης
double labelling:	διπλή σήμανση
double layer immunofluorescence:	τεχνική ανοσοφθορισμού διπλής στιβάδας
double-negative thymocytes:	διπλά αρνητικά θυμοκύτταρα
double-positive thymocytes:	διπλά θετικά θυμοκύτταρα
doubling dilution:	διπλάσια αραίωση
drug allergy:	φαρμακευτική αλλεργία
dye exclusion test:	δοκιμασία αποκλεισμού χρωστικής
E-rosette forming cell:	κύτταρο που σχηματίζει Ε-ρόδακες
EAC-rosette forming cell:	λεμφοκύτταρο που σχηματίζει EAC-ρόδακες
eczema:	έκζεμα
effector cell:	δραστικό κύτταρο
effector lymphocyte:	δραστικό λεμφοκύτταρο
Ehrlich's side chain theory:	θεωρία πλευρικών αλυσίδων του Ehrlich
elicited macrophage:	αποσπώμενο μακροφάγο
ellipsoids:	ελλειψοειδή
emperipolesis:	ενδοπεριπολία
encapsulation:	εγκύστωση
encephalitogenic factors:	εγκεφαλιτογόνοι παράγοντες
end cell:	τελικό κύτταρο
end point:	τελικό σημείο
endocytosis:	ενδοκυττάρωση
endoplasmic reticulum:	ενδοπλασματικό δίκτυο
endotoxin shock:	καταπληξία από ενδοτοξίνη
endotoxin:	ενδοτοξίνη
enhancement:	ενίσχυση
enzyme labelling:	σήμανση με ένζυμο
enzyme-linked immunosorbent assay (ELISA):	ενζυμικός ανοσοπροσροφητικός προσδιορισμός
eosinophil chemotactic factors of anaphylaxis (ECF-A):	χημειοτακτικός παράγοντας της αναφυλαξίας για τα ηωζινόφιλα
eosinophil leucocyte:	ηωζινόφιλο λευκοκύτταρο
eosinophilia:	ηωζινοφιλία
epithelioid cell:	επιθηλιοειδές κύτταρο
epitope:	επίτοπος
epitype:	επίτυπος (οικογένεια συγγενών επιτόπων)
equilibrium dialysis:	ισόρροπη διαπίδυση
equivalence:	ισοδυναμία
erythroblastosis fetalis:	εμβρυική ερυθροβλάστωση
exon:	εξόνιο
exotoxin:	εξωτοξίνη
experimental allergic encephalomyelitis (EAE):	πειραματική αλλεργική εγκεφαλομυελίτιδα
experimental allergic neuritis:	πειραματική αλλεργική νευρίτιδα
experimental allergic thyroiditis:	πειραματική αλλεργική θυρεοειδίτιδα
extractable nuclear antigens (ENAs):	εκχυλιζόμενα πυρηνικά αντιγόνα
extrinsic allergic alveolitis:	εξωγενής αλλεργική κυψελίτιδα
pregnancy and lactation	Κύηση και γαλουχία
FAB fragmant: FAB-	τμήμα FAB-
farmer's lung:	πνεύμονας αγρότου
Farr test:	δοκιμασία Farr
Fc fragment: Fc-	τμήμα Fc
Fc receptor: Fc-	υποδοχέας Fc-
ferritin labelling:	σήμανση με φερριτίνη
first set rejection:	πρώτη απόρριψη
flagellin:	φλαγκελλίνη
flow cytometry:	κυτταρομετρία ροής
fluorescein antibody technique:	τεχνική φθοριζόντων αντισωμάτων
fluorescein isothiocyanate (FITC):	ισοθειοκυανική φθορισεϊνη
fluorescein labelled antibody:	αντίσωμα σημασμένο με φθορισεϊνη
fluorescein:	φθορισεϊνη
fluorescence activated cell sorter (FACS):	κυτταρομετρητής διαχωριστής φθορισμού
fluorochrome:	φθοριόχρωμα
fluorography:	φθοριογραφία
follicle:	οζίδιο
follicular dendritic cell (FDC):	λεμφοζιδιακό δενδριτικό κύτταρο
follicular hyperplasia:	λεμφοζιδιακή υπερπλασία
follicular mantle:	βλ. mantle zone
food allergy:	τροφική αλλεργία
forbidden clone:	απαγορευμένος κλώνος
formyl peptides:	μυρμηκικά πεπτίδια
Forssman antigen:	αντιγόνο Forssman
framework region:	περιοχή-σκελετός
freemartin:	φριμαρτικό
Freund's adjuvant:	ανοσοενίσχυτικό Freund
functional affinity:	λειτουργική συγγένεια
functional immunity:	λειτουργική ανοσία
gamma (γ) globulin:	γ-σφαιρίνη
gel diffusion test:	δοκιμασία διάχυσης σε γέλη
gene knockout mouse:	ποντικός με εξουδετερωμένο γονίδιο
germ free:	αξενικό
germinal centre:	βλαστικό κέντρο
germinal follicle:	βλαστικό λεμφοζίδιο
globulin:	σφαιρίνη
glomerulonephritis:	σπειραματονεφρίτιδα
glycosyl-phosphatidylinositol (GPI anchor):	γλυκοζυλ-φωσφατιδυλινοσιτόλη
glycosylation-dependent cell adhesion molecule-1 (GlyCAM-1)	γλυκοζυλιο-εξαρτώμενο μόριο προσκόλλησης-1
Gm allotype:	αλλότυπος Gm
gnotobiotic:	γνωστοβιωτικό
Goodpasture's syndrome:	σύνδρομο Goodpasture
graft rejection:	απόρριψη μοσχεύματος
graft-versus-host disease:	νόσος μοσχεύματος έναντι του ξενιστή
graft-versus-host reaction (GVHR):	αντίδραση μοσχεύματος κατά ξενιστή
granulocyte colony stimulating factor (G-CSF):	παράγοντας διεγερτικός αποικιών κοκκιοκυττάρων
granulocyte colony stimulating factor receptor (G-CSFR):	υποδοχέας παράγοντα διεγερτικού αποικιών κοκκιοκυττάρων
granulocyte-macrophage colony stimulating factor (GM-CSF):	παράγοντας διεγερτικός αποικιών κοκκιοκυττάρων-μακροφάγων
granulocyte-macrophage conoly stimulating	υποδοχέας παράγοντα διεγερτικού αποικιών
granulocyte:	κοκκιοκύτταρο
granuloma:	κοκκίωμα
granzyme:	γρανένζυμο
gut associated lymphoid tissue (GALT):	λεμφικός ιστός εντέρου
H-2 Histocompatibility system:	σύστημα ιστοσυμβατότητας Η-2
H-2 restriction:	περιορισμός H-2
haemagglutination test:	δοκιμασία αιμοσυγκόλλησης
haemagglutination:	αιμοσυγκόλληση
haemagglutinin:	αιμοσυγκολλητίνη
haemocyanin:	αιμοκυανίνη
haemocyte:	αιμοκύτταρο
haemocytoblast:	αιμοκυτοβλάστη
haemolysin:	αιμολυσίνη
haemolysis:	αιμόλυση
haemolytic anaemia:	αιμολυτική αναιμία
haemolytic disease of the newborn:	αιμολυτική νόσος του νεογνού
haemolytic plaque test:	δοκιμασία αιμολυτικής πλάκας
haemolytic system:	αιμολυτικό σύστημα
haemopoietic growth factors:	αυξητικοί παράγοντες αιμοποίησης
haemopoietin receptor family:	οικογένεια υποδοχέων της αιμοποιητίνης
haplotype:	απλότυπος
hapten inhibition test:	δοκιμασία αναστολής απτίνης
hapten:	απτίνη
haptotaxis:	απτοταξία
Hashimoto's thyroiditis:	θυροειδίτιδα Hasimoto
HAT (hypoxanthin, aminopterin, thymidin) selection:	επιλογή HAT
hay fever:	πυρετός εκ χόρτου
heat aggregated protein antigen:	θερμoσυσσωματωμένο πρωτεϊνικό αντιγόνο
heat inactivation:	αδρανοποίηση με θέρμανση
heat shock proteins (HSP):	πρωτεϊνες θερμικού shock
heavy chain class:	τάξη βαριάς αλυσίδας
heavy chain disease:	νόσος βαριάς αλυσίδας
heavy chain:	βαριά αλυσίδα
helper T lymphocyte:	βοηθητικό T-λεμφοκύτταρο
hemagglutination:	αιμοσυγκόλληση
herd immunity:	ανοσία πληθυσμού
hereditary angio-oedema:	κληρονομικό αγγειοοίδημα
heteroclitic antibody:	ετερόκλητο αντίσωμα
heterogeneic:	ετερογενής
heterograft:	ετερομόσχευμα
heterologous carrier vaccine:	εμβόλιο με ετερόλογο φορέα
heterologous vaccine:	ετερόλογο εμβόλιο
heterologous:	ετερόλογος
heterospecific:	ετεροειδικός
heterotopic graft:	ετερότοπο μόσχευμα
hidden determinant:	κρυμμένος επίτοπος
high dose tolerance:	ανοσοανοχή υψηλής δόσης
high endothelial venule (HEV):	φλεβίδιο με υψηλό ενδοθήλιο
high responder:	υψηλός απαντητής
hinge area:	αρθρωτή περιοχή
histamine:	ισταμίνη
histiocyte:	ιστιοκύτταρο
histocompatibility antigen:	αντιγόνο ιστοσυμβατότητας
histocompatibility gene:	γονίδιο ιστοσυμβατότητας
histocompatibility locus:	τόπος ιστοσυμβατότητας
histocompatibility testing:	δοκιμασία ιστοσυμβατότητας
HLA class I locus:	τόπος HLA τάξης Ι
HLA class II locus:	τόπος HLA τάξης ΙΙ
HLA histocompatibility system:	σύστημα ιστοσυμβατότητας HLA
holoxenic:	ολοξενικός
homing receptor:	υποδοχέας επικοισμού
homograft:	ομοιομόσχευμα
homology region:	ομόλογη περιοχή
horror autotoxicus:	αυτοτοξικός τρόμος
house dust allergy:	αλλεργία στη σκόνη σπιτιού
human γ globulin (HGG):	ανθρώπινη γ-σφαιρίνη
human immunodeficiency virus (HIV):	ιός ανοσοανεπάρκειας του ανθρώπου
human mucosal antigen-1 (HML-1):	αντιγόνο-1 ανθρώπειου βλεννογόνου
human serum albumin (HSA):	λευκωματίνη ανθρώπειου ορού
humanized antibodies:	εξανθρωποποιημένα αντισώματα
humbilical vein endothelial cells (HUVEC):	ενδοθηλιακά κύτταρα της ομφαλίου φλέβας του ανθρώπου
humoral antibody:	χυμικό αντίσωμα
humoral immunity:	χυμική ανοσία
hybrid antibodies:	υβριδικά αντισώματα
hybridoma:	υβρίδωμα
hyper-IgE syndrome:	σύνδρομο υπερ-ΙgΕ
hypergammaglobulinaemia:	υπεργαμμασφαιριναιμία
hyperimmune state:	υπεράνοση κατάσταση
hyperimmunization:	υπερανοσοποίηση
hypersensitivity:	υπερευαισθησία
hypervariable region:	υπερμεταβλητή περιοχή
hypocomplementaemia:	υποσυμπληρωματαιμία
hypogammaglobulinaemia:	υπογαμμασφαιριναιμία
hyposensitization:	υποευαισθητοποίηση
I.P.A.	Independent Physician Association
Ia antigens:	αντιγόνα Ιa
Μalpighian body (Malpighian corpuscle):	Μαλπιγγιανό σωμάτιο
identity, reaction of:	αντίδραση ταυτότητας
idiopathic thrombocytopenic purpura (ITP):	ιδιοπαθής θρομβοπενική πορφύρα
idiotope:	ιδιότοπος
idiotype:	ιδιότυπος
idiotypic determinant:	ιδιοτυπικός καθοριστής
Ig superfamily:	υπεροικογένεια ανοσοσφαιρινών
IgA deficiency:	ανεπάρκεια της ανοσοσφαιρίνης Α
IgG subclass deficiency:	ανεπάρκεια υποτάξεων ανοσοσφαιρίνης G
IL-2R antagonist:	ανταγωνιστής υποδοχέα IL-2
οligosaccharide determinant:	ολιγοσακχαριτικός καθοριστής
immediate hypersensitivity:	άμεση υπερευαισθησία
immobilization test:	δοκιμασία ακινητοποίησης
immune adherence:	ανοσοπροσκόλληση
immune clearance:	ανοσοκάθαρση
immune complex disease:	νόσημα από ανοσοσυμπλέγματα
immune complex:	ανοσοσύμπλεγμα
immune cytolysis:	ανοσοκυτταρόλυση
immune elimination:	ανοσοεξάλειψη
immune exclusion:	ανοσοαποκλεισμός
immune haemolysis:	ανοσοαιμόλυση
immune response gene (Ir):	γονίδιο ανοσοαπάντησης
immune response:	ανοσοαπάντηση
immune serum:	ανοσοορός
immune state:	ανοσιακή κατάσταση
immune tolerance:	ανοσοανοχή
immune:	άνοσος
immunity deficiency syndrome (immunodeficiency):	σύνδρομο ανοσοανεπάρκειας
immunity:	ανοσία
immunization:	ανοσοποίηση
immunize:	ανοσοποιώ
immunoblotting:	ανοσοαποτύπωση
immunoconglutinin:	ανοσοσυσσυγκολλητίνη
immunodeficiency:	ανοσοανεπάρκεια
immunodiffusion:	ανοσοδιάχυση
immunodominance:	ανοσοεπικράτηση
immunoelectrphoresis:	ανοσοηλεκτροφόρηση
immunoferritin technique:	τεχνική ανοσοφερριτίνης
immunofluorescence:	ανοσοφθορισμός
immunogen:	ανοσογόνο
immunogenic:	ανοσογονικός
immunogenicity:	ανοσογονικότητα
immunoglobulin class:	τάξη ανοσοσφαιρίνης
immunoglobulin domain:	πεδίο ανοσοσφαιρίνης
immunoglobulin gene:	γονίδιο ανοσοσφαιρίνης
immunoglobulin subclass:	υπόταξη ανοσοφαιρίνης
immunoglobulin superfamily:	υπεροικογένεια ανοσοσφαιρινών
immunoglobulin:	ανοσοσφαιρίνη
immunogold labelling:	ανοσοσήμανση με χρυσό
immunological barrier:	ανοσολογικός φραγμός
immunological competence:	ανοσοαρμοδιότητα
immunological deficiency state:	κατάσταση ανοσοανεπάρκειας
immunological enhancement:	ανοσοενίσχυση
immunological inertia:	ανοσοαδράνεια
immunological memory:	ανοσιακή μνήμη
immunological reaction:	ανοσοαντίδραση
immunological rejection:	ανοσοαπόρριψη
immunological surveillance:	ανοσοεποπτεία
immunological tolerance:	ανοσοανοχή
immunological unresponsivevess:	απουσία ανοσοαπάντησης
immunological:	ανοσολογικός
immunophilins:	ανοσοφιλίνες
immunopotentiation:	ανοσοενίσχυση
immunoprophylaxis:	ανοσοπροφύλαξη
immunosupression:	ανοσοκαταστολή
immunotherapy:	ανοσοθεραπεία
immunotoxin:	ανοσοτοξίνη
in situ hybridization:	in situ υβριδισμός
inactivated vaccine:	αδρανοποιημένο εμβόλιο
inactivation:	αδρανοποίηση
inbred strain:	στέλεχος από ενδοικογειακή διασταύρωση
incompatibility:	ασυμβατότητα
incomplete Freund's adjuvant:	μη πλήρες ανοσοενισχυτικό Freund
indirect complement fixation test:	έμμεση δοκιμασία σύνδεσης του συμπληρώματος
indirect immunofluorescence:	έμμεσος ανοσοφθορισμός
inducible nitric oxide synthetase (INOS):	επαγώγιμη συνθετάση νιτρικού οξειδίου
inductive phase:	επαγωγική φάση
infantile sex-linked hypogammaglobulinaemia:	βρεφική φυλοσύνδετη υπογαμμασφαιριναιμία
infectious mononucleosis:	λοιμώδης μονοπυρήνωση
inflammatory cell:	φλεγμονώδες κύτταρο
inhibition tests:	δοκιμασίες αναστολής
innate immunity:	σύμφυτη ανοσία
inoculation:	ενοφθαλμισμός
instructive hypotheses of antibody production:	καθοδηγητικές υποθέσεις της αντισωματοπαραγωγής
insulin dependent diabetes mellitus:	ινσουλινοεξαρτώμενος σακχαρώδης διαβήτης
intercellular adhesion molecule (ICAM):	μεσοκυττάρια μόρια προσκόλλησης
interdigitating cell:	διαπλεκόμενο κύτταρο
interferon (IFN):	ιντερφερόνη
interleukin (IL):	ιντερλευκίνη
internal image:	εσωτερικό είδωλο
International Unit of Immunological Activity:	Διεθνής Μονάδα Ανοσολογικής Δραστηριότητας
intraepithelial lymphocyte:	ενδοεπηθηλιακό λεμφοκύτταρο
intrinsic affinity:	ενδογενής συγγένεια
intron:	ιντρόνιο
invariant chain (Ii):	σταθερή αλυσίδα
iontergrin superfamily:	υπεροικογένεια ιντεργκρινών
irradiation chimera:	χίμαιρα δι' ακτινοβολίας
isoantigen:	ισοαντιγόνο
isoelectric focusing:	ισοηλεκτρική εστίαση
isogeneic (isogenic):	ισογενής
isograft (syngeneic graft):	ισομόσχευμα
isohaemagglutinin:	ισοαιμοσυγκόλληση
isoimmunization:	ισοανοσοποίηση
isologous:	ισόλογος
isotype switching:	ισοτυπική μεταστροφή
isotype:	ισότυπος
isotypic variation:	ισοτυπική παραλλαγή
α chain disease:	νόσημα των α-αλυσίδων
γ chain disease:	νόσος γ-αλυσίδων
κ chain:	αλυσίδα κ
λ chain:	αλυσίδα λ
walker	περπατητήρα
Jennerian vaccination:	εμβολιασμός κατά Jenner
Jerne plaque technique:	τεχνική πλακών κατά Jerne
Job's syndrome:	σύνδρομο Job
Jones-Mote reaction:	αντίδραση Jones-Mote
K cell (K [ADCC] cell, killer cell):	κύτταρο Κ (κύτταρο-φονέας)
kallikreins:	καλλικρεϊνες
Kd (dissociation constant):	σταθερά διάστασης
killed vaccine:	βλ. inactivated vaccine
killer cell:	κύτταρο φονέας
kinins:	κινίνες
knockout mouse:	βλ. gene knockout mouse
Koch's phenomenon:	φαινόμενο Koch
Kupffer cell:	κύτταρο Kupffer
Kurloff cell:	κύτταρο Kurloff
L chain:	βλ. light chain
lamina propria:	χόριο του βλεννογόνου
Langerhans cell:	κύτταρο Langerhans
large granular lymphocyte (LGL):	μεγάλο κοκκιώδες λεμφοκύτταρο
late phase reaction:	αντίδραση βραδείας φάσης
lattice hypothesis:	υπόθεση δικτύου
lazy leukocyte syndrome:	σύνδρομο του νωθρού λεμφοκυττάρου
leader peptide:	οδηγό πεπτίδιο
lectin:	λεκτίνη
leucocyte (leukocyte):	λευκοκύτταρο
leucocyte adhesion deficiency (leucocyte adhesion defect, LAD)	ανεπάρκεια προσκόλλησης λευκοκυττάρων
leucocyte common antigen:	κοινό αντιγόνο των λευκοκυττάρων
leucocytosis:	λευκοκυττάρωση
leukocyte:	βλ. leucocyte
leukotrienes:	λευκοτριένες
ligand:	συνδέτης
light chain subtype:	υπότυπος ελαφράς αλυσίδας
light chain type:	τύπος ελαφράς αλυσίδας
light chain:	ελαφρά αλυσίδα
light zone:	ελαφρά ζώνη
limiting dilution assay:	δοκιμασία οριακής αραίωσης
limiting dilution:	οριακή αραίωση
linkage disequilibrium:	διαταραχή ισορροπίας σύνδεσης
lipocortin (annexin):	λιποκορτίνη (αννεξίνη)
lipopolysaccharide (LPS):	λιποπολυσακχαρίτης
liposome:	λιποσωμάτιο
live vaccine:	ζωντανό εμβόλιο
low dose tolerence:	ανοσοανοχή χαμηλής δόσης
low responder:	χαμηλός απαντητής
lupus erythematosus:	ερυθηματώδης λύκος
lupus erythymatosus cell (LE cell):	κύτταρο ερυθυματώδους λύκου
lymph node:	λεμφαδένας
lymph:	λέμφος
lymphoblast:	λεμφοβλάστης
lymphocyte activation:	ενεργοποίηση λεμφοκυττάρων /ου
lymphocyte recirculation:	επανεκυκλοφορία λεμφοκυττάρων
lymphocyte transformation:	μεταμόρφωση λεμφοκυττάρων
lymphocyte:	λεμφοκύτταρο
lymphocytosis:	λεμφοκυττάρωση
lymphoid cell series:	λεμφοειδής κυτταρική σειρά
lymphoid cell:	λεμφοειδές κύτταρο
lymphoid follicle:	λεμφοειδές οζίδιο
lymphoid tissues:	λεμφοειδείς ιστοί
lymphokine activated killer cells (LAK):	ενεργοποιημένα με λεμφοκίνη κύτταρα-φονείς
lymphokine:	λεμφοκίνη
lymphoma:	λέμφωμα
lymphoreticular tissue:	συν. lymphoid tissue
lymphotοxin (LT):	λεμφοτοξίνη
lynphocytic choriomeningitis (LCM):	λεμφοκυτταρική χοριομηνιγγίτιδα
lysin:	λυσίνη
Lysosome:	λυσόσωμα
lysozyme:	λυσοζύμη
macroglobulin:	μακροσφαιρίνη
macroglobulinaemia:	μακροσφαιριναιμία
macrophage activating factor:	παράγοντας ενεργοποιητικός μακροφάγων
macrophage colony stmulating factor receptor (M-CSFR):	υποδοχέας παράγοντα διεγερτικού αποικιών μακροφάγων
macrophage conoly stimulating factor (M-CSF):	παράγοντας διεγερτικός αποικιών μακροφάγων
macrophage inflammatory proteins (MIPs):	φλεγμονώδεις πρωτεϊνες των μακροφάγων
macrophage:	μακροφάγο
major histocompatibility complex (MHC):	μείζον σύμπλεγμα ιστοσυμβατότητας
Mancini test:	δοκιμασία Mancini
mannose-binding protein:	πρωτείνη συνδεόμενη με τη μαννόζη
mantle zone (follicular mantle):	περιφερική ζώνη δευτερογενούς λεμφοζιδίου
Mantoux test:	δοκιμασία Mantoux
marginal zone:	περιθωριακή περιοχή
margination:	περιθωριοποίηση
mast cell:	σιτευτικό κύτταρο
Masugi nephritis:	νεφρίτιδα Masugi
maternal immunity:	μητρική ανοσία
medullary cord:	μυελώδης χορδή, δοκίδα
membrane attack complex (MAC):	σύμπλεγμα προσβολής της μεμβράνης
membrane cofactor protein (MCP):	μεμβρανικός πρωτεϊνικός συμπαράγοντας
membrane immunofluorescence:	μεμβρανικός ανοσοφθορισμός
membrane immunoglobulin (mlg):	μεμβρανική ανοσοσφαιρίνη
memory cells:	κύτταρα μνήμης
metalophilic cells:	μεταλλοφιλικά κύτταρα
methyl green pyronin stain:	χρώση πρασίνου του μεθυλίου-πυρονίνης
MHC genes:	γονίδια μείζονος συμπλέγματος ιστοσυμβατότητας
MHC restriction:	MHC περιορισμός
microfilaments:	μικροϊνίδια
microglobulin:	μικροσφαιρίνη
microphage:	μικροφάγο
microtubules:	μικροσωληνάρια
migration inhibition factor (MIF):	παράγοντας αναστολής της μετανάστευσης
minimal hemolytic dose (MHD):	ελάχιστη αιμολυτική δόση
minor lymphocyte stimulating antigen (Mls):	έλασσον αντιγόνο διέγερσης των λεμφοκυττάρων
mitogen:	μιτογόνο
mixed leucocyte reaction:	μικτή αντίδραση λευκοκυττάρων
mixed lymphocyte reaction (MLR):	μικτή αντίδραση λεμφοκυττάρων
mixed vaccine:	μικτό εμβόλιο
modulation:	τροποποίηση
monoclonal antibody (mab):	μονοκλωνικό αντίσωμα
monoclonal:	μονοκλωνικό
monocyte chemotactic proteins (MCP-1,2,3):	χημειοτακτικές πρωτεϊνες μονοκυττάρων
monocyte:	μονοκύτταρο
monokine:	μονοκίνη
mononuclear cell:	μονοπύρηνο κύτταρο
mononuclear phagocytes (mononuclear monocytes system):	σύστημα μονοπυρήνων φαγοκυττάρων
monospecific antiserum:	μονοδύναμος αντιορός
motheaten mouse:	σκωροφαγωμένος ποντικός
mucosal addressin cell adhesion molecule (MAdCAM):	μόριο προσκόλλησης βλεννογονική αντρεσίνη
mucosal associated lymphoid tissue (MALT):	λεμφικός ιστός σχετιζόμενος με βλεννογόνο
mucosal mast cell:	σιτευτικό κύτταρο βλεννογόνων
multiple myeloma:	πολλαπλό μυέλωμα
multivalent vaccine:	πολυδύναμο εμβόλιο
muramyl dipeptide (MDP):	μουραμικό διπεπτίδιο
myasthenia gravis:	βαριά μυασθένεια
mycobacterial adjuvants:	μυκοβακτηριακά ανοσοενισχυτικά
myeloid cell series:	μυελοειδής κυτταρική σειρά
myeloma protein:	πρωτείνη μυελώματος
myeloma:	μυέλωμα
myelomatosis:	μυελωμάτωση
myeloperoxidase:	μυελοϋπεροξειδάση
naive lymphocyte:	παρθένο κύτταρο
native immunity:	σύμφυτη ανοσία
natural antibody:	φυσικό αντίσωμα
natural fluorescence (autofluorescence):	φυσικός φθορισμός (αυτοφθορισμός)
natural immunity:	φυσική ανοσία
natural killer cell ( ΝΚ cell ):	φυσικό κυτταροκτόνο κύτταρο
naturally acquired immunity:	φυσικά επίκτητη ανοσία
negative phase:	αρνητική φάση
negative selection:	αρνητική επιλογή
neoantigen:	νεοαντιγόνο
neonatal thynectomy syndrome:	σύνδρομο νεογνικής θυμεκτομής
nephritic factor:	νεφριτικός παράγοντας
nerve growth factor receptor family (NGFR superfamily):	οικογένεια υποδοχέων νευρικών αυξητικών παραγόντων
network theory:	θεωρία δικτύου
neutralization test:	δοκιμασία εξουδετέρωσης
neutrophil leucocyte:	ουδετρόφιλο λευκοκύτταρο
New Zeland black mice:	μαύροι ποντικοί της Νέας Ζηλανδίας
nitric oxide (NO):	νιτρικό οξείδιο
nitroblue tetrazolium test (NBT):	δοκιμασία νιτροκυανού του τεραζολίου
NK cell stimulating factor (IL-12):	παράγοντας διεγερτικός ΝΚ κυττάρων
non-Hodgkin's lymphoma:	μη-Hodgkin λέμφωμα
non-identity, reaction of:	βλ. reaction of non identity
non-immune animal:	μη άνοσο ζώο
non-obese diabetic mouse (NOD):	μη παχύσαρκος διαβητικός ποντικός
non-specific esterase:	μη ειδική εστεράση
non-specific fluorescence:	μη ειδικός φθορισμός
non-specific immunity:	μη ειδική ανοσία
non-tissue specific antigen:	μη ειδικό για ιστούς αντιγόνο
northern blotting:	northern αποτύπωμα
nu nu mice:	ποντικοί nu nu
nuclear factor of activated T cells (NF-AT):	πυρηνικός παράγοντας των ενεργοποιημένων Τ-κυττάρων
nude mice:	αθυμικοί ποντικοί
null lymphocyte:	ουδέτρο λεμφοκύτταρο
nurse cell:	κύτταρο-τροφός
NZB mouse (New Zealand black mouse):	μαύροι ποντικοί Νέας Ζηλανδίας
NZW mouse (New Zealand white mouse):	λευκοί ποντικοί Νέας Ζηλανδίας
Τ cell-dependent antigen:	θυμοεξαρτώμενο αντιγόνο
opsonin:	οψονίνη
opsonization:	οψονινοποίηση
optimal proportions:	άριστες αναλογίες
oral tolerance:	από του στόματος ανοχή
organ specific antigen:	αντιγόνο οργανοειδικό
original antigenic sin:	προπατορικό αντιγονικό αμάρτημα
orthotopic graft:	ορθοτοπικό μόσχευμα
osteopetrosis:	οστεοπέτρωση
Ouchterlony test:	δοκιμασία Ouchterlony
ovalbumin:	ωολευκωματίνη
oxazolone:	οξαζολόνη
oxidative metabolic burst (respiratory bust):	οξειδωτική μεταβολική έκρηξη (αναπνευστική έκρηξη)
papain hydrolysis:	υδρόλυση με παπαίνη
paracortex:	παραφλοιός
paraprotein:	παραπρωτείνη
paraproteinaemia:	παραπρωτειναιμία
paratope:	παράτοπος
parenteral:	παρεντερικός
paroxysmal cold haemoglobinuria:	παροξυσμική αιμοσφαιρινουρία εκ ψύχους
partial identity, reaction of:	αντίδραση μερικής ταυτότητας
particulate antigen:	σωματιδιακό αντιγόνο
passive agglutination test:	δοκιμασία παθητικής συγκόλλησης
passive Arthus reaction:	παθητική αντίδραση Arthus
passive cutaneous anaphylaxis (PCA):	παθητική δερματική αναφυλαξία
passive haemolysis:	παθητική αιμόλυση
passive immunity:	παθητική ανοσία
passive immunization:	παθητική ανοσοποίηση
passive sensitization:	παθητική ευαισθητοποίηση
passive transfer:	παθητική μεταφορά
patch tests:	επιδερμικές δοκιμασίες
patching:	κηλιδωτή εικόνα
penicillin hypersensitivity:	υπερευαισθησία στην πενικιλλίνη
pentraxin:	πεντραξίνη
pepsin digestion:	διάσπαση με πεψίνη
perforin:	περφορίνη
periarteriolar lymphatic sheath (PALS):	περιαρτηριδιακή λεμφική θήκη
peripheral lymphoid organs:	περιφερικά λεμφικά όργανα
peripheral sensitization:	περιφερική ευαισθητοποίηση
peritoneal exudate cells:	περιτοναικά εξιδρωματικά κύτταρα
pernicious anaemia:	κακοήθης αναιμία
peroxidase-anti-peroxidase technique (PAP):	τεχνική υπεροξειδάσης-αντι-υπεροξειδάσης
Peyer's patches:	Παϋέριες πλάκες
phage neutralization test:	δοκιμασία εξουδετέρωσης φάγου
phagocyte:	φαγοκύτταρο
phagocytosis:	φαγοκυττάρωση
phagolysosome:	φαγολυσόσωμα
phagosome:	φαγόσωμα
pharyngeal tonsil:	φαρυγγική αμυγδαλή
phycoerythrin:	φυκοερυθρίνη
phytohemagglutinin (PHA):	φυτοαιμοσυγκολλητίνη
pigeon fancier's lung:	πνεύμονας των πτηνοτρόφων
pinocytosis:	πινοκύτωση ή πινοκυττάρωση
plaque-forming cells (PFC):	κύτταρα σχηματίζοντα πλάκες
plasma cell:	πλασματοκύτταρο
plasma half-life (T1/2):	χρόνος ημίσειας ζωής (συστατικών) πλάσματος
plasma pool:	δεξαμενή πλάσματος
plasma:	πλάσμα
plasmablast:	πλασμαβλάστη
plasmacyte:	πλασματοκύτταρο
plasmacytoma:	πλασματοκύτωμα
platelet (thrombocyte):	αιμοπετάλιο
platelet activating factor (PAF):	παράγοντας ενεργοποίησης αιμοπεταλίων
plication suture	ράμμα.συρραφή πτύχωσης
pneumococcal polysaccharide:	πολυσακχαρίτης πνευμονιοκκόκου
Pneumocystis carinii pneumonia (PCP):	πνευμονία από πνευμονοκύστη carinii
poison ivy hypersensitivity:	υπερευαισθησία στο δηλητηριώδη κισσό
pokeweed mitogen:	μιτογόνo pokeweed
poliomyelitis vaccine:	εμβόλιο πολιομυελίτιδος
pollen hypersensitivity:	υπερευαισθησία στη γύρη
polyacrylamide gel electrophoresis (PAGE):	ηλεκτροφόρηση σε πηκτή πολυακριλαμίδης
polyclonal activators:	πολυκλωνικοί ενεργοποιητές
polymerase chain reaction (PCR):	αλυσιδωτή αντίδραση πολυμεράσης
polymorphonuclear leucocyte (ΡΜΝ):	πολυμορφοπύρηνo λευκοκύτταρo
polyvalent antiserum:	πολυδύναμος αντιορός
polyvalent vaccine:	πολυδύναμο εμβόλιο
positive selection:	θετική επιλογή
post-capillary vessules:	μετατριχοειδικά φλεβίδιαο
Prausnitz-Kustner reaction (PK test):	αντίδραση Prausnitz-Kustner
pre-B lymphocyte:	προ-Β-λεμφοκύταρο
pre-T lymhpocyte:	προ-Τ-λεμφοκύτταρο
precipitation:	σχηματισμός ιζήματος
precipitin test:	ιζηματινοαντίδραση
precipitin:	ιζηματίνη
premunition (premunity, non-sterile immunity):	προστατευτική ανοσία
primary (azurophil) granule:	πρωτογενές (αζουρόφιλο) κοκκίο
primary allergen:	πρωτογενές αλλεργιογόνο
primary antibody:	πρωτογενές αντίσωμα
primary follicles:	πρωτογενή οζίδια
primary immune response:	πρωτογενής ανοσοαπάντηση
primary interaction:	πρωτογενής αλληλοαντίδραση
primary lymphoid tissues:	πρωτογενείς λεμφικοί ιστοί
primary lysosome:	πρωτογενές λυσόσωμα
primary nodule:	πρωτογενές οζίδιο
primed lympocyte:	ειδικά ενεργοποιημένο λεμφοκύτταρο
priming (of immune response):	έναρξη (ανοσοαπάντησης)
priming dose:	δόση έναρξης
private determinant:	ατομικός καθοριστής
privilaged sites:	προνομιούχες θέσεις
pro-B lymphocyte:	προ-Β-λεμφοκύτταρο
processing:	επεξεργασία
programmed cell death:	προγραμματισμένος κυτταρικός θάνατος
properdin (factor P):	προπερδίνη
prophylactic immunization:	προφυλακτική ανοσοποίηση
propidium iodide:	ιωδιούχο προπίδιο
prostaglandins:	προσταγλανδίνες
proteasome:	πρωτεάσωμα
protective antigens:	προστατευτικά αντιγόνα
protective immunity:	προστατευτική ανοσία
protein kinase:	πρωτεϊνική κινάση
protein tyrosine kinase (PTK):	πρωτεϊνική τυροσινική κινάση
prozone:	προζώνη
pseudoallergic reaction:	ψευδοαλλεργική αντίδραση
public determinant:	κοινός αντιγονικός καθοριστής
purified protein derivative ( PPD):	παράγωγο κεκαθαρμένης πρωτεϊνης
purine nucleoside phosphorylase deficiency (PNP deficiency):	ανεπάρκεια πουρινικής νουκλεοσιδικής φωσφορυλάσης
quantitative gel diffusion tests:	ποσοτικές δοκιμασίες διάχυσης σε πηκτή
quantitative precipitation:	ποσοτική ιζηματινοαντίδραση
radial diffusion test:	δοκιμασία ακτινωτής (ανοσο)διάχυσης
radiation chimera:	βλ. irradiation chimera
radioallergosorbent test (RAST):	ραδιοαλλεργοπροσροφητική δοκιμασία
radioimmunoassay:	ραδιοανοσολογικός προσδιορισμός
Raji cell assay:	προσδιορισμός με κύτταρα Raji
reaction of identity:	αντίδραση ταυτότητας
reaction of non-identity:	αντίδραση μη ταυτότητας
reaction of partial identity:	αντίδραση μερικής ταυτότητας
reactive haemolysis:	αντιδραστική αιμόλυση
reactive oxygen intermediates (ROI):	ρίζες οξυγόνου
reagin (reagenic antibody):	αντιδρασίνη
receptor (R):	υποδοχέας
recirculating pool:	επανακυκλοφορούσα δεξαμενή
recognition:	αναγνώριση
recombinant strains:	ανασυνδυασμένα στελέχη
recombinant vaccine:	ανασυνδυασμένο εμβόλιο
red pulp of spleen:	ερυθρός πολφός του σπλήνα
regulators of complement activation gene family	οικογένεια γονιδίων των ρυθμιστών της ενεργοποίησης
rejection:	απόρριψη
repeating units:	επαναλαμβανόμενες μονάδες
repertoire:	ρεπερτόριο
resident macrophage:	περιοχικό μακροφάγο
respiratory burst:	αναπνευστική έκρηξη
restriction fragment length polymorphism	ανάλυση πολυμορφισμού τμήματος μήκους καθοριζόμενου
reticular cells:	δικτυοκύτταρα
reticular dysgenesis:	δυσγενεσία δικτύου
reticuloendotheliac blockage:	δικτυοενδοθηλιακός αποκλεισμός
reticuloendotheliac system:	δικτυοενδοθηλιακό σύστημα
reticulosis:	δικτύωση
reverse immunoblotting:	ανάστροφο ανοσοαποτύπωμα
reverse passive Arthus reaction:	ανάστροφη παθητική αντίδραση Arthus
Rhesus (Rh) blood group system:	σύστημα ομάδας αίματος Rhesus
rheumatoid arthritis:	ρευματοειδής αρθρίτιδα
rheumatoid factor:	ρευματοειδής παράγοντας
rhodamines:	ροδαμίνες
rhodopsin superfamily:	υπεροικογένεια της ροδοψίνης
Rose-Waaler test:	δοκιμασία Rose-Waaler
rosette:	ρόδακας
runt disease:	καχεκτική νόσος
salt precipitation:	κατακρίμνιση δι' άλατος
sandwich immunofluorescence:	ανοσοφθορισμός \σάντουιτς\
sandwich technique:	τεχνική \σάντουιτς\
scavenger cell:	κύτταρο-καθαριστής
second set rejection:	δεύτερη απόρριψη
secondary allergen:	δευτερογενές αλλεργιογόνο
secondary antibody:	δευτερογενές αντίσωμα
secondary follicle:	δευτερογενές οζίδιο
secondary granule (specific granule):	δευτερογενές κοκκίο
secondary immune response:	δευτερογενής ανοσοαπάντηση
secondary lymphoid tissues:	συν. του peripheral lymphoid organs
secondary lysosome (phagolysosome):	δευτερογενές λυσόσωμο
secretory IgA (sIgA):	εκκριτική IgA
secretory piece:	εκκριτικό τμήμα
selectins:	σελεκτίνες
selective theories of the immune response:	θεωρίες επιλογής της ανοσοαπάντησης
self antigen (autoantigen):	αυτοαντιγόνο
self tolerance:	αυτοανοχή
self-cure:	αυτοϊαση
sensitization:	ευαισθητοποίηση
septic shock:	σηπτική καταπληξία
sequestered antigen:	απομονωμένο αντιγόνο
serial dilutions:	διαδοχικές αραιώσεις
serology:	ορολογικές εξετάσεις
serotherapy:	οροθεραπεία
serotonin:	σεροτονίνη
serprocidin:	σεπροσιδίνη
serum hepatitis:	ηπατίτιδα από ομόλογο ορό
serum sickness:	ορονοσία
serum:	ορός
severe combined imunodeficiency syndrome (SCID):	σύνδρομο βαριάς συνδυασμένης ανοσοανεπάρκειας
Sezary syndrome:	σύνδρομο Sezary
sheep cell agglutination test:	δοκιμασία συγκόλλησης ερυθρών προβάτου
sheep erythrocyte (SRBC):	ερυθροκύτταρα προβάτου
short consensus repeat (SCR):	βραχείες επαναλαμβνόμενες αμινοξικές αλληλουχίες
Shwartzman reaction:	αντίδραση Shwartzman
signal hypothesis:	υπόθεση μηνύματος
signal peptide (leader peptide):	οδηγό πεπτίδιο
Simonsen phenomenon:	φαινόμενο Simonsen
single layer immunofluorescence technique	τεχνική μονής στιβάδας ανοσοφθορισμού
single radial diffusion test:	δοκιμασία απλής κυκλοτερούς διάχυσης
Sjφgren's disease:	νόσος του Sjφgren
skin sensitizing antibody:	ευαισθητοποιό αντίσωμα του δέρματος
skin test:	δερματική δοκιμασία
skin window:	δερματικό παράθυρο
slot blotting:	βλ. dot blotting
slow reacting substance A (SRS-A):	βραδέως αντιδρώσα ουσία Α
small lymphocyte:	μικρό λεμφοκύτταρο
smallpox vaccination:	δαμαλισμός
soluble complex:	διαλυτό σύμπλεγμα
somatic hypermutation:	σωματική υπερμετάλλαξη
Southern blotting:	ανοσοαποτύπωμα Southern
specific immunity:	ειδική ανοσία
specificity:	ειδικότητα
spleen:	σπλήνας
splenectomy:	σπληνεκτομή
split tolerance:	διάσπαση ανοσχής
spur:	σπειρούνι
stem cell:	αρχέγονο κύτταρο
streptococcal nephritis:	στρεπτοκοκκική νεφρίτιδα
stromal cells:	κύτταρα στρώματος
subset:	υποπληθυσμός
subunit vaccines:	εμβόλια υπομονάδων
superantigen:	υπεραντιγόνο
superfamily:	υπεροικογένεια
superoxide anion:	ανιόν υπεροξειδίου
suppressor T lymphocyte:	κατασταλτικό Τ-λεμφοκύτταρο
surface immunoglobulin (slg):	ανοσοσφαιρίνη επιφανείας
surrogate light chain:	προσωρινή ελαφρά αλυσίδα
switch region:	περιοχή μεταστροφής
switch site:	θέση μεταστροφής
sympathetic ophthalmia:	συμπαθητική οφθαλμία
synapsin-a neuronal protein	νευρωνική πρωτεϊνή α-συναψίνη
syngeneic (syngenic):	ισογενής
synthetic peptide vaccine:	εμβόλιο από συνθετικό πεπτίδιο
systemic anaphylaxis:	συστηματική αναφυλαξία
systemic lupus erythematosus (SLE):	συστηματικός ερυθηματώδης λύκος
T cell receptor (TCR):	υποδοχέας Τ-κυττάρου
T cell subset:	υποπληθυσμός Τ-κυττάρων
T cell-dependent area:	θυμοεξαρτώμενη περιοχή
T cell-dependent immune response:	θυμοεξαρτώμενη ανοσοαπάντηση
T lymphocyte - B lymphocyte cooperation:	βλ. T-B cell cooperation
T lymphocyte antigen receptor (TCR):	αντιγονικός υποδοχέας Τ-λεμφοκυττάρου
T lymphocyte repertoire:	ρεπερτόριο Τ-λεμφοκυττάρων
T lymphocyte subset:	υποπληθυσμός Τ-λεμφοκυττάρων
T lymphocyte:	Τ-λεμφοκύτταρο
T-B cell cooperation:	συνεργασία Τ-Β κυττάρων
T-cell:	Τ-κύτταρο
tachyphylaxis:	ταχυφυλαξία
tail peptide:	ουραίο πεπτίδιο
tanned red cell test:	δοκιμασία με κατεργασμένα με ταννίνη ερυθρά αιμοσφαίρια
TDTH lymphocyte:	Τ-λεμφοκύτταρο επιβρδυνόμενης υπερευαισθησίας
terminal deoxynucleotide transferase (TdT):	τελική δεσοξυνουκλεοτιδική τρανφεράση
test dosing:	δοκιμασία δόσης
tetramethylrodamine isothiocyanate:	ισοθειοκυανιούχος τετραμεθυλροδαμίνη
tetraparental chimera:	τετραγονεϊκή χίμαιρα
thermic effect of food	θερμικό αποτέλεσμα/δυναμική δράση τροφών
thoracic duct drainage:	παροχέτευση θωρακικού πόρου
thymectomy:	θυμεκτομή
thymic cortex:	φλοιός θύμου
thymic epithelial cells:	επιθηλιακά κύτταρα του θύμου
thymic hypoplasia:	υποπλασία του θύμου
thymic medullary hyreplasia:	μυελική υπερπλασία του θύμου
thymic nurse cell:	θυμικό κύτταρο-τροφός
thymocyte:	θυμοκύτταρο
thymus dependent antigen (TD antigen):	θυμοεξαρτώμενο αντιγόνο
thymus dependent area:	θυμοεξαρτώμενη περιοχή
thymus dependent cells:	θυμοεξαρτώμενα κύτταρα
thymus derived cells:	κύτταρα προερχόμενα από το θυμό
thymus independent antigen:	θυμοανεξάρτητο αντιγόνο
thymus:	θύμος
thyroid antibodies:	θυροειδικά αντισώματα
thyroiditis:	θυροειδίτιδα
thyrotoxicosis:	θυρεοτοξίκωση
tingible body:	βαθυχρωματικό σωμάτιο
tissue specific antigen:	ιστιειδικό αντιγόνο
tissue typing:	ιστική τυποποίηση
titre (USA titer):	τίτλος
tolerance:	ανοχή
tolerogenic:	επαγωγικός ανοχής
tonsil:	αμυγδαλή
toxoid:	τοξοειδές
transfection:	διαμόλυνση
transformation:	μεταμόρφωση
transforming growth factor β (TGF-β):	αυξητικός παράγοντας μεταμόρφωσης β
transfusion reaction:	αντίδραση από τη μετάγγιση
transgene:	διαγονίδιο
transgenic mouse:	διαγονιδιακός ποντικός
translocation:	διαμετάθεση
transplantation antigen:	αντιγόνο μεταμόσχευσης
transplantation immunology:	ανοσολογία μεταμόσχευσης
transport piece:	τμήμα μεταφοράς
transporter associated with antigen processing (TAP):	μεταφορέας σχετιζόμενος με την επεξεργασία του αντιγόνου
trypan blue:	κυανούν του τρυπανίου
tuberculin test:	φυματινοαντίδραση
tuberculin:	φυματίνη
tumor necrosis factor α, cachectin:	παράγοντας νέκρωσης των όγκων α, καχεκτίνη
tumor necrosis factor β, lymphotoxin:	παράγοντας νέκρωσης των όγκων β, λεμφοτοξίνη
tumor necrosis factor receptor superfamily (TNFR):	υπεροικογένεια των υποδοχέων των παραγόντων
tumor specific antigen:	αντιγόνο ειδικό όγκου
tumour necrosis factor (TNF):	παράγοντας νέκρωσης των όγκων
type I, II, III transmembrane protein:	διαμεμβρανική πρωτεϊνη τύπου Ι, II, III
type I, II, III, IV hypersensitivity reaction:	αντίδραση υπευαισθησίας τύπου Ι, II, III IV
tyrosine kinase:	τυροσινική κινάση
ulcerative colitis:	ελκώδης κολίτιδα
univalent antibody:	μονοδύναμο αντίσωμα
unprimed:	παρθένο
unresponsiveness:	μη απαντητικότητα
uropod:	ουροπόδιο
urticaria:	κνίδωση
vaccination:	εμβολιασμός
vaccine:	εμβόλιο
vaccinia:	δαμαλισμός
valency:	σθένος
variable region (V-region):	μεταβλητή περιοχή
variable region group:	ομάδα μεταβλητών περιοχών
variable region subgroup:	υποομάδα μεταβλητών περιοχών
variola:	ευλογιά
vascular cell adhesion molecule-1 (VCAM-1):	αγγειακό μόριο προσκόλλησης -1
vascular permeability factors:	παράγοντες αγγειακής διαβατότητας
vasoactive amines:	αγγειοδραστικές αμίνες
veiled cell:	πεπλόμορφο κύτταρο
virgin lymphocyte:	παρθένο λεμφοκύτταρο
virus neutralization tests:	δοκιμασίες εξουδετέρωσης ιών
Waldenstrom's macroglobulinaemia:	μακροσφαιριναιμία Waldenstrom
Wassermannn reaction (WR):	αντίδραση Wassermann
wasting disease:	καχεκτική νόσος
water-in-oil emulsion adjuvant:	ανοσοενισχυτικό υδατοελαιώδες γαλάκτωμα
weal and flare response:	αντίδραση ερυθήματος και πομφού
Wegener's granulomatosis:	κοκκιωμάτωση του Wegener
western blotting:	ανοσοαποτύπωμα western
white cells:	λευκά αιμοσφαίρια
white pulp:	λευκός πολφός
Wiskott-Aldrich syndrome:	σύνδρομο Wiskott-Aldrich
X-linked hyper-IgM syndrome:	σύνδρομο φυλοσύνδετης υπερανοσοαφαιριναιμίας IgM
X-linked lymphoproliferative syndrome:	φυλοσύνδετο λεμφουπερπλαστικό σύνδρομο
xenogenic (xenogenic, heterogenic):	ξενογενής, ετερογενής
xenograft (heterograft):	ξενομόσχευμα, ετερομόσχευμα
xenotype:	ξενότυπος
zeta chain associated protein (ZAP-70):	πρωτείνη σχετιζόμενη με την ζ αλυσίδα
zooprophylaxis:	ζωοπροφύλαξη
zymosan:	ζυμοζάνη
peptidoglycan	πεπτιδογλυκάνη
Clinical results should also be assessed	(Συνιστάται) κλινική συναξιολόγηση
cerebrovascular accident; stroke	αγγειακό εγκεφαλικό επεισόδιο
barium enema (BaE), contrast enema	βαριούχοs υποκλυσμόs
basophil stippling (punctate basophilia)	βασ. στίξη, βασεόφιλη στίξη
thyroxine-binding globulin, TBG	δεσμευτική σφαιρίνη της θυροξίνης, δεσμευτική της θυροξίνης σφαιρίνη, σφαιρίνη που δεσμεύει την θυροξίνη
haemorrhagic contusion	αιμορραγική θλάση
plateletcrit (PCT), thrombocytocrit	αιμοπεταλιοκρίτης
cluster headache	αθροιστική κεφαλαλγία
marked tachycardia	εκσεσημασμένη ταχυκαρδία
intra-articular fracture	ενδαρθρικό κάταγμα
reconstitution	ανασύνθεση
measuring device	δοσιμετρικό εξάρτημα
viscosupplementation	ενίσχυση της ιξωδοελαστικότητας
applicator	εξάρτημα χορήγησης
nucleated red blood cells, NRBC	εμπύρηνα ερυθρά
erythron	ερυθρά σειρά (ερυθρή σειρά)
oesophageal atresia	ατρησία του οισοφάγου
autografting, autotransplantation	αυτομεταμόσχευση
autograft	αυτομόσχευμα
red cell distribution width (RDW) [blood test]	εύρος κατανομής ερυθρών
his/her fever resolved, the fever resolved	απυρέτησε
dilation and curettage (dilatation and curettage), D&C	απόξεση με αναρρόφηση
C-reactive protein	C-αντιδρώσα πρωτεΐνη
ischiopubic ramus	ηβοϊσχιακός κλάδος
cefepime [drug: respiratory tract infections]	κεφεπίμη
differential count; differential leukocyte count; diff	λευκοκυτταρικός τύπος
leukocytosis with a leftward shift	λευκοκυττάρωση με στροφή του τύπου προς τα αριστερά
capsid	καψίδιο
modified-release granules	κοκκία ελεγχόμενης αποδέσμευσης
capsule	κάψουλα, [EDQM term] καψάκιο
microcythemia, microcytosis	μικροκυττάρωση
mononuclear phagocyte; monocyte	μονοπύρηνο φαγοκύτταρο
monoconvex tablet	μονόκυρτο δισκίο
haustorium	μυζητήρας
nasal ridge	ράχη της ρινός
ranibizumab	ρανιμπιζουμάμπη
nasogastric tube	ρινογαστρικός σωλήνας
ritonavir	ριτοναβίρη
buffer [in pharmaceutical product]	ρυθμιστικό
φυσιολογικές τιμές, reference values, [blood test] reference ranges	Φ.Τ.
well-formed and well-nourished	άρτιας σωματικής διάπλασης και καλής θρέψεως
upper pole	άνω πόλος (νεφρού)
impacted tooth	έγκλειστο δόντι
methaemoglobin reductase deficiency	έλλειψη της αναγωγάσης της μεθαιμοσφαιρίνης
arachnoidea mater	αραχνοειδής μήνιγγα
capacitance vessels	αγγεία χωρητικότητας
angiotensin	αγγειοτασίνη, αγγειοτενσίνη
vasovagal	αγγειοπνευμονογαστρικός
organ perfusion	αιμάτωση οργάνου
pure embryonal carcinoma	αμιγές εμβρυϊκό καρκίνωμα
bifrontal decompressive craniectomy	αμφιμετωπιαία αποσυμπιεστική κρανιεκτομία
reductase	αναγωγάση
ACE inhibitor	αναστολέας ΜΕΑ
restlessness	ανησυχία
human genome	ανθρώπινο γονιδίωμα
open-label study	ανοικτής χορήγησης μελέτη [clinical trials]
open-label	ανοικτής χορήγησης [clinical trials]
antigen-presenting cell, APC	αντιγονοπαρουσιαστικό κύτταρο
atezolizumab	ατεζολιζουμάμπη
plain ACE inhibitor	απλός αναστολέας του ΜΕΑ
is demethylated	απομεθυλιούται, απομεθυλιώνεται
is denitrated	απονιτρούται
excretory portion	αποχετευτική μοίρα (νεφρού)
single-agent oral vinorelbine	από του στόματος βινορελμπίνη ως μεμονωμένος παράγοντας
magnetic resonance imaging	απεικόνιση με μαγνητικό συντονισμό
short-axis diameter	βραχεία διάµετρος
short-acting bronchodilator	βρογχοδιασταλτικό βραχείας δράσης
short-acting beta-2 agonist	βήτα-2 διεγερτής βραχείας (διάρκειας) δράσης
dose calibration system	βαθμονομημένο σύστημα
duct patency	βατότητα του πόρου
gastro-resistant pellets (Minimicrospheres)	γαστροανθεκτικά μικροσφαιρίδια
cerebellopontine angle	γεφυροπαρεγκεφαλιδική γωνία
effective regurgitant orifice area, EROA	δραστικό στόμιο παλινδρόμησης
annuloplasty (device)	δακτυλιοπλαστική
interstitial nephritis	διάμεση νεφρίτιδα
diffuse axonal injury	διάχυτη αξονική βλάβη
T1-weighted scanning sequences	διαδοχικές απεικονίσεις Τ1
percutaneous thrombectomy	διαδερμική θρομβεκτομή
dispersible tablet	διασπειρόμενο δισκίο
penetrating keratoplasty	διατρητική κερατοπλαστική
eating disorder	διαταραχή πρόσληψης τροφής
compliance of the large arteries	διατασιμότητα των μεγάλων αρτηρίων
autologous serum skin test	δοκιμασία αυτόλογου ορού
autologous serum skin test	δοκιμασία αυτόλογου ορού
autologous serum skin test	δοκιμασία αυτόλογου ορού
secondary packaging	δευτερογενής συσκευασία, δευτερεύουσα συσκευασία [pharmaceuticals]
CTH harness (cardiothoracic harness)	ζώνη στήριξης θωρακικού τοιχώματος
e-prescribing	ηλεκτρονική συνταγογράφηση
e-referral	ηλεκτρονικό παραπεµπτικό
EEG brain mapping	ηλεκτροεγκεφαλογράφημα χαρτογραφικής απεικόνισης
blurred vision	θάμβος όρασης, θολή όραση
leiomyoma, fibroid (tumour), fibromyoma	ινομύωμα
low-pathogenic virus	ιός µε χαµηλή παθογένεια
primary safety endpoint	κύριο καταληκτικό σημείο ασφάλειας
whiplash injury	κάκωση δίκην μαστιγίου
blister card	καρτέλα μπλίστερ
multiple sclerosis	κατά πλάκας σκλήρυνση, σκλήρυνση κατά πλάκας
potassium citrate (E332)	κιτρικό κάλιο [excipient]
clinical years (of medical education)	κλινικά έτη
clinical audits	κλινικοί έλεγχοι [assessment of national health systems]
clinical repository (sample repository, biosample repository, biospecimen repository)	κλινικό αποθετήριο
common renewal date, CRD	κοινή ημερομηνία ανανέωσης [pharmaceuticals]
colloidal silica	κολλοειδές διοξείδιο του πυριτίου
powder and solvent for instillation solution for intraocular use	κόνις και διαλύτης για παρασκευή διαλύματος ενδοφθαλμικής ενστάλαξης
toluidine blue (stain)	κυανούν της τολουϊδίνης
cyclopentane heptanoic acid	κυκλοπεντανιοεπτανοϊκό οξύ
dose-ranging [clinical study]	κυμαινόμενης δόσης
dose-ranging [clinical study]	κυμαινόμενης δόσης
quiescent tuberculosis	λανθάνουσα φυματίωση
complexometric methods	μέθοδοι μέτρησης σύμπλοκων ενώσεων
long-term, open-label study	μακροπρόθεσμη, ανοικτής επισήμανσης μελέτη [clinical trials]
uncorrected hypokalaemia	μη αντιμετωπισθείσα υποκαλιαιμία
non-nucleoside reverse transcriptase inhibitors, NNRTI	μη νουκλεοσιδικοί αναστολείς της ανάστροφης μεταγραφάσης
uncomplicated gonorrhoea	μη επιπλεγμένη γονόρροια
unresectable melanoma	μη χειρουργήσιμο μελάνωμα
off-label use	μη προβλεπόμενη χρήση φαρμάκου, μη επιτρεπόμενη χρήση
microaerophilic streptococci	μικροαερόφιλοι στρεπτόκοκκοι
microcapsule	μικροκαψίδιο
only on strict indications	μόνο σύμφωνα με τις ενδείξεις (του, της)
double-dummy	με χρήση διπλού εικονικού φαρμάκου [clinical trials]
open-label study	μελέτη ανοιχτής θεραπείας [clinical trials]
active comparator study (active comparator period)	μελέτη σύγκρισης με ενεργό παράγοντα [clinical trials]
interscapular	μεσοπλάτιος, μεσοωμοπλατιαίος
sodium salt	μετά νατρίου άλας
translational research	μεταγραφική έρευνα
poststenotic myocardial areas	μεταστενωτικές περιοχές του μυοκαρδίου.
post-marketing surveillance	μετεγκριτική παρακολούθηση
myxoedema coma	μυξοιδηματικό κώμα
cardiomyopathy (CM)	μυοκαρδιοπάθεια (ΜΚΠ)
conus medullaris, medullary cone	μυελικός κώνος
younger patients	νεαρής ηλικίας ασθενείς
by nephelometry	νεφελομετρικά
neurogenic detrusor overactivity	νευρογενής υπερδραστηριότητα εξωστήρα μυός
dasabuvir	ντασαμπουβίρη
sagittal section	οβελιαία τομή
pathways, paths	οδοί
right ventricular outflow tract velocity time integral, RVTI	ολοκλήρωμα ταχύτητας χρόνου ροής αίματος χώρου εξόδου δεξιάς κοιλίας
diagnosis-related groups, DRGs	ομάδες συγγενών διαγνώσεων
ombitasvir	ομπιτασβίρη
ombitasvir	ομπιτασβίρη
ombitasvir	ομπιτασβίρη
urinary tract infection, UTI	ουρολοίμωξη
μεσοκοιλιακό διάφραγμα - interventricular septum, IVS	ΜΚΔ
adverse drug reaction terms, ADR terms	όροι περί ανεπιθύμητων ενεργειών φαρμάκων
Cyprus Medical Register	Μητρώο Ιατρών Κύπρου
isointense (relative) to ...	όμοιας προς ... εντάσεως σκιαγραφήσεως
Meckel's diverticulum	Μεκέλειος απόφυση, Μεκέλεια απόφυση
capillary leak syndrome	σύνδρομο διαφυγής τριχοειδών
contrast-enhanced MRI	σκιαγραφικώς ενισχυμένη μαγνητική τομογραφία
dura mater	σκληρά μήνιγγα
sucralose (E955)	σουκραλόζη [excipient]
sodium stearyl fumarate	στεαρυλικό φουμαρικό νάτριο [excipient]
stenosing coronary arteriosclerosis	στενωτική στεφανιαία αρτηριοσκλήρυνση
coronal plane	στεφανιαίο επίπεδο
coronary angiography	στεφανιογραφία
platelet aggregation	συσσωμάτωση των αιμοπεταλίων
cannula	σωληνίσκος
facial skull	σπλαγχνικό κρανίο
spermatic cord	σπερματικός τόνος
Newcastle disease, ND	ψευδοπανώλη (των ορνίθων, των πτηνών)
erythromycin ethylsuccinate	ερυθρομυκίνη αιθυλοηλεκτρική
burn surface	εγκαυματική επιφάνεια
breath-actuated nebuliser	εκνεφωτής ενεργοποιούμενος με την αναπνοή
jet nebuliser	εκνεφωτής ταχυρεύματος
minimum inhibitory concentration, MIC	ελάχιστη ανασταλτική συγκέντρωση [antibiotics]
free-floating anxiety	ελεύθερα επιπολάζον άγχος
active-controlled	ελεγχόμενη με δραστικό φάρμακο [clinical trials]
baseline-controlled study	ελεγχόμενη ως προς τις τιμές αναφοράς μελέτη [clinical trials]
ebastine	εμπαστίνη
empirical treatment	εμπειρική θεραπεία
intratubular germ cell neoplasia, IGCN	ενδοσωληναριακή νεοπλασία από γεννητικά κύτταρα
intraocular solution, solution for intraocular irrigation	ενδοφθάλμιο διάλυμα
circle of Willis	εξάγωνο του Willis
antibody-dependent cell-mediated cytotoxicity, ADCC	εξαρτώμενη από το αντίσωμα, μεσολαβούμενη από κύτταρα κυτταροτοξικότητα
οff-pump coronary revascularisation of the ischaemic left ventricle	επαναιμάτωση ισχιαμούσης αριστερής κοιλίας χωρίς χρήση εξωσωματικής κυκλοφορίας
target lesion re-intervention	επανεπέμβαση της βλάβης στόχου
cerebral falx calcification(s)	επασβεστώσεις του δρεπάνου του εγκεφάλου
cerebral falx calcification(s)	επασβεστώσεις του δρεπάνου του εγκεφάλου
milestone survival	επιβίωση-ορόσημο
partial onset seizures	επιληπτικές κρίσεις εστιακής έναρξης
visiting hours	επισκεπτήριο, ώρες επισκεπτηρίων
Expiry date; Do not use after	Ημερομηνία λήξης
End of Trial declaration, EoT declaration	Δήλωση περάτωσης κλινικής δοκιμής
δικτυ(ο)ερυθροκύτταρα - reticulocytes	ΔΕΚ [blood tests]
toxicities associated with ...	τοξικά φαινόμενα που σχετίζονται με ...
renal vascular tone	τόνος των νεφρικών αγγείων
final-stage heart failure	τελικού σταδίου ΚΑ, τελικού σταδίου καρδιακή ανεπάρκεια
LV-ED	τελοδιαστολική διάμετρος αριστεράς κοιλίας
LPLV, last patient's last visit, last visit of the last subject	τελευταία επίσκεψη τελευταίου ασθενή [clinical trials]
quadrigeminal cistern	τετραδυμική δεξαμενή
tetrahydrobiopterin, BH4, sapropterin	τετραϋδροβιοπτερίνη
One Point Cut ampoule	φύσιγγα με μονό σημείο κοπής
first-pass effect	φαινόμενο πρώτης διόδου
venous pooling	φλεβική λίμναση
methotrexate-induced ventriculitis	φλεγμονή της εγκεφαλικής κοιλίας, που προκλήθηκε από μεθοτρεξάτη
reference values; [blood test] reference ranges	φυσιολογικές τιμές
chronic spontaneous urticaria, CSU	χρόνια αυθόρμητη κνίδωση, ΧΑΚ
activity reference time	χρόνος αναφοράς της ραδιενέργειας
chromogenic assay	χρωμογόνο δοκιμασία
biliary sludge, gallbladder sludge	χολική λάσπη
airway management	χειρισμοί από το αναπνευστικό
anterior segment surgery [eye]	χειρουργικές επεμβάσεις του προσθίου θαλάμου
εντός φυσιολογικών ορίων­, within normal limits, within normal range	Ε.Φ.Ο.
Investigator's Brochure (IB) [clinical studies]	Εγχειρίδιο του Ερευνητή
Periodic Safety Update Report (PSUR)	Εκθεση Περιοδικής Παρακολούθησης της Ασφάλειας (ΕΠΠΑ)
European Parkinson's Disease Standards of Care Consensus Statement	Ευρωπαϊκή Κοινή Διακήρυξη για τα Πρότυπα Φροντίδας στη Νόσο Πάρκινσον
overflexion	υπέρκαμψη [whiplash injury]
residual moisture	υπολειπόμενη υγρασία
recurrence after surgery	υποτροπή μετεγχειρητικά
pituitary hypothyroidism, hypothyroidism of pituitary origin	υποφυσιογενής υποθυρεοειδισμός
obligate anaerobes	υποχρεωτικώς αναερόβια (βακτήρια)
overgrowth of clostridia	υπερανάπτυξη κλωστριδίων
detrusor overactivity	υπερδραστηριότητα του εξωστήρα μυός (της ουροδόχου κύστης)
detrusor overactivity	υπερδραστηριότητα του εξωστήρα μυός της ουροδόχου κύστης
pertechnetate ion	υπερτεχνητικό ιόν
sodium pertechnetate	υπερτεχνητικό νάτριο
causative (micro)organism	υπεύθυνος μικροοργανισμός
study manager	υπεύθυνος παρακολούθησης της μελέτης [clinical trials]
screening tests	προσανατολιστική αναζήτηση
prosthodontics, dental prosthetics	προσθετική οδοντιατρική
kit [pharmaceuticals]	προσκεύασμα
prodrug	προφάρμακο
propylthiouracil	προπυλοθειουρακίλη
anterior and posterior synechiae	πρόσθιες και οπίσθιες συνέχειες
primary patency	πρωτογενής βατότητα
PASS protocol, post-authorisation safety study protocol	πρωτόκολλο μετεγκριτικής μελέτης ασφαλείας [clinical trials]
persistent pulmonary hypertension of the newborn (PPHN)	παραμένουσα πνευμονική υπέρταση σε νεογνά
paritaprevir	παριταπρεβίρη
acid reflux	παλινδρόμηση οξέων
population pharmacokinetic study	πληθυσμιακή φαρμακοκινητική μελέτη
foreign body-type multinucleated giant cells	πολυπύρηνα γιγαντοκύτταρα του τύπου των ξένων σωμάτων
overage [Cyprus, pharmaceutical]	περίσσεια
strengths (of a medicinal product)	περιεκτικότητες (ενός φαρμακευτικού προϊόντος)
(cadaveric, postmortem) hypostases, livor mortis	πτωματικές υποστάσεις
high-flux nuclear reactor (HFR)	πυρηνικός αντιδραστήρας υψηλής ροής
L-aspartic acid	L-ασπαργινικό οξύ
band neutrophils, bands	ραβδοπύρηνα
quantitative pharmacoelectroencephalogram (QPEEG(R))	φαρμακοηλεκτρεγκεφαλογράφημα (μέθοδος QPEEG(R))
ciprofloxacin [antibacterial drug]	σιπροφλοξασίνη
dropper container	σταγονομετρικό φιαλίδιο
IMPD, Investigational Medicinal Product Dossier	ΦΥΕΦΠ
implanter	συσκευή εμφύτευσης
vertebral fusion	σπονδυλοδεσία
ACL, anterior cruciate ligament of the knee	Π.Χ.Σ. γόνατος, πρόσθιος χιαστός συνδεσμός γόνατος
referral	παραπεμπτικό
mild precordial pain	ήπιο προκάρδιο άλγος
absolute mean deviation	μέση απόλυτη απόκλιση
absorbance	απορρόφηση
absorption filters	φίλτρα απορρόφησης
absorptivity	απορροφητικότητα
accepted reference value	αποδεκτή τιμή αναφοράς
accuracy	ακρίβεια
activation analysis	ανάλυση με ενεργοποίηση
activation polarization	πόλωση ενεργοποιήσεως
adsorption	προσρόφηση
affinity	συγγένεια
aliquot	γνωστό κλάσμα
alternative hypothesis	ενναλακτική υπόθεση
ANalysis Of VAriance	ανάλυση διακύμανσης
analyst	αναλυτής
analyte	αναλύτης ή αναλυόμενη ουσία
analyzer	αναλυτής
assay	ποσοτικός προσδιορισμός
assigned value	αποδιδόμενη τιμή
attenuated total reflectance	εξασθενημένη ολική ανάκλαση
background signal	σήμα υποβάθρου
band tailing	κορυφή με ουρά
band-pass filters	φίλτρα διελεύσεως ζώνης (ταινίας)
barrier-layer cells	φωτοβολταϊκά κύτταρα ή κύτταρα επιστρώματος φράγματος ή φωτοδίοδοι
base peak	βασική κορυφή
between run	μεταξύ προσδιορισμών
between sample	διαδειγματική
bias	συστηματικό σφάλμα
bimodal distribution	δικόρυφη κατανομή
birefringent modulator	διπλοδιαθλαστικός διαμορφωτής
blank sample	τυφλό ή λευκό δείγμα
boiling point	σημείο ζέσεως
bond elut	πλαστικές θήκες συρίγγων
bovine serum albumin	αλβουμίνη βόειου ορού
bracketing standards	πρότυπα που περικλείουν τα άγνωστα
bulk sample	μαζικό δείγμα
calibration	βαθμονόμηση
capacitive current	χωρητικό ρεύμα
carbon paste disk electrode	ανιχνευτής ηλεκτροδίου από δίσκο γραφιτικής πάστας
cell in a precision experiment	στοιχείο σε πείραμα επαναληψιμότητας
central limit theorem	θεώρημα κεντρικού ορίου
central tendency	κεντρική τάση
certified value	διακριβωμένη τιμή
chemical ionization source	πηγή χημικού ιονισμού
chemical shift	χημική μετατόπιση
circular dichroism	κυκλικός διχρωϊσμός
classes	κλάσεις
closeness	εγγύτητα
coefficient of variation	συντελεστής μεταβλητότητας
combined error	συνδυασμός σταθερού αναλογικού σφάλματος
component bias	συστατικό του συστηματικού σφάλματος
concentration polarization	πόλωση συγκεντρώσεως
confidence interval	διάστημα εμπιστοσύνης
confidence level	στάθμη εμπιστοσύνης
confidence level	στάθμη εμπιστοσύνης
consensus value	εκ συγκατάθεσης τιμή
constant error	σταθερό σφάλμα
controls	γνωστά δείγματα
convection	φυσική ροή
correct value	ορθή τιμή
correlation coefficient	συντελεστής συσχέτισης
correlation plot	διάγραμμα συσχέστισης
counter electrode	αντι-ηλεκτρόδιο
countercurrent	κατ'αντιρροή
critical batch size	κρίσιμο μέγεθος φουρνιάς δειγμάτων
cross reactivity	διασταυρούμενη δραστικότητα
cummulative distirbution function	σωρευτική κατανομή
cut-off filters	φίλτρα αποκοπής
data input	εισαγόμενα δεδομένα
data integrity	εντιμότητα δεδομένων
data output	εξαγόμενα δεδομένα
decay curve	καμπύλη διασπάσεως
degree of cross-linkage	αριθμός διακλαδώσεων
densitometry	πυκνομετρία
derivative spectrophotometry	φασματοφωτομετρία παραγώγων
detection limit	όριο ανίχνευσης
detection limit	όριο ανίχνευσης
determinate error	καθορισμένο σφάλμα
determination	προσδιορισμός
diamagnetic shielding	διαμαγνητική προστασία
differential pulse polarography	διαφορική παλμική πολαρογραφία
diffuse reflection	διάχυτη ανάκλαση
diffusion	διάχυση
digestion bombs	οβίδες χωνεύσεως
discrete	διακριτή
discrimination	πλήρης διάκριση
dispersion	διασπορά
displacement	εκτόπιση
dissolution studies	δοκιμασίες διαλυτοποίησης
distillation range	περιοχή απόσταξης
distirbution	κατανομή
dosage form	δοσομετρική μορφή
double focusing analyzers	αναλυτές διπλής εστιάσεως
drift	ολίσθηση
drop point	σημείο στάξεως
electrode drift	ολίσθηση ηλεκτροδίου
electrodeless-discharge lamp	λυχνία εκκενώσεως άνευ ηλεκτροδίων
electron capture detector	ανιχνευτής συλλήψεως ηλεκτρονίων
electron impact ionization source	πηγή ιονισμού με πρόσκρουση ηλεκτρονίων
electron multiplier	ηλεκτρονιοπολλαπλασιαστής
electronic scaler	ηλεκτρονικός κλιμακωτής
element specific chromatography	ειδική χρωματογραφία στοιχείων
eluent strength	ισχύς εκλούσεως
elution	έκλουση
elutropic series	εκλουτροπική σειρά
emission spectrum	φάσμα εκπομπής
estimator	εκτιμήτρια
evaluation	αξιολόγηση
exchange capacity	ανταλλακτική χωρητικότητα
excitation spectrum	φάσμα διέγερσης
expected value	αναμενόμενη τιμή
extinction	απόσβεση
extracta	εκχυλίσματα
extrapolation	προέκταση
factorial analysis	παραγοντική ανάλυση
faradaic cup	φαρανταϊκό κύπελλο
fiber optics	οπτικές ίνες
field ionization source	πηγή ιονισμού με πεδίο
fingerprint region	περιοχή αποτυπωμάτων
finite population	πεπερασμένος πληθυσμός
flame ionization detector	ανιχνευτής ιονισμού φλόγας
flash chromatography	χρωματογραφία παλμού
flow injection analysis	εισαγωγή δείγματος σε ροή
fluctuations	διακυμάνσεις
fluorescence quantum yield	συντελεστής κβαντικής απόδοσης φθορισμού
fluorescense probe technique	τεχνική φθορίζοντος ανιχνευτή
formulation	σκεύασμα
fraction collector	κλασματοσυλλέκτης
fractionation range	περιοχή κλασματώσεως
freezing point	σημείο πήξεως
front face fluorescense technique	τεχνική φθορισμού εμπρόσθιας όψεως
gas chromatography with static head-space injection	αέρια χρωματογραφία υπερκείμενης φάσεως
Gauss distribution	κατανομή κατά Gauss ή καμπύλη κανονικής κατανομής
gel filtration	διήθηση γέλης
gel permeation	διαπερατότητα γέλης
general average	γενική μέση τιμή
glass electrode	ηλεκτρόδιο υάλου
glassy carbon disk electrode	ηλεκτρόδιο υαλώδους άνθρακα
gradient	βαθμίδωση
gradient elution	βαθμιδωτή έκλουση
gross sample	χονδρικό δείγμα
hollow-cathode lamp	λυχνία κοίλης καθόδου
hyphenated techniques	συνδυασμένες τεχνικές
immunoprecipitation	ανοσοκαθίζηση
impurity test	έλεγχος προσμίξεων
in house methods	εσωτερικές μέθοδοι
in process control	έλεγχος κατά τη διάρκεια παραγωγής
increment	δόση
indeterminate error	ακαθόριστο σφάλμα
indicator electrode	ενδεικτικό ηλεκτρόδιο
Inductively Coupled Plasma (ICP)	επαγωγικά συζευγμένο πλάσμα
intercept	τομή επί της αρχής
interface	διασύνδεση
interference filters	φίλτρα συμβολής
interferogram	συμβολόγραμμα
interlaboratory	διεργαστηριακό
internal standard	εσωτερικό πρότυπο
internal standard method	μέθοδος εσωτερικού προτύπου
interpercentile range	εύρος μεταξύ ποσοστημοριακών σημείων
interquartile range	περιοχή τεταρτημορίων
ion selective electrode	εκλεκτικό ηλεκτρόδιο ιόντων
ion trap	παγίδευση ιόντων
ion-exchange	ιονανταλλαγή
ion-pair extraction photometry	φωτομετρία εκχύλισης συζευγμένων ιόντων ή συμπλόκων μεταλλοϊόντων
Ionic Strength Adjustor (ISA)	ρυθμιστής ιονικής ισχύος
ionization buffer	ρυθμιστής ιονισμού
isotope dilution analysis	ανάλυση με ισοτοπική αραίωση
isotopic abundance	ισοτοπική αφθονία
kurtosis	κύρτωση
labelled antigen	επισημασμένο αντιγόνο
laboratory bias	συστηματικό σφάλμα (ή μεροληψία) εργαστηρίου
lack of fit	έλλειψη προσαρμογής
least squares fit method	μέθοδος προσαρμογή ελαχίστων τετραγώνων
level of the test in a precision experiment	επίπεδο δοκιμασίας σε πείραμα επαναληψιμότητας
liberation factor	παράγοντας απελευθέρωσης
limit test	έλεγχος ορίου
linear dynamic range	γραμμική δυναμική περιοχή
liquid junction potential	δυναμικό διαχύσεως ή δυναμικού υγρού συνδέσμου
liquid-liquid extraction	εκχύλιση υγρό-υγρό
log-normal	λογαριθμοκανονικός
lot	παρτίδα
masking	κάλυψη
matrix effect	επίδραση φέροντος υλικού (μήτρας)
mean	μέση τιμή
median	διάμεση τιμή
melting point	σημείο τήξεως
mesh	οπές ανά ίντσα
metastable peaks	μετασταθείς κορυφές
migration	όδευση
mode	επικρατούσα τιμή
molecular exclusion	μοριακός αποκλεισμός
mull	γλίσχρασμα
noise	θόρυβος (σήμα υποβάθρου)
normal distribution	κανονική κατανομή
null hypothesis	μηδενική υπόθεση
observed value	παρατηρούμενη τιμή
one tailed test	δοκιμασία ενός άκρου
operator bias	προκατάληψη χειριστή
optical density	οπτική πυκνότητα
oscillator strength	ισχύς ταλαντωτού
outlier	έκτροπη τιμή
packed column chromatography	χρωματογραφία πληρωμένων στηλών
paired	κατά ζεύγη
paired t-test	δοκιμασία t κατά ζεύγη
paramagnetic deshielding	παραμαγνητική αποπροστασία
particle size distribution factor	παράγοντας σωματιδιακής κατανομής
partition	κατανομή
pattern of residuals	διαγράμματα υπολοίπων
pellicular particles	υμενοειδή σωματίδια
photodiode arrays	σειρές φωτοδιόδων
photomultipliers	φωτοπολλαπλασιαστές
photon counter	απαριθμητής φωτονίων
phototubes	φωτολυχνίες
pIon meter	πιονόμετρο (αντίστοιχο του πεχαμέτρου)
planarity	επιπεδότητα
plot	διάγραμμα
pooled	συνδυασμένη
population sample	πληθυσμιακό δείγμα
precision	πιστότητα
probe displacement	εκτόπιση ιχνηθέτη
programmed-temperature	θερμοπρογραμματιζόμενος
propotional error	αναλογικό σφάλμα
quadrapole mass analyzers	τετραπολικοί αναλυτές μαζών
quality assurance	διασφάλιση ποιότητας
quality control	έλεγχος ποιότητας
quantification limit	όριο προσδιορισμού
quantitation limit	όριο ποσοτικοποίησης
quenching	απόσβεση
quenching gas	αέριο αποσβέσεως
radiotracer	ραδιενεργός ιχνηθέτης
random error	τυχαίο σφάλμα
range	εύρος ή δειγματική διακύμανση
rapid-scanning spectrophotometer	φασματοφωτόμετρο ταχείας σάρωσης
recovery	ανάκτηση
reference electrode	ηλεκτρόδιο αναφοράς
reflectance spectrophotometry	ανακλαστική φασματοφωτομετρία
regression line	ευθεία παλινδρόμησης ή συμμεταβολής
relative error	σχετικό σφάλμα
relative standard deviation	σχετική τυπική απόκλιση
releaser	αποδεσμευτής
reliability	αξιοπιστία
repeatability	επαναληψιμότητα
repeatability coefficient of variation	συντελεστής διακύμανσης της επαναληψιμότητας
repeatability conditions	συνθήκες επαναληψιμότητας
repeatability standard deviation	τυπική απόκλιση επαναληψιμότητας
repeatability variance	διακύμανση επαναληψιμότητας
replicates	επαναλαμβανόμενες μετρήσεις ή προσδιορισμοί
reproducibility	αναπαραγωγιμότητα
residual	υπόλοιπο
resolution	διαχωριστικότητα
resolving power	διαχωριστική ικανότητα ή δύναμη
response fumction	συνάρτηση απόκρισης
response time	χρόνος αποκρίσεως
robust estimator	ανθεκτική εκτιμήτρια
robustness	ανθεκτικότητα
ruggedness	αντοχή
run	προσδιορισμός
salting out effect	εξαλάτωση
sample throughput	ταχύτητα αναλύσεως δειγμάτων
sampling	δειγματοληψία
saturators	κορεστές
scanning	σάρωση
scattering	διασπορά
scintillation counter	απαριθμητές σπινθηρισμού
screening methods	μέθοδοι διαλογής
segretation	διαχωρισμός
selectivity	εκλεκτικότητα
sensitivity	ευαισθησία
sensor	αισθητήρας
sep-pak	προσυσκευασμένα μικροφυσίγγια μίας χρήσεως
separator column	στήλη διαχωρισμού
septum	παχύ διάφραγμα από θερμοανθεκτικό ελαστικό
set	ομάδα
shear rate	ταχύτητα περιστροφής
shift reagents	αντιδραστήρια μετατοπίσεως
signal to noise ratio (S/N)	αναλογία σήματος προς θόρυβο
silylation	σιλανοποίηση
single focusing analyzers with magnetic deflection	αναλυτές απλής εστιάσεως με μαγνητική εκτροπή
skewness	ασσυμμετρία
slope	κλίση
solid phase extraction	εκχύλιση στερεάς φάσης
spark ionization source	πηγή ιονισμού με σπινθήρα
specifity	ειδικότητα
specimen	δοκίμιο
spectrochemical buffer	φασματοχημικός ρυθμιστής
specular reflection	κατοπτρική ανάκλαση
spiked samples	ενισχυμένα ή εμβολιασμένα δείγματα
spin-spin coupling	σύζευξη spin-spin
spinning side-bands	πλευρικές ζώνες λόγω περιστροφής
spline technique	τεχνική σφήνας
standard addition method	μέθοδος προσθήκης γνωστών ποσοτήτων
standard deviation	τυπική απόκλιση
standard error	τυπικό σφάλμα
standard stock solution	πρότυπο διάλυμα παρακαταθήκης
steady state	στατική ή σταθεροποιημένη κατάσταση
stopped-flow spectrophotometer	φασματοφωτόμετρο αναχαιτιζόμενης ροής
straggler value	ακατάστατη τιμή
stratified sampling	δειγματοληψία κατά στρώσεις (διαστρωματοποιημένη)
stratum	στώση ή στρώμα
stray light	παράσιτη ακτινοβολία
stripping voltammetry	αναδιαλυτική βολταμμετρία
sum of square residuals	άθροισμα των τετραγώνων των υπολοίπων
sum of weighted squares	άθροισμα των ζυγισμένων τετραγώνων
supercon	υπεραγώγιμο πηνίο
suppressor column	στήλη καταστολής
systematic error	σφάλμα συστηματικό
tandem mass spectrometry	δίδυμη φασματομετρία μαζών MS/MS
test result	αποτέλεσμα δοκιμασίας
thermal conductivity detector	ανιχνευτής θερμικής αγωγιμότητας
thermospray	θερμοψεκασμός
time lag	χρόνος υστέρησης
time-of-flight analyzers	αναλυτές χρόνου πτήσεως
tincturae	βάμματα
Total Ionic Strength Adjustment Buffer (TISAB)	μεικτός ρυθμιστής ιονικής ισχύος-οξύτητας
total sum of squares	ολικό άθροισμα των τετραγώνων
total variance	ολική διακύμανση
transmittance	διαπερατότητα
trend	τάση
trimmed mean value	ρυθμισμένη μέση τιμή
trimming percentage	εκατοστιαίο ποσοστό ρύθμισης
trueness	αληθότητα
tubular carbon electrode	ηλεκτροχημικό ανιχνευτής άνθρακα τύπου σωλήνα
tunable dye lasers	λέηζερ χρωστικών με επιλογή μήκους κύματος
two tailed test	δοκιμασία δύο άκρων
uncertainty	αβεβαιότητα
univariate regression	μονοπαραμετρική παλινδρόμηση (ή προσαρμογή)
unpaired	μη κατά ζεύγη
validation	επικύρωση
variance	διακύμανση
verification	επιβεβαίωση
vibrations, bending	δονήσεις, κάμψεως
vibrations, rocking	δονήσεις, λικνιζόμενες
vibrations, scissoring	δονήσεις, ψαλιδοειδείς
vibrations, skeletal or breathing	δονήσεις, σκελετού ή αναπνοής
vibrations, stretching	δονήσεις, τάσεως ή εκτατικές
vibrations, twisting	δονήσεις, συστρεφόμενες
vibrations, wagging	δονήσεις, παλλόμενες
void volume	κενός όγκος
volatilizer	εξαερωτής
wall-jet detector	ανιχνευτής πίδακα στον τοίχο
weighted least squares regression	ζυγισμένη παλινδρόμηση ελαχίστων τετραγώνων
within run	εντός προσδιορισού
within sample	ενδοδειγματική
working electrode	ηλεκτρόδιο εργασίας
standard commercially available medicine / drug / medication	κανονικό φάρμακο του εμπορίου
randomised / randomized	τυχαιοποιηθεί
crow's feet	πόδι της χήνας
αντίσωμα αντι-α4-ιντεγκρίνης	anti-alpha 4 integrin antibody
APICAL 4-CHAMBER VIEW	κορυφαία προβολή/λήψη/τομή 4 κοιλοτήτων
APICAL 4-CHAMBER VIEW	κορυφαία τομή/προβολή/λήψη 4 κοιλοτήτων
athlete's foot	πόδι του αθλητή/επιδερμοφυτία των μεσοδακτύλιων πτυχών
βασικοκυτταρικό καρκίνωμα	basal cell carcinoma
become dependent on	εμφανίζω εξάρτηση (από το φάρμακο)/εμφανίζω εθισμό (στο φάρμακο)/εθίζομαι (στο φάρμακο)
Calcification of mitral annulus	ασβέστωση του μιτροειδικού δακτυλίου
Αγγειοεγκεφαλικό επεισόδιο	cerebrovascular accident
ρυθμιστής συνδιέγερσης	co stimulation modulator
επιφανειακό αντιγόνο της ηπατίτιδας Β (HBsAg)	hepatitis B surface antigen (HBsAg)
radiculopathy	ριζοπάθεια
rituximab	ριτουξιμάμπη
rheumatoid arthritis	ρευματοειδής αρθρίτιδα
nifedipine	Νιφεδιπίνη
renal failure	Νεφρική ανεπάρκεια
trigeminal neuralgia	Νευραλγία τριδύμου
neuropathic pain	Νευροπαθητικός πόνος
Rheumatic autoimmune disease	Ρευματική αυτοάνοση νόσος
atypical facial pain	άτυπος πόνος προσώπου
Herpes zoster	έρπης ζωστήρ
Foot ulcer	έλκος άκρου ποδός
platelet counts	αριθμός αιμοπεταλίων
arterial hypertension	αρτηριακή υπέρταση
azathioprine	αζαθειοπρίνη
h(a)emostatic bandage/dressing	αιμοστατικη περιδεση
alkaline phosphatase	αλκαλική φωσφατάση
alanine aminotransferase (ALT)	αμινοτρανσφεράση αλανίνης
TNF-inhibitors	αναστολείς TNF
serum human chorionic gonadotropin	ανθρώπινη χοριονική γοναδοτροπίνη ορού
anti-CD20 monoclonal antibody	αντι-CD20 μονοκλωνικό αντίσωμα
reactive arthritis	αντιδραστική αρθρίτιδα
calcium	ασβέστιο
aspartate aminotransferase (AST)	ασπαρτική αμινοτρανσφεράση
cervical spine	αυχενική μοίρα σπονδυλικής στήλης (ΑΜΣΣ)
cervical syndrome	αυχενικό σύνδρομο
stratified squamous epithelium detritus	αποτρίμματα πολύστιβου πλακώδους επιθηλίου
absolute neutrophil count	απόλυτος αριθμός ουδετερόφιλων
absolute differential	απόλυτος διαφορικός τύπος
abscess	απόστημα
Bronchial asthma	βρογχικό άσθμα
biomarker	βιοδείκτης
venlafaxine	βενλαφαξίνη
gadolinium	γαδολίνιο
gadolinium diethylenetriamine pentaacetic acid	γαδολίνιο-διαιθυλενοτριαμινοπενταοξικό οξύ
gliburide	γλιβουρίδη
gliclazide	γλικλαζίδη
glimepiride	γλιμεπιρίδη
glucocorticoids	γλυκοκορτικοειδή
random glucose	γλυκόζη τυχαίας μέτρησης
diabetic retinopathy	διαβητική αμφιβληστροειδοπάθεια
Diabetic neuropathy	διαβητική νευροπάθεια
remittent	διαλείπων
joint structural damage	δομική βλάβη στην άρθρωση
Douglas space/pouch/cul-de-sac	δουγλάσειος χώρος
neuropathy secondary to tumor infiltration	δευτερογενής νευροπάθεια λόγω διήθησης όγκου
secondary limited cutaneous vasculitis	δευτερογενής περιορισμένη δερματική αγγειίτιδα
ischiopubic ramus	ηβοισχιακός κλάδος
echogenic	ηχογενή
rescue treatment	θεραπεία διάσωσης
thoracic pain	θωρακαλγία
irvesartan	ιρβεσαρτάνη
Highmore's antrum/Antrum Highmori/Antrum of Highmore/maxillary sinus	ιγμόρειο
popliteal artery	ιγνυακή αρτηρία
interferon	ιντερφερόνη
sciatica	ισχιαλγία
creatinine	κρεατινίνη
tibial nerve lesion	κάκωση κνημιαίου νεύρου
potassium	κάλιο
lumbar hernia	κήλη ΟΜΣΣ
causalgia	καυσαλγία
captopril	καπτοπρίλη
clopidogrel	κλοπιδογρέλη
pruritus, itching	κνησμός
cyclic citrullinated peptide (CCP)	κυκλικό κιτρουλινικό πεπτίδιο
circulatory failure	κυκλοφορική ανεπάρκεια
cyclophosphamide	κυκλοφωσφαμίδη
albumin	λευκωματίνη
phantom limb	μέλος φάντασμα
meningioma	μηνιγγίωμα
mixed connective tissue disease	μικτή νόσος του συνδετικού ιστού
isosorbide mononitrate	μονονιτρικός ισοσορβίτης
excessive sleepiness	μεγάλη υπνηλία
methotrexate	μεθοτρεξάτη
methylprednisolone	μεθυλπρεδνισολόνη
metacarpophalangeal joint	μετακαρπιοφαλαγγική άρθρωση
post-traumatic pain	μετατραυματικός πόνος
post operative	μετεγχειρητικός
metformin	μετφορμίνη
mycophenolate mofetil	μυκοφαινολική μοφετίλη
sodium	νάτριο
Wegener disease	νόσος του Wegener
juvenile idiopathic arthritis	νεανική ιδιοπαθής αρθρίτιδα
occipital neuralgia	νευραλγία ινιακού
facial neuralgia	νευραλγία προσώπου
rectum	ορθό
seronegative spondyloarthropathy	οροαρνητική σπονδυλοαρθροπάθεια
uvular oedema	οίδημα της σταφυλής
total bilirubin	ολική χολερυθρίνη
total protein	ολική πρωτεΐνη
bone erosions	οστικές διαβρώσεις
osteitis	οστεΐτιδα
knee osteoarthritis	οστεοαρθρίτιδα γονάτου
osteomyelitis	οστεομυελίτιδα
Osteomyelitis of the right lower extremity	οστεομυελίτιδα του δεξιού κάτω άκρου
osteoporosis	οστεοπόρωση
lumbar portion of the spine	οσφυϊκή μοίρα της σπονδυλικής στήλης (ΟΜΣΣ)
urea	ουρία
gout	ουρική αρθρίτιδα
uric acid	ουρικό οξύ
urinary tract infection	ουρολοίμωξη
Non-Steroidal Anti-Inflammatory Drugs (NSAIDs)	Μη στεροειδή αντιφλεγμονώδη φάρμακα (ΜΣΑΦ)
complex regional pain syndrome	σύνδρομο σύμπλοκου περιοχικού πόνου
Popliteal artery entrapment syndrome	σύνδρομο παγίδευσης ιγνυακής αρτηρίας
sarcoma	σάρκωμα
multiple sclerosis	σκλήρυνση κατά πλάκας
scleroderma	σκληροδερμία
sulfasalazine	σουλφασαλαζίνη
angina	στηθάγχη
Coronary disease	στεφανιαία νόσος
systemic lupus erythematosus	συστηματικός ερυθηματώδης λύκος
spondylodesis	σπονδυλοδεσία
mental disorder	ψυχική νόσος
psoriatic arthritis	ψωριασική αρθρίτιδα
brain stem	εγκεφαλικό στέλεχος
implanted cardiac defibrillator	εμφυτεύσιμος καρδιακός απινιδωτής
Intra-articular (iart) glucocorticoids	ενδοαρθρικά γλυκοκορτικοειδή
eruption	εξάνθημα
painful diabetic neuropathy	επώδυνη διαβητική νευροπάθεια
selective B cell targeted therapy	επιλεκτική θεραπεία με στόχο τα κύτταρα B
hematocrit	Αιματοκρίτης
haemophilia	Αιμορροφιλία
Hemoglobin	Αιμοσφαιρίνη
allodiny	Αλλοδυνία
allopurinol	Αλοπουρινόλη
CVA	ΑΕΕ
Blood chemistry	Βιοχημικές εξετάσεις αίματος
right hemiplegia	Δεξιά ημιπληγία
uterine cervix (και cervix uteri)	τράχηλος της μήτρας
artificial kidney	τεχνητός νεφρός
phosphorous	φώσφορος
flunitrazepam	φθοριονιτραζεπάμη
inflammatory myopathy	φλεγμονώδης μυοπάθεια
inflammatory bowel disease	φλεγμονώδης νόσος του εντέρου
furosemide	φουροσεμίδη
chronic bronchitis	χρόνια βρογχίτιδα
chloride	χλώριο
cholangiocarcinoma	χολαγγειοκαρκίνωμα
Health Assessment Questionnaire (HAQ)	Ερωτηματολόγιο αξιολόγησης υγείας
longitudinal	ΕΠΙΜ. (Επιμήκης)
transverse	ΕΓΚ. (εγκάρσιος)
(specialist) registrar	Επιµελήτρια Β
hydroxychloroquine	υδροξυχλωροκίνη
synovitis	υμενίτιδα
high blood pressure	υπέρταση
Hypothyroidism	υποθυρεοειδισμός
supraglottic larynx	υπεργλωττιδικός λάρρυγας
supraglottic larynx	υπερλωττιδικός λάρρυγας
prednisone	πρεδνιζόνη
iron proteinate	πρωτεϊνικός σίδηρος
Pelvis	πύελος
tumor necrosis factor (TNF)	παράγοντας νέκρωσης των όγκων (TNF)
pain of central origin	πόνος κεντρικής αιτιολογίας
fasciitis	περιτονιΐτιδα
peripheral arteriopathy	περιφερική αρτηριοπάθεια
laminectomy	πεταλεκτομή
Peptic ulcer	πεπτικό έλκος
hepatitis B core antibody (HBcAb)	πυρηνικό αντιγόνο της ηπατίτιδας Β (HBcAb)
mannerism	ιδιομορφία/ εκζήτηση/ ασύνηθες χαρακτηριστικό κίνησης, ενέργειας ή ομιλίας
myocardial infarction	έμφραγμα (του) μυοκαρδίου
occupational therapist	εργοθεραπευτής
pack-years	πακέτα/έτη, πακέτα-έτη
palliative care	παρηγορητική/ανακουφιστική φροντίδα/αγωγή
parasternal long axis view	παραστερνική λήψη κατά τον επιμήκη άξονα
parasternal long axis view	παραστερνική λήψη/τομή κατά τον επιμήκη άξονα
parasternal long axis view	παραστερνική τομή/λήψη κατά τον επιμήκη άξονα
από του στόματος	per os (p.o.)
potentiator	ενισχυτής (δράσης)
pulse oximeter	παλμικό οξύμετρο
SNP(s) Single Nucleotide Polymorphism(s)	μονονουκλεοτιδικός(-οί) πολυμορφισμός(-οί)
Spontaneous contrast in the left atrium	αυτόματη (ηχο)αντίθεση στον αριστερό κόλπο
ακανθοκυτταρικό καρκίνωμα	squamous cell carcinoma
vaginal speculum	μητροσκόπιο
varus/valgus	ραιβός/βλαισός
Absorption	Απορρόφηση
Acoustic lens	Ακουστικός φακός
Acoustic lenses or curved elements as a means of focusing the beam	Ακουστικοί φακοί ή καμπύλα στοιχεία σαν μέσο εστίασης της δέσμης
Acoustic mirror	Ακουστικός καθρέπτης
Activation	Ενεργοποίηση
Aliasing	Ψευδής μετατόπιση
Analog - to - digital converter	Μετατροπέας αναλογικού σε ψηφιακό σήμα
Analog echo signals	Αναλογικά σήματα ήχων
Analog to digital converter	Ψηφιακός μετατροπέας
Angle of beam incidence	Γωνία πρόσπτωσης της δέσμης
Annular array, oscillating	Διάταξης δακτυλίου, ταλαντούμενος
Annular phased array sector transducer	Σύστημα δακτυλίου κατά φάση τομέα ανιχνευτού
Annular phased arrays	Διατάξεις δακτυλίου κατά φάση
Array focusing	Εστίαση συστήματος
Articulated arm (static) b-scanners	Στατικοί β-υπερηχοτομογράφοι με βραχίονα
As low as reasonably achievable (alara)	Σε τόσο χαμηλά επίπεδα όσο είναι λογικά κατορθωτό
Attenuation	Εξασθένηση
Audible range	Περιοχή ακουστών ήχων
Audible tone	Ακουστός ήχος
Axial resolution	Αξονική διακριτική ικανότητα
Backing material	Υλικό ελέγχου οπισθοσκέδασης
Beam focusing	Εστίαση δέσμης
Beam formation	Σχηματισμός δέσμης
Beam shape and focus	Σχήμα δέσμης και εστία
Beam steering	Σάρωση της δέσμης
Bioeffects and safety of doppler ultrasound devices	Βιολογικά αποτελέσματα από τη δράση υπερήχων doppler - ασφάλεια συστημάτων
Bioeffects mechanisms	Μηχανισμοί βιολογικής δράσης
Bursts of ultrasound	Παλμοί υπερήχων
Cavitation	Κοιλοποίηση
Cavitation nuclei	Πυρήνες κοιλοποίησης
Color - display	Χρωματική απεικόνιση φοράς ροής
Color - filter	Φίλτρο (συχνότητας έγχρωμου doppler)
Color doppler sonography (cds)	Απεικόνιση με έγχρωμο doppler (triplex)
Color doppler sonography controls	Παράμετροι απεικόνισης με έγχρωμο doppler
Color doppler sonography instrumentation	Υπερηχοτομογράφοι έγχρωμου doppler
Color gain	Ενίσχυση χρώματος
Color- write priority	Επιλογή χρήσης χρώματος
Computed sonography	Υπολογιστική υπερηχοτομογραφία
Concentric rings	Ομόκεντροι δακτύλιοι
Constantly scanning beam	Δέσμη συνεχούς σάρωσης
Continuous wave ultrasound	Συνεχές κύμα υπερήχων
Contrast resolution	Αντίθεση (διαβαθμίσεις αντίθεσης)
Coupled directly	Σε άμεση επαφή
Coupling gel	Ακουστικό ζελέ
Coupling interface	Ενδιάμεσο υλικό
Cross - talk	Διαπλοκή
Curved linear array	Καμπύλη διάταξη
Curved linear array transducers	Καμπύλα εν σειρά συστήματα ανιχνευτών
Damping material	Υλικό απόσβεσης
Data pre-processing and digital image formation	Επεξεργασία σημάτων και σχηματισμός ψηφιακής εικόνας
Delayed pulse sequences	Ακολουθίες παλμών (ενεργοποιημένες διαδοχικά)
Depth setting	Καθορισμός του βάθους
Diagram depicting side lobes generated by linear array transducer	Διάγραμμα πλάγιων ενεργειακών λοβών σε γραμμικό ανιχνευτή
Digital scan converter	Ψηφιακός μετατροπέας σάρωσης
Diverging	Αποκλίνον
Doppler effect	Φαινόμενο doppler
Doppler shift	Μετατόπιση doppler
Doppler transducer	Ανιχνευτής doppler
Doppler ultrasound	Φαινόμενο doppler με υπερήχους
Driven simultaneously	Ενεργοποιούνται ταυτόχρονα
Dynamic apodization	Δυναμική μεταβολή ενίσχυσης
Dynamic focusing	Δυναμική εστίαση
Dynamic range	Δυναμικό εύρος
Echo image	Εικόνα ανακλάσεων
Echo rotor	Κινητήρας κρυστάλλων
Effect of digital memory size relative to image smoothness	Επίδραση ψηφιακής μνήμης στη βελτίωση της εικόνας
Electrical connector	Ηλεκτρική επαφή
Electro-mechanic motor	Ηλεκτρομηχανικός κινητήρας
Electronic focusing	Ηλεκτρονική εστίαση
Electronic scanner	Ηλεκτρονικός υπερηχοτομογράφος
Electronically steered transducer	Ηλεκτρονικά οδηγούμενος ανιχνευτής
Element oscillating	Ταλαντούμενο στοιχείο
Element rotating wheel	Στοιχεία σε περιστρεφόμενο τροχό
Ensemble length	Ζεύγη παλμών
Ensurement of adequate acoustic coupling	Επίτευξη επαρκούς ακουστικής ζεύξης
Epoxy face	Επάλειψη εποξικής ρητίνης
Exposure at intensities typical of present diagnostic ultrasound instruments	Έκθεση σε εντάσεις των διαγνωστικών μηχανημάτων υπερήχων
External focusing	Εξωτερική εστίαση
Face material	Πρόσθια επιφάνεια
Fixed radius of curvature	Σταθερή ακτίνα καμπυλότητας
Fluid filled silastic coupling boot	Αποσβένον υλικό
Focal range	Εστιακή ζώνη
Focused beam intensities	Εντάσεις εστιασμένης δέσμης
Focusing and steering	Εστιασμός και σάρωση
Formation and steering by pulse timing	Σχηματισμός και καθοδήγηση με χρονική ενεργοποίηση του παλμού
Fourier transformation	μετασχηματισμός fourier
Framing rate	Ρυθμός σάρωσης
Free - field spatial peak, temporal average for continuous wave and pulsed exposures	Χωρικό μέγιστο, χρονικό μέσο, για έκθεση σε συνεχές και παλμικό κύμα
Frequency envelopes in plug vs. Laminar flow	Κατανομή συχνοτήτων σε στρωτή και στρωματική ροή
Ghosting	Ψευδής καταγραφή
Grating lobes	Κροσσωτοί λοβοί
High speed parallel processors under program control driving multielement array transducers, have made it possible to dynamically vary pulsing and rec	Παράλληλοι επεξεργαστές μεγάλης ταχύτητας, σε ανιχνευτές πολλαπλών στοιχείων, δίνουν τη δυνατότητα δυναμικής μεταβολής του σήματος του παλμού και των
Highly reflective acoustic interface	Υψηλής ανάκλασης ακουστική επιφάνεια
Idicator of cavitation activity	Δείκτης κοιλοποίησης
Image artifacts	Ψευδείς εικόνες
Image documentation	Αποτύπωση εικόνας
Image storage and display	Αποθήκευση εικόνας και απεικόνιση
Incident beam	Προσπίπτουσα δέσμη
Infinite gate	Απεριόριστη πύλη
Intensity profile	Κατανομή εντάσεων
Internal focusing	Εσωτερική εστίαση
Intraluminar transducer probes	Ενδοσκοπικοί ανιχνευτές
Laminar flow	Στρωματική ροή
Large aperture transducer	Ανιχνευτής ευρείας διάταξης
Lateral resolution	Πλάγια διακριτική ικανότητα
Length of sample volume	Μήκος όγκου αναφοράς
Length of the transmitted burst	Μήκος εκπεμπόμενου παλμού
Limited echo dynamic range	Περιορισμένο δυναμικό εύρος ανακλάσεων
Line density	Πυκνότητα γραμμών
Linear array transducers	Γραμμικά συστήματα ανιχνευτών (μεγάλου εύρους)
Low - viscosity body liquids	Υγρά σώματος χαμηλού ιξώδους
5-hydroxytryptamine	σεροτονίνη, 5-υδροξυτρυπταμίνη
Achilles' tendonitis	τενοντίτιδα του αχίλλειου τένοντα
acupuncture	βελονισμός
adrenal medulla	μυελώδης ουσία των επινεφριδίων
amygdala	αμυγδαλοειδές σώμα
anesthetic	αναισθητικό
aneurysm	ανεύρυσμα
anticoagulant therapy	αντιπηκτική θεραπεία
arteriosclerosis	αρτηριοσκλήρωση
artifactual	ψευδής, εικονική, ως αποτέλεσμα ψευδούς ευρήματος
asthma	άσθμα
autoimmune response	αυτοανοσοαντίδραση
autonomic nervous system	αυτόνομο νευρικό σύστημα
bilateral	αμφίπλευρος
birth size	σωματικό βάρος και ύψος γέννησης
bradykinin	βραδυκινίνη
brainstem	εγκεφαλικό στέλεχος
cane length	μήκος μπαστουνιού
carotid artery	καρωτίδα αρτηρία
catecholamines	κατεχολαμίνες
cavum septi pellucidi	κυστη διαφανούς διαφράγματος
cellulite	κυταρίττιδα
cerebellum	παρεγκεφαλίδα
cerebrospinal fluid	εγκεφαλονωτιαίο υγρό
chiropractic	χειροθεραπευτική
cholecystokinin	χοληκυστοκινίνη
chronic pain syndrome	σύνδρομο χρόνιου πόνου
circadian rhythm	κιρκαδικός ρυθμός
circulatory disorders	διαταραχές του κυκλοφορικού
clinical research trial	κλινικές δοκιμές, κλινικές έρευνες
clinical setting	κλινικό περιβάλλον, χώρος εργασίας
clinician	θεραπευτής
cochlea	κοχλίας
cold packs	ψυχρά επιθέματα
concatemer	αλυσομερές
constitunionally activated tyrosine kinase	(ιδιο)συστατικά ενεργοποιημένη κινάση (της) τυροσίνης
contraindications	αντενδείξεις
contralateral	ετερόπλευρος
cornea	κερατοειδής χιτώνας
council for professions supplementary to medicine (CPSM)	Συμβούλιο παραϊατρικών επαγγελμάτων
defence response	αμυντική αντίδραση, αμυντική απόκριση
dendrite	δενδρίτης
diagnosis	διάγνωση
distal pancreatomy	ουραία παγκρεατομή
dorsal horn	ραχιαίο κέρας
DP-like peptides	πεπτίδια που μοιάζουν με τη διπεπτιδυλική πεπτιδάση
edema	οίδημα
electrical stimulation	ηλεκτρική διέγερση
endocrine inadequacies	ενδοκρινείς ανεπάρκειες
endorphins	ενδορφινές
endplate	τελική πλάκα, τελική κινητική πλάκα
energy crisis	ενεργειακή κρίση
enzymes	ένζυμα
ethylene chloride	χλωριούχο αιθύλιο
external rotation	έξω στροφή
extrameridian	υπερμεσημβρινός
fatigue	κόπωση
Femoral Box	Μηριαίο ένθεμα (προσθετικού εμφυτεύματος)
flourimethane	φθορομεθάνιο
follow-up treatment	συμπληρωματική αγωγή, επαναληπτική θεραπεία, επαναληπτικές ασκήσεις,  μεταθεραπευτικές ασκήσεις, μετέπειτα θεραπεία, ενισχυτική θεραπεία/ υποστηρικτικ
foramen	διαμπερής κοιλότητα
forearm	αντιβράχιο
fossa	βόθρος
frontal lobe	μετωπιαίος λοβός
full-dose	συνολική δόση, πλήρης δόση
fusion takedown	αρθρόδεση, αρθροδεσία
gaba	γ-αμινοβουτυρικό οξύ
gama-aminobutyric acid	γ-αμινοβουτυρικό οξύ
goose bumps	ανατρίχιασμα
gravity drainage	παροχέτευση με ροή δια της βαρύτητας, παροχέτευση δια της βαρύτητας
growth cone	αυξητικός κώνος
hair loss	απώλεια τριχών
halo	(στερεοτακτική) στεφάνη
Health Visitor	Ιατρικός Επισκέπτης, Επισκέπτης Υγείας
heel pricks	τσιμπήματα στην πτέρνα, λήψη (τριχοειδικού) αίματος από τη πτέρνα (του νεογέννητου)
heel spur	πελματιαία περιτονίτιδα
heparin	ηπαρίνη
hippocampus	ιππόκαμπος
histamine	ισταμίνη
hot packs	θερμά επιθέματα
humerus	βραχιόνιο
hypoxia	υποξία
implantation spotting	αιμόρροια εκ διαφυγής, αιμορραγία από διαφυγή, αιμόρροια εμφύτευσης
inhibitor	αναστολέας
innervation ratio	αναλογία νεύρωσης
Inter- and intra-measurer	μετρήσεις του ίδιου χειριστή και μεταξύ των μετρήσεων
interexaminer reliability	αξιοπιστία μεταξύ των εξεταστών
internal rotation	έσω στροφή
interosseous	μεσόστεος
interrater reliability	αξιοπιστία μεταξύ των αξιολογητών
intrafusal fibers	ενδοατρακτιαίες ίνες
iontophoresis	ιοντοφόρεση
ipsilateral	ομόπλευρος
rural service	αγροτικό
specialty / post-graduate medical education	ειδικότητα
jugular vein	αυχενική φλέβα
killer grip	άρπαγμα, αντανακλαστικό της αρπαγής
killer grip	άρπαγμα, αντανακλαστικό της αρπαγής, αντανακλαστικό του δραγμού
kyphosis	κύφωση
leg length discrepancy	ανισοσκελία
linea aspera	τραχεία γραμμή
low-level laser therapy (LLLT)	αγωγή με λέιζερ χαμηλής ισχύος (ΑΛΧΙ)
malignancy	κακοήθεια
medial	μέσος
medial forebrain bundle	μέση τελεγκεφαλική δεσμίδα
Medical Claim Forms	έντυπα για ιατρικά έξοδα / έντυπα [αίτησης] αποζημίωσης για ιατρικά έξοδα
Medicin cabinet	κουτί πρώτων βοηθειών, φαρμακείο πρώτων βοηθειών
medulla oblongata	προμήκης μυελός
melatonin	μελατονίνη
meridians	μεσημβρινοί
mesio-distal diameter	εγγύς-άπω διάμετρος
metabolic inadequacies	μεταβολικές ανεπάρκειες
micronized platelet, PTZ	αιμοπετάλιο σε λεπτότατο διαμερισμό/ πολύ λεπτά σωματίδια, πυριθειονικού ψευδαργύρου
midpoint	μεσότητα
mitochondria	μιτοχόνδρια
modalities	τεχνικά θεραπευτικά μέσα
Montgomery's tubercles	θηλαία οζίδια, φυμάτια του Μontgomery
motor endplate	τελική κινητική πλάκα
moxotherapy	μοξοθεραπεία, θερμοκαυτηριασμός
Muzzy headedness	σύγχυση, ζάλη και θολούρα, ζαβλάκωμα
myelin	μυελίνη
National Institute of Allergy and Infectious Diseases (NIAID)	Εθνικό Ίδρυμα Αλλεργιών και Λοιμωδών Ασθενειών (των ΗΠΑ) [NIAID) ]
nervous system	νευρικό σύστημα
neuregulin	νεουρεγκιουλίνη, νευρορεγκιουλίνη, νευρεγκουλίνη
neurotransmitter	νευροδιαβιβαστής
neutronography	νετρονιογραφία, ακτινογραφία νετρονίων
nociceptive	αλγοϋποδεκτικός
nociceptor	αλγοϋποδοχέας
node	κόμβος, οζίδιο, όζος
nodular area	οζώδης περιοχή
nodularity	παρουσία οζιδίων
nodule	οζίδιο
non-productive cough	μη παραγωγικός βήχας
norepinephrine	νορεπινεφρίνη
obturator	αποφράκτης
occipital lobe	ινιακός λοβός
open rotator cuff repair	ανοιχτή επέμβαση αποκατάστασης των μυοτενοντοδών δομών που περιβάλλουν τον ώμο
Operating Department Personnel	προσωπικό Χειρουργικού Τμήματος, προσωπικό Τμήματος Χειρουργικής, προσωπικό Χειρουργείου
osteoporosis	οστεοπόρωση
palmar and volar	παλαμιαία και παλαμική
par asseys for chromosomal aberrations	δοκιμασίες/αναλύσεις πρωτεϊνικών υποδοχέων (PAR) για χρωμοσωμικές αποκλίσεις/παρεκκλίσεις/ανωμαλίες
parabronchial	παραβρογχικός
parapox (virus)	ψευδοευλογιά, ιός του λοιµώδους εκθύµατος
parasympathetic nervous system	παρασυμπαθητικό νευρικό σύστημα
pelvic obliquity	λοξότητα λεκάνης
phonophoresis	φονοφόρεση
pilomotor reflex	τριχοκινητικό αντανακλαστικό
pituitary gland	υπόφυση
postpacing interval (PPI)	μεταβηματοδοτικό διάστημα
premenstrual syndrome (PMS)	προεμμηνορυσιακό σύνδρομο (Π.Μ.Σ.)
procaine injection	ένεση προκαΐνης
Professions Supplementary to Medicine Act	Νόμος περί παραϊατρικών επαγγελμάτων
prominent myxoid change	προεξέχουσα μυξοειδής/ βλεννώδης μετατροπή
proprioceptive	ιδιοϋποδεκτικός
proprioceptor	ιδιοϋποδοχέας
prostaglandins	προσταγλανδίνες
PSIS	οπίσθια άνω λαγόνιος άκανθα [posterior superior iliac spines (PSIS)]
Ranvier's node	κόμβος του Ranvier
repetitive strain injury (RSI)	σύνδρομο υπερχρήσης
resectabiblity	εγχειρησιμότητα
rigor mortis	νερκική ακαμψία
rumen	μεγάλη κοιλία
sacrotuberus ligament	μείζων ισχιοϊερός σύνδεσμος
Saline	ορός, φυσιολογικός ορός
saline injection	ένεση με αλατώδες διάλυμα
salivation	σιελόρροια
scapula	ωμοπλάτη
scoliosis	σκολίωση
scope	ιατρικό όργανο απεικόνισης ή παρατήρησης (-σκόπιο)
Selective Serotonin Re-Uptake Inhibitors	Εκλεκτικοί Αναστολείς Επαναπρόσληψης της Σεροτονίνης
Senior Nurse Manager	Προϊστάμενος (ή Διευθυντής) Νοσηλευτικής Υπηρεσίας/Προϊστάμενος νοσηλευτών
sensitization	ευαισθητοποίηση
sensory cortex	αισθητικός φλοιός
sensory neurons	αισθητικοί νευρώνες
serum components	συστατικά του ορού
sleep disturbances	διαταραχές ύπνου
spasm	σύσπαση
SSRI	Εκλεκτικοί Αναστολείς Επαναπρόσληψης της Σεροτονίνης (Selective Serotonin Re-Uptake Inhibitors)
strength	περιεκτικότητα σε δραστική ουσία
sub trochanteric fracture	υποτροχαντήριο κάταγμα
subdural hematoma	υποδόριο αιμάτωμα
sweating	εφίδρωση
symptoms	συμπτώματα
temporal lobe	κροταφικός λοβός
thalamus	θάλαμος
treatment	θεραπεία, αγωγή
tuberosity	όγκωμα
ultrasound	υπέρηχοι
umbilical stump	κολόβωμα ομφαλίου λώρου
vapocoolant	ψυκτικό σπρέι
vasa placenta	προδρομικός πλακούντας
venous ventricle	αριστερή κοιλία
ventral root	κοιλιακή ρίζα
visceral	σπλαγχνικός
wicking effect	φαινόμενο τριχοειδικής διαρροής
proximal	εγγύς, εγγύτερος, κεντρικός
transversospinal muscles	εγκαρσιακανθώδεις μύες
risorius	γελαστήριος
stylohyoid	βελονοϋοειδής
deltoid	δελτοειδής
anconeus muscle	αγκωνιαίος μυς
arytenoideus transversus muscle	εγκάρσιος αρυταινοειδής μυς
genioglossus muscle	γενειογλωσσικός μυς
geniohyoid muscle	γενειοϋοειδης μυς
geniohyoideus muscle	γενειοϋοειδης μυς
gastrocnemius	γαστροκνήμιος
digastric	διγαστρικός
spinalis cervicis	ακανθώδης  αυχενικός
spinalis  capitis	ακανθώδης  κεφαλικός
spinalis thoracis	ακανθώδης  θωρακικός
ciliaris muscle	βλεφαριδικός μυς
stretch	διατείνω, τεντώνω
dilatores naris anterior and posterior	διαστολείς της μύτης πρόσθιοι και οπίσθιοι
dilitator of pupillae muscle	διαστολέας της κόρης του οφθαλμού
rectus capitis posterior minor	ελλάσων οπίσθιος ορθός κεφαλικός μυς
teres minor	ελλάσων στρογγύλος
biceps brachii	δικέφαλος βραχιόνιος
biceps femoris	δικέφαλος μηριαίος
lumbricales	ελμινθοειδείς του ποδιού
lumbricals	ελμινθοειδείς του ποδιού
antibrachial extensors	εκτείνοντες του αντιβράχιου
extend	εκτείνω
extensor indicis proprius	εκτείνων τον δείκτη
extensor pollicis brevis	εκτείνων τον αντίχειρα βραχύς
extensor pollicis lοngus	εκτείνων τον αντίχειρα μακρός
extensor digiti minimi	εκτείνων τον μικρό δάκτυλο
extensor communis digitorum muscle	εκτείνων τους δακτύλους
extensor digitorum	εκτείνων τους δακτύλους
muscle sensory receptors	αισθητικοί υποδοχείς του μυ
stretching	διάταση, τέντωμα
lingual muscle	γλωσσικός μυς
glossopalatinus muscle	γλωσσοϋπερώιος μυς
gluteus minimus	ελάσσων γλουτιαίος
obliquus capitis inferior muscle	ελάσσων λοξός κεφαλικός μυς
rhomboid minor	ελάσσων ρομβοειδής
rhomboideus minor	ελάσσων ρομβοειδής
palmaris brevis muscle	ελάσσων παλαμιαίος μυς
psoas minor muscle	ελάσσων ψοΐτης μυς
deep	εν τω βάθει
deep posterior tibial muscles	εν τω βάθει οπίσθιοι μύες της κνήμης
deep posterior crural muscles	εν τω βάθει οπίσθιοι μύες του μηρού
levator muscle	ανελκτήρας μυς
levator anguli oris	ανελκτήρας της γωνίας του στόματος
levator palati muscle	ανελκτήρας της μαλακής υπερώας
levator scapulae	ανελκτήρας της ωμοπλάτης
levator ani muscle	ανελκτήρας του απευθυσμένου
levator labii superioris muscle	ανελκτήρας του άνω χείλους
levator costae muscle	ανελκτήρας των πλευρών
levator alae nasi muscle	ανελκτήρας των πτερυγίων της ρινός
mylohyodeus muscle	γναθοϋοειδής μυς
mylohyoid	γναθοϋοειδής μυς
intrafusal	ενδοατρακτιαίος
suspensory of duodenum	αναρτήρας του δωδεκαδάκτυλου
accelerator urinae	βολβοσηραγγώδης μυς
bulbocavernosus	βολβοσηραγγώδης μυς
iliocostalis lumborum muscle	βουβωνικός λαγονοπλευρικός μυς
antibrachium	αντιβράχιο
forearm	αντιβράχιο
opponens pollicis	αντιθετικός του αντίχειρα
elevation of the shoulder	ανάσπαση του ώμου
striated muscles	γραμμωτοί μύες
striped muscles	γραμμωτοί μύες
short rotators	βραχείς περιστροφείς των νώτων
brachioradialis	βραχιοκερκιδικός
brachial muscle	βραχιόνιος μυς
brachialis muscle	βραχιόνιος μυς
triceps	βραχιόνιος τρικέφαλος
shorten	βραχύνω
extensor hallucis brevis	βραχύς εκτείνων τον μέγα δάκτυλο του ποδιού
extensor digitorum brevis	βραχύς εκτείνων τους δακτύλους του ποδιού
abductor pollicis brevis	βραχύς απαγωγός του αντίχειρα
flexor pollicis brevis	βραχύς καμπτήρας του αντίχειρα
flexor hallucis brevis	βραχύς καμπτήρας του μεγάλου δακτύλου του ποδιού
flexor brevis minimi digiti	βραχύς καμπτήρας του μικρού δακτύλου
flexor digiti quinti brevis	βραχύς καμπτήρας του μικρού δακτύλου
flexor digitorum brevis	βραχύς καμπτήρας των δακτύλων
extensor carpi radialis longus	βραχύς κερκιδικός εκτείνων τον καρπό
peroneus brevis	βραχύς περονιαίος
bronchoesophageus muscle	βρογχοεισοφάγειος μυς
brachium	βράχιο
shortening	βράχυνση
buccinator muscle	βυκανήτης μυς
fusal	ατρακτιαίος
cervicis	αυχενικός
spinalis cervicis muscle	αυχενικός ακανθεγκάρσιος μυς
iliocostalis cervicis muscle	αυχενικός λαγονοπλευρικός μυς
cervical spine	αυχενική μοίρα της σπονδυλικής στήλης
inferior gemellus	δίδυμος κάτω
superior gemellus	δίδυμος άνω
abductor	απαγωγός
abductor muscle	απαγωγός μυς
abductor digiti minimi	απαγωγός του μικρού δακτύλου
abductor digiti quinti	απαγωγός του μικρού δακτύλου
abductor digiti minimi pedis	απαγωγός του μικρού δακτύλου του ποδός
abductor digiti quinti pedis	απαγωγός του μικρού δακτύλου του ποδός
abductor ossis metatarsi quinti	απαγωγός των οστών του μετακαρπίου
epicranial	επικράνιος
epicranial occipitalis	επικράνιος ινιακός
epicranial frontalis	επικράνιος μετωπιαίος
piriformis	απιοειδής
longus capitis	επιμήκης κεφαλικός
longus colli	επιμήκης τραχηλικός
belly muscle	η γαστέρα του μυός
belly of the muscle	η γαστέρα του μυός
muscle belly	η γαστέρα του μυός
semitendinosus	ημιτενοντώδης
semimembranosus	ημιυμενώδης
iliocostalis thoracis	λαγονοπλευρικός θωρακικός
iliocostal muscle	λαγονοπλευρικός μυς
iliopsoas	λαγονοψοΐτης
iliac muscle	λαγόνιος μυς
iliacus muscle	λαγόνιος μυς
depressor muscle	καθελκτήρας μυς
depressor anguli oris	καθελκτήρας της γωνίας του στόματος
depressor labii inferioris	καθελκτήρας του κάτω χείλους
depressor septi nasi	καθελκτήρας του ρινικού διαφράγματος
depressor nasalis	καθελκτήρας του ρινικού διαφράγματος
depressor angulioris muscle	καθελκτήρας των άκρων του στόματος
depressor alae nasi muscle	καθελκτήρας των πτερυγίων της μύτης
depressor labii muscle	καθελκτήρας των χειλέων
muscle spindle function	λειτουργία της μυϊκής ατράκτου
popliteus	ιγνυακός
antibrachial flexors	καμπτήρες του αντιβράχιου
flexor digitorum profundus	καμπτήρας των δακτύλων του χεριού εν τω βάθει
flexor digitorum superficialis	καμπτήρας των δακτύλων του χεριού επιπολής
flexor ossis metacarpi muscle	καμπτήρας των οστών του μετακαρπίου
extensor carpi radialis	κερκιδικός εκτείνων τον καρπό
flexor carpi radialis	κερκιδικός καμπτήρας του καρπού
insertion	κατάφυση του μυός
muscle insertion	κατάφυση του μυός
depression of the shoulder	κατάσπαση του ώμου
smooth muscles	λείοι μύες
thin filament	λεπτό μικκύλιο
occipitofrontalis muscle	ινιακομετωπικός μυς
occipital muscle	ινιακός μυς
occipitalis muscle	ινιακός μυς
ventricularis	κοιλιακός
transversus abdominis	κοιλιακός εγκάρσιος
rectus abdominis	κοιλιακός ορθός
pyramidalis abdominis	κοιλιακός πυραμοειδής
coccygeus muscle	κοκκυγικός  μυς
oblique muscle	λοξός μυς
coracobrachial muscle	κορακοβραχιόνιος μυς
coracobrachialis muscle	κορακοβραχιόνιος μυς
cremaster muscle	κρεμαστήρας μυς
cricoarytenoideus muscle	κρικοαρυταινοειδής μυς
cricothyreoideus muscle	κρικοθυρεοειδής μυς
cricopharyngeus muscle	κρικοφαρύγγειος μυς
temporalis	κροταφικός
temporomandibular joint	κροταφογναθική άρθρωση
pectineus	κτενίτης
theyreohyoideus muscle	θυρεοειδής μυς
thyreoarytaenoideus muscle	θυρεοαρυταινοειδής μυς
thyrohyoid	θυροϋοειδής μυς
gracilis	ισχνός, ισχνός προσαγωγός, έσω ορθός μηριαίος
thoracolumbar spine	θωρακοοσφυϊκή μοίρα της σπονδυλικής στήλης
lower extremities	κάτω άκρα
long rotators	μακροί περιστροφείς των νώτων
extensor hallucis longus	μακρός εκτείνων τον μέγα δάκτυλο του ποδιού
extensor digitorum longus	μακρός εκτείνων τους δακτύλους του ποδιού
flexor pollicis longus	μακρός καμπτήρας του αντίχειρα
flexor hallucis longus	μακρός καμπτήρας του μεγάλου δακτύλου του ποδιού
extensor carpi radialis brevis	μακρός κερκιδικός εκτείνων τον καρπό
peroneus longus	μακρύς περονιαίος
serratus muscle	οδοντωτός μυς
serratus posterior inferior	οδοντωτός οπίσθιος κάτω
serratus posterior muscle	οδοντωτός οπίσθιος μυς
serratus posterior superior	οδοντωτός οπίσθιος άνω
intertransversi	μεσεγκάρσιοι
intertransversi posterior	μεσεγκάρσιοι οπίσθιοι
intertransversi lateral	μεσεγκάρσιοι έξω
intertransversi medial	μεσεγκάρσιοι έσω
intertransversi anterior	μεσεγκάρσιοι πρόσθιοι
interspinalis	μεσακάνθιος
masseter	μασητήρας
interspinal muscle	μεσοσπονδύλιος μυς
interspinalis muscle	μεσοσπονδύλιος μυς
intercostal lateral	μεσοπλεύριοι έξω
intercostal medial	μεσοπλεύριοι έσω
intercostal muscle	μεσοπλεύριος μυς
intercostalis muscle	μεσοπλεύριος μυς
interossei dorsales	μεσόστεοι ραχιαίοι του ποδιού
palmar interossei muscles	μεσόστεοι παλαμιαίοι μύες
interossei plantares	μεσόστεοι πελματιαίοι
plantar interossei	μεσόστεοι πελματιαίοι
plantar interossei	μεσόστεοι πελματιαίοι
interosseus dorsalis muscle	μεσόστεος ραχιαίος μυς
interosseus palmaris muscle	μεσόστεος παλαμιαίος μυς
frontal muscle	μετωπιαίος μυς
frontalis muscle	μετωπιαίος μυς
rhomboid major	μείζον ρομβοειδής
gluteus maximus	μείζων γλουτιαίος
obliquus capitis superior muscle	μείζων λοξός κεφαλικός μυς
pectoralis major	μείζων θωρακικός
rectus capitis posterior major	μείζων οπίσθιος ορθός κεφαλικός μυς
teres major	μείζων στρογγύλος
palmaris longus muscle	μείζων παλαμιαίος μυς
psoas major muscle	μείζων ψοΐτης μυς
filament	μικκύλιο
rectus capitis lateralis	ορθός κεφαλικός μυς έξω
rectus femoris	ορθός μηριαίος
myalgia	μυαλγία
myasthenia	μυασθένεια
myoangelosis	μυοαγκύλωση
rotator cuff	μυοτενοντώδεις δομές που περιβάλλουν τον ώμο
muscolotendinous	μυοτενοντώδης
muscolosckeletal	μυοσκελετικός
myofibrositis	μυοσυνδετικίτιδα
myofascial	μυοπεριτονιακό
articularis genus or subcrureus muscle	μυς αρθρικός του γόνατος ή υπομηρίδιος μυς
arrestores pilorum muscle	μυς ορθωτήρας των τριχών
auricular muscle	μυς του ώτος
auricularis muscle	μυς του ώτος
lumbar spine	οσφυϊκή μοίρα της σπονδυλικής στήλης
muscle fibril	μυϊκό ινίδιο
myofibril	μυϊκό ινίδιο
muscle cell	μυϊκό κύτταρο
muscular system	μυϊκό σύστημα
musculature	μυϊκό σύστημα
muscular rheumatism	μυϊκός ρευματισμός
muscular tone	μυϊκός τόνος
muscular atrophy	μυϊκή ατροφία
muscular dystrophy	μυϊκή δυστροφία
muscle fascicle	μυϊκή δέσμη
muscularis	μυϊκή στιβάδα
muscle fibre	μυϊκή ίνα
platysma	μυώδες πλάτυσμα
adductor magnus	μέγας προσαγωγός
calf muscles	μύες της γαστροκνημίας
wrist muscles	μύες του καρπού
thigh muscles	μύες του μηρού
foot muscles	μύες του άκρου του ποδιού
ocular muscles	μύες των οφθαλμών
gluteus medius	μέσος γλουτιαίος
middle and lower trapezius	μέσος και κάτω τραπέζιος
vastus intermedius	μέσος πλατύς
cruralis	μέσος πλατύς μηριαίος μυς
medial pterygoid	μέσος πτερυγοειδής
upward rotation	άνω στροφή
outer rotation	έξω στροφή
inner rotation	έσω στροφή
parietofrontal	κροταφοβρεγματικός
downward rotation	κάτω στροφή
thenar muscles	μύες του θέναρος
rhomboideus major	μείζον ρομβοειδής
retraction	οπισθόταξη
tibialis posterior	οπίσθιος κνημιαίος
posterior muscle	οπίσθιος μυς
longissimus cervicis	μήκιστος αυχενικός
longissimus capitis	μήκιστος κεφαλικός
longissimus thoracis	μήκιστος θωρακικός
mast cell	σιτευτικό κύτταρό
rotation	στροφή
instrastructure, facilities	υποδομές
sartorius muscle	ραπτικός μυς
dorsal interossei	ραχιαίοι μεσόστεοι
iliocostalis dorsi muscle	ραχιαίος λαγονοπλευρικός μυς
motor endplate	τελική κινητική πλάκα
sarcolemma	σαρκείλημμα
sarcomere	σαρκομέριο
sarcoplasmic reticulum	σαρκοπλασματικό δίκτυο
quadratus lumborum	τετράγωνος οσφυϊκός
quadratus plantae	τετράγωνος πελματιαίος
pronator quadratus	τατράγωνος πρηνιστής
extensor ossis metacarpi muscle	τείνων τα οστά του μετακαρπίου
tensor fascia lata	τείνων την πλατεία περιτονία
skeletal muscle	σκελετικός μυς
scalenus	σκαληνός
scalenus minimus	σκαληνός ελάσσων
scalenus maximus	σκαληνός μείζων
middle scalene	σκαληνός μέσος
posterior scalene	σκαληνός οπίσθιος
anterior scalene	σκαληνός πρόσθιος
lumbricalis manus muscle	σκωληκοειδής της χειρός, ελμινθοειδής της χειρός
lumbricalis pedis muscle	σκωληκοειδής του ποδός, ελμινθοειδής του ποδός
hyglossus muscle	υογλωσσικός μυς
trapezoid muscle	τραπεζοειδής μυς
trapezius muscle	τραπέζιος μυς
peroneus tertius	τρίτος περονιαίος
compressor narium muscle	στενών τους μυκτήρας μυς
sternocleidomastoid	στερνοκλειδομαστοειδής
sternothyreoid muscle	στερνοθυρεοειδής μυς
sternothyreoideus muscle	στερνοθυρεοειδής μυς
sternohyoid muscle	στερνοϋοειδής μυς
sternohyoideus muscle	στερνοϋοειδής μυς
sternalis	στερνίτης
constrictor muscle	σφιγκτήρας μυς
constrictor urithrae muscle	σφιγκτήρας της ουρήθρας
corrugator cutis ani muscle	σφιγκτήρας του απευθυσμένου
orbicular oris muscle	σφιγκτήρας του στόματος
orbicularis oris muscle	σφιγκτήρας του στόματος
constrictor pharyngis muscle	σφιγκτήρας του φάρυγγα μυς
orbicular oculi muscle	σφιγκτήρας των βλεφάρων
orbicularis oculi muscle	σφιγκτήρας των βλεφάρων
corrugator supercilii	σφιγκτήρας των φρυδιών
layer	στιβάδα
fibrositis	συνδετικίτιδα
congenerous muscle	συναγωνιστής μυς
pronator teres	στρογγύλος πρηνιστής
rotatores	στροφείς
rotators	στροφείς
rotator	στροφέας
muscle contraction	συστολή του μυός
infraspinatus	υπακάνθιος
supraspinous	υπερακανθώδης
supraspinatus	υπερακάνθιος
overstretching	υπερδιάταση
overshortening	υπερβράχυνση
supraclavicularis muscle	υπερκλείδιος μυς
overloading	υπερφόρτωση
splenus cervicis	σπληνιοειδής αυχενικός
splenus capitis	σπληνιοειδής κεφαλικός
suboccipital muscles	υπινιακοί μύες
subclavius	υποκλείδιος
subcostal muscles	υποπλεύριοι μύες
subscapularis	υποπλάτιος
inversion	υπτιασμός
supination	υπτιασμός
supinator	υπτιαστής
muscle spindle hypothesis	υπόθεση της μυϊκής ατράκτου
extensor carpi ulnaris	ωλένιος εκτείνων τον καρπό
flexor carpi ulnaris	ωλένιος καμπτήρας του καρπού
omohyoid muscle	ωμοϋοειδής μυς
levator paplebrae superioris muscle	άνω ανελκτήρας του  βλεφάρου
upper trapezius	άνω τραπέζιος
upper extremities	άνω άκρα
upper extremity	άνω άκρο
auricular posterior	ωτιαίος οπίσθιος
auricular superior	ωτιαίος άνω
auricular anterior	ωτιαίος πρόσθιος
azygos unvulae muscle	άζυγος μυς της σταφυλής
distal	άπω, περιφερικός, αφιστάμενος
pectoralis minor	έλασσον θωρακικός
extension	έκταση
muscle origin	έκφυση του μυός
origin	έκφυση του μυός
obliquus extremus abdominis muscle	έξω λοξός κοιλιακός μυς
external oblique muscle	έξω λοξός μυς
internal oblique muscle	έξω λοξός μυς
obturator externus	έξω θυροειδής
vastus lateralis	έξω πλατύς
lateral pterygoid	έξω πτερυγοειδής
obliquus internus abdominis muscle	έσω λοξός κοιλιακός μυς
obturator internus	έσω θυροειδής
vastus medialis	έσω πλατύς
zygomaticus major	ζυγωματικός ελλάσων
zygomaticus minor	ζυγωματικός μείζων
zygomaticus muscle	ζυγωματικός μυς
palmar and volar	παλαμιαία και παλαμική
palmar and volar	παλαμιαίος και παλαμικός
palmar muscle	παλαμιαίος μυς
palmaris muscle	παλαμιαίος μυς
volar	παλαμικός
plantar muscle	πελματιαίος μυς
plantaris muscle	πελματιαίος μυς
soleus	πελματικός
paraspinal muscles	παρασπονδύλιοι μύες
shoulder region	περιοχή του ώμου
distal to the midpoint	περιφερικά της μεσότητας
fascial	περιτονιακό
fat filament	παχύ μικκύλιο
ventrolateral	πλαγιοκοιλιακός
latissimus dorsi	πλατύς ραχιαίος
multifidus	πολυσχιδής
eversion	πρηνισμός
pronation	πρηνισμός
protractor muscle	προελκτικός μυς
adductor	προσαγωγός
adductor muscle	προσαγωγός μυς
adductor pollicis	προσαγωγός του αντίχειρα
adductor hallucis	προσαγωγός του μεγάλου δακτύλου του ποδιού
protraction	πρόταξη
tibialis anterior	πρόσθιος κνημιαίος
serratus anterior muscle	πρόσθιος οδοντωτός μυς
rectus capitis anterior	πρόσθιος ορθός κεφαλικός μυς
anterior muscle	πρόσθιος μυς
pyramidalis muscle	πυραμοειδής μυς
affected muscle	πάσχων μυς
chondropharyngeus muscle	χονδροφαρυγγικός μυς
hand	χέρι
joint shoulder pain	αρθραλγία ώμου
underweight	ελλιποβαρές ή υπόβαρο
plantar/pelmatic flexion	πελματιαία κάμμη
Immune  sera	'Ανοσοι οροί
3-(2,2,2-TRIMETHYLHYDRAZINIUM) PROPIONATE SALTS FOR TREATING MYOCARDIAL INFARCTI	Προπιονικά άλατα του τριμεθυλο-υδραζινίου
Artificial blood to save lives.	Το τεχνητό αίμα θα σώσει ζωές
Cobb elevator	ανυψωτήρας  Cobb
deep coverage genome	γονιδίωμα ευρέως φάσματος
dioptrimeter	Φακόμετρο
ECG trace	Κλινικό ίχνος ΗΚΓ
flashback window	θάλαμος επιστροφής
forensic purposes	ιατροδικαστικοί σκοποί
genome	γονιδίωμα
Social Insurance Institute	I.K.A 'Ιδρυμα Κοινωνικών Ασφαλίσεων
F.E.I.R Foundation for Economic and Industrial Research	I.O.B.E  Ίδρυμα  Οικονομικών και Βιομηχανικών Ερευνών
immersion burns	θερμικά εγκαύματα λόγω εμβάπτισης σε καυτό υγρό
Cost of Daily Treatment	Κ.Η.Θ (Κόστος Ημερήσιας Θεραπείας)
Defined Daily Dose	Κ.Η.Δ Καθορισμένη Ημερήσια Δόση
Seaman's Home	Οικος Ναύτου
Patient with renal failure undergoing hemodialysis for the past year	Νεφροπαθής υπο αιμοκάθαρση απο έτους
Active Substance Content on the Package	Π.Δ.Σ Περιεκτικότητα σε Δραστική Ουσία στη Συσκευασία
Health Economics Observatory	Παρατηρητήριο Οικομίας της Υγείας
Comfort Therapy	Παρηγορητική Θεραπεία
Skiagraphy Medicinal Products	Σκιαγραφικά φάρμακα
Medical Profession Pension and Insurance Fund	ΤΣΑΥ Ταμείο Συντάξεως και Ασφάλισης Υγειονομικών
medical devices inspection fees	Τέλος ετοιμότητας (ΕΟΦ)
Blood substitutes	Υποκατάστατα αίματος
Onassis Cardiac Surgery Centre	Ωνάσειο Καρδιοχειρουργικό Κέντρο
informal diagnostic material	άτυπο διαγνωστικό υλικό
immunoglobulin	ανοσοσφαιρίνη
blood grouping reagent	αντιδραστήριο αιμοδοσίας
genome	γονιδίωμα
generic medicines	γενόσημα φάρμακα
infusion solutions	διαλύματα έγχυσης
proprietary medicine	ιδιοσκεύασμα
clinical trials	κλινικές μελέτες
To curb healthcare expenditure	μειώνω τις δαπάνες  για την  Υγεία
orphan medicine	ορφανά φάρμακα
Average Daily Dose )A.D.D	Μέση Ημερήσια Δόση
Artificial Kidney Unit	Μονάδα Τεχνητού Νεφρού
prescription list	συνταγολογιο ταμείου
active-implantable devices	ενεργά εμφυτεύσιμα προϊόντα
Number of Daily Doses (Dosage)	Α.Η.Δ (Αριθμός Ημερήσιας Δόσης)
on behalf of the Drugs Commissioner	Για Έφορο (Συμβουλίου Φαρμάκων)
Directorate General of Prices  for Medical Products	Γενική Διεύθυνση Τιμών Φαρμακευτικών προϊόντων
pharmacovigilence	φαρμακοεπαγρύπνιση
National Centre of Emergency Social Care	Ε.Κ.Α.Β
National Organisation for Medicines	Ε.Ο.Φ Εθνικός Οργανισμός Φαρμάκων
Injectable medicinal products	Ενέσιμα Φάρμακα
European Directorate for the Quality of Medicines (E.D.Q.M)	Ευρωπαϊκή Διεύθυνση για την Ποιότητα των Φαρμάκων
Coagulation factors	παράγοντες πήξης
Pharmaceutical Sales Assistant	Ιατρικός Επισκέπτης
laminated	πλαστικοποιημένη
metabolic monitor	συσκευή μέτρησης μεταβολισμού
nonverbal measures	μη λεκτκές μετρήσεις
Nuclear Magnetic Resonance NMR	Πυρηνικός Μαγνητικός Συντονισμός ΠΜΣ
ocytocin	ωκυτοκίνη
paid companion/live-in help	έμμισθος/η συνοδός/εσωτερική βοηθός
ROI cursor (Region of Interest Cursor)	Κέρσορας περιοχής ενδιαφέροντος
Spatial Span	χωρικό εύρος
Standards for Educational and Psychological Testing	προδιαγραφές εκπαιδευτικών και ψυχολογικών εξετάσεων
test of visual scanning	δοκιμασία οπτικής σάρωσης
Verbal measures	λεκτικές μετρήσεις
working memory	λειτουργική μνήμη/ εργαζόμενη ή ενεργός μνήμη
