 1 AAS (atomic absorption spectroscopy)	Êà»¡â·ÃÊâ¡»Õ¡ÒÃ´Ù´¡Å×¹â´ÂÍÐµÍÁ	     
 1 abbreviated new drug application (ANDA)	¡ÒÃ¢Öé¹·ÐàºÕÂ¹ÂÒãËÁè©ºÑºÂèÍ	     
 1 abdomen	ÊèÇ¹·éÍ§,·éÍ§	     
 1 aberration	¡ÒÃàºÕèÂ§¨Ò¡»¡µÔ, ¡ÒÃ¾ÃèÒ (ÊÒÂµÒ)	     
 1 aborticide	ÂÒá·é§	     
 1 abortifacient	ÂÒá·é§	     
 1 abortion	¡ÒÃá·é§,¡ÒÃ·Óá·é§	     
 1 abrasion test	¡ÒÃ·´ÊÍº¡ÒÃ¢Ñ´¶Ù	     
 1 abrasive	ÊÒÃ¢Ñ´¶Ù	     
 1 abscess	½Õ, â¾Ã§Ë¹Í§	     
 1 absence	¡ÒÃËÁ´ÊµÔªÑèÇ¢³Ð	     
 1 absolute	ÊÑÁºÙÃ³ì, ÅéÇ¹æ	     
 1 absorbance	¤ÇÒÁ´Ù´¡Å×¹ÃÑ§ÊÕ, áÍº«ÍÃìáº¹«ì	     
 1 absorbefacient	ÊÒÃªèÇÂ¡ÒÃ´Ù´«ÖÁ,ªèÇÂ¡ÒÃ´Ù´«ÖÁ	     
 1 absorbent	ÊÒÃ´Ù´«ÖÁ, ´Ù´«ÖÁä´é	     
 1 absorb	´Ù´«ÖÁ,´Ù´¡Å×¹	     
 1 absorption base	ÂÒ¾×é¹ª¹Ô´´Ù´¹éÓ	     
 1 absorption	¡ÒÃ´Ù´«ÖÁ,¡ÒÃ´Ù´¡Å×¹	     
 1 absorption site	µÓáË¹è§·Õè´Ù´«ÖÁ, ºÃÔàÇ³·Õè´Ù´«ÖÁ	     
 1 absorptivity	ÊÀÒ¾´Ù´«ÖÁ, ÊÀÒ¾´Ù´¡Å×¹	     
 1 accelerated stability testing	¡ÒÃ·´ÊÍº¤ÇÒÁ¤§ÊÀÒ¾áººàÃè§	     
 1 acceleration	¤ÇÒÁàÃè§	     
 1 accommodation	¡ÒÃ»ÃÑºãËéàËÁÒÐ	     
 1 accreditation	¡ÒÃµÃÇ¨»ÃÐàÁÔ¹	     
 1 accuracy	¤ÇÒÁáÁè¹	     
 1 acid-base balance	´ØÅ¡Ã´´èÒ§	     
 1 acidifying agent	ÊÒÃ·ÓãËéà»ç¹¡Ã´	     
 1 acidity	ÊÀÒ¾¡Ã´, ÀÒÇÐà»ÃÕéÂÇ	     
 1 acidosis	ÀÒÇÐ¡Ã´à¡Ô¹	     
 1 acid value	¤èÒ¤ÇÒÁà»ç¹¡Ã´	     
 1 acquired immunodeficiency syndrome (AIDs)	¡ÅØèÁÍÒ¡ÒÃÀÙÁÔ¤ØéÁ¡Ñ¹º¡¾ÃèÍ§	     
 1 acquisition cost	ÃÒ¤Òµé¹·Ø¹	     
 1 acrid	©Ø¹, à¼ç´ÃéÍ¹	     
 1 acriflavine	ÂÒàËÅ×Í§	     
 1 action of drug	Ä·¸ÔìÂÒ	     
 1 action potential	ÈÑ¡Âì·Ó§Ò¹	     
 1 activated carbon	¤ÒÃìºÍ¹¡ÑÁÁÑ¹µì	     
 1 activated charcoal	¶èÒ¹¡ÑÁÁÑ¹µì	     
 1 activate	¡èÍ¡ÑÁÁÑ¹µì, ¡èÍÄ·¸Ôì	     
 1 activation energy	¾ÅÑ§§Ò¹¡èÍ¡ÑÁÁÑ¹µì, ¾ÅÑ§§Ò¹¡èÍÄ·¸Ôì, ¾ÅÑ§§Ò¹¡ÃÐµØé¹	     
 1 activation	¡ÒÃ¡èÍ¡ÑÁÁÑ¹µì, ¡ÒÃ¡èÍÄ·¸Ôì	     
 1 activator	ÊÒÃ»ÅØ¡Ä·¸Ôì, µÑÇ»ÅØ¡Ä·¸Ôì	     
 1 active constituent	ÊÒÃÍÍ¡Ä·¸Ôì, ÊÒÃÁÕÄ·¸Ôì, µÑÇÂÒËÅÑ¡, µÑÇÂÒÊÓ¤Ñ­	     
 1 active	ÍÍ¡Ä·¸Ôì, ÁÕÄ·¸Ôì, ãªé¾ÅÑ§§Ò¹, ·Ó§Ò¹, ¡ÑÁÁÑ¹µì	     
 1 active ingredient	ÊÒÃÍÍ¡Ä·¸Ôì, ÊÒÃÁÕÄ·¸Ôì, µÑÇÂÒËÅÑ¡, µÑÇÂÒÊÓ¤Ñ­	     
 1 active principle	ÊÒÃÍÍ¡Ä·¸Ôì, ÊÒÃÁÕÄ·¸Ôì, µÑÇÂÒËÅÑ¡, µÑÇÂÒÊÓ¤Ñ­	     
 1 active site	µÓáË¹è§·Ó§Ò¹, µÓáË¹è§ÍÍ¡Ä·¸Ôì, ºÃÔàÇ³ÍÍ¡Ä·¸Ôì	     
 1 active state	ÀÒÇÐ·Ó§Ò¹	     
 1 active transport	¡ÒÃ¢¹Êè§â´Âãªé¾ÅÑ§§Ò¹, ¡ÒÃ¢¹Êè§áºº¡ÑÁÁÑ¹µì	     
 1 activity	¡ÒÃ§Ò¹, ¡Ô¨¡ÃÃÁ, ¡ÑÁÁÑ¹µÀÒ¾, áÍ¡µÔÇÔµÕ	     
 1 actual yield	¼Åä´é¨ÃÔ§, »ÃÔÁÒ³ä´é¨ÃÔ§	     
 1 actuator	ËÑÇ¡´	     
 1 acupoint	¨Ø´½Ñ§à¢çÁ	     
 1 acupressure	¡ÒÃ¡´¨Ø´	     
 1 acupuncture	¡ÒÃ½Ñ§à¢çÁ	     
 1 acute	à©ÕÂº¾ÅÑ¹,(âÃ¤) »Ñ¨¨ØºÑ¹, à©ÕÂº¾ÅÑ¹	     
 1 additive	ÊÒÃàµÔÁáµè§, ÊÒÃ»ÃØ§áµè§, ÃÇÁ, àµÔÁ	     
 1 adhesion	¡ÒÃÂÖ´µÔ´, ¡ÒÃ»ÃÐÊÒ¹	     
 1 adhesive	ÊÒÃÂÖ´µÔ´, ÂÖ´µÔ´	     
 1 adiabatic	áÍà´ÕÂáºµÔ¡	     
 1 adjuvant	µÑÇàÊÃÔÁ, µÑÇÂÒàÊÃÔÁ, ÊÒÃ»ÃØ§áµè§ÂÒ, ÊÒÃ»ÃØ§ÃÙ»ÂÒ	     
 1 adjuvant therapy	¡ÒÃÃÑ¡ÉÒàÊÃÔÁ, ¡ÒÃºÓºÑ´àÊÃÔÁ	     
 1 administration	¡ÒÃãËé (ÂÒ)	     
 1 admixture	¡ÒÃà¾ÔèÁ¼ÊÁ, ÊÔè§à¾ÔèÁ¼ÊÁ	     
 1 ADR (adverse drug reaction)	ÍÒ¡ÒÃäÁè¾Ö§»ÃÐÊ§¤ì¨Ò¡¡ÒÃãªéÂÒ	     
 1 adsorbate	ÊÔè§¶Ù¡´Ù´«Ñº, µÑÇ¶Ù¡´Ù´«Ñº	     
 1 adsorbent	µÑÇ´Ù´«Ñº, ´Ù´«Ñº	     
 1 adsorb	´Ù´«Ñº	     
 1 adsorption	¡ÒÃ´Ù´«Ñº	     
 1 adulteration	¡ÒÃ»ÅÍÁ»¹	     
 1 adverse drug reaction monitoring	¡ÒÃµÔ´µÒÁÍÒ¡ÒÃäÁè¾Ö§»ÃÐÊ§¤ì¨Ò¡¡ÒÃãªéÂÒ	     
 1 adverse event	àËµØ¡ÒÃ³ìäÁè¾Ö§»ÃÐÊ§¤ì	     
 1 aerobic	ãªéÍÍ¡«Ôà¨¹, áÍâÃºÔ¡	     
 1 aerosol	áÍâÃâ«Å, ÅÐÍÍ§ÅÍÂ, ÂÒ©Õ´¾è¹	     
 1 affinity	¤ÇÒÁªÍº¨Ñº	     
 1 aftertaste	ÃÊµÔ´ÅÔé¹, ÃÊµÒÁËÅÑ§	     
 1 agar	ÇØé¹	     
 1 agglomeration	¡ÒÃà¡ÒÐ¡ÅØèÁ	     
 1 agglutination	¡ÒÃ¨Ñº¡ÅØèÁ¡éÍ¹	     
 1 aggregated suspension	ÂÒ¹éÓá¢Ç¹µÐ¡Í¹ª¹Ô´¨Ñº¡ÅØèÁ	     
 1 aggregation	¡ÒÃ¨Ñº¡ÅØèÁ	     
 1 agitate	¡Ç¹, »Ñè¹	     
 1 agitation	¡ÒÃ¡Ç¹, ¡ÒÃ»Ñè¹	     
 1 agitator	à¤Ã×èÍ§¡Ç¹, à¤Ã×èÍ§»Ñè¹	     
 1 agonist	µÑÇ·Ó¡ÒÃ	     
 1 air displacement	¡ÒÃá·¹·ÕèÍÒ¡ÒÈ	     
 1 air permeability method	ÇÔ¸Õ¡ÒÃ«ÖÁ¼èÒ¹ÍÒ¡ÒÈ	     
 1 air sampler	à¤Ã×èÍ§ÊØèÁµÑÇÍÂèÒ§ÍÒ¡ÒÈ	     
 1 air shower	½Ñ¡ºÑÇÅÁ, à¤Ã×èÍ§¾è¹ÅÁáºº½Ñ¡ºÑÇ	     
 1 air suspension coating	¡ÒÃà¤Å×Íºáººá¢Ç¹ÅÍÂã¹ÍÒ¡ÒÈ	     
 1 alcoholic macerate	ÂÒ´Í§àËÅéÒ	     
 1 algorithm	ªØ´¡ÒÃ»ÃÐàÁÔ¹ÃÐ´Ñº¢Í§»Ñ­ËÒ, ÍÑÅ¡ÍÃÔ·ÖÁ	     
 1 alimentation	¡ÒÃãËéÊÒÃÍÒËÒÃ	     
 1 alkalinizing agent	ÊÒÃ·ÓãËéà»ç¹´èÒ§	     
 1 alkalosis	ÀÒÇÐ´èÒ§à¡Ô¹	     
 1 allergy	ÀÙÁÔá¾é	     
 1 allergy, delayed type	ÀÙÁÔá¾éª¹Ô´¤èÍÂà»ç¹¤èÍÂä»	     
 1 allergy, immediate type	ÀÙÁÔá¾éª¹Ô´·Ñ¹·Õ	     
 1 allied drug	ÂÒá·¹	     
 1 allocation criteria	à¡³±ì¡ÒÃ¨Ñ´ÊÃÃ	     
 1 allopathic medicine	¡ÒÃá¾·Âìá¼¹»Ñ¨¨ØºÑ¹, ¡ÒÃá¾·Âì¡ÃÐáÊËÅÑ¡	     
 1 alternative medicine	¡ÒÃá¾·Âì·Ò§àÅ×Í¡	     
 1 amber glass	á¡éÇÊÕÍÓ¾Ñ¹, á¡éÇÊÕªÒ	     
 1 ambulatory care	¡ÒÃºÃÔºÒÅ¼Ùé»èÇÂà´Ô¹ä´é, ¡ÒÃºÃÔºÒÅ¼Ùé»èÇÂä»¡ÅÑº	     
 1 ambulatory patient	¼Ùé»èÇÂà´Ô¹ä´é, ¼Ùé»èÇÂä»¡ÅÑº	     
 1 amebacide	ÊÒÃ¦èÒÍÐÁÕºÒ	     
 1 amebicide	ÊÒÃ¦èÒÍÐÁÕºÒ	     
 1 amoebacide	ÊÒÃ¦èÒÍÐÁÕºÒ	     
 1 amoebicide	ÊÒÃ¦èÒÍÐÁÕºÒ	     
 1 amorphous	ÍÊÑ³°Ò¹, äÁèà»ç¹¼ÅÖ¡	     
 1 amperometry	ÇÔ¸ÕÇÑ´¡ÃÐáÊä¿¿éÒ	     
 1 amphiphatic	ªÍº¹éÓáÅÐä¢ÁÑ¹	     
 1 amphiphilic	ªÍº¹éÓáÅÐä¢ÁÑ¹	     
 1 amphoteric	ÁÕ·Ñé§äÍÍÍ¹ºÇ¡áÅÐÅº	     
 1 ampoule	áÍÁ¾ÙÅ, ËÅÍ´ºÃÃ¨ØÂÒ©Õ´	     
 1 ampul	áÍÁ¾ÙÅ, ËÅÍ´ºÃÃ¨ØÂÒ©Õ´	     
 1 ampule	áÍÁ¾ÙÅ, ËÅÍ´ºÃÃ¨ØÂÒ©Õ´	     
 1 anabolic	ÊÃéÒ§àÊÃÔÁ	     
 1 anabolism	¡ÃÐºÇ¹¡ÒÃÊÃéÒ§àÊÃÔÁ	     
 1 anaemia	ÀÒÇÐàÅ×Í´¨Ò§	     
 1 anaerobic	«Öè§äÁèãªéÍÍ¡«Ôà¨¹, áÍ¹áÍâÃºÔ¡	     
 1 analeptic	ÂÒ¡ÃÐµØé¹ÊÁÍ§, ÂÒ»ÅØ¡ÊÁÍ§	     
 1 analgesia	¡ÒÃÃÐ§Ñº»Ç´	     
 1 analgesic	ÂÒÃÐ§Ñº»Ç´, ÃÐ§Ñº»Ç´	     
 1 analog	áÍ¹ÐÅçÍ¡	     
 1 analogue	áÍ¹ÐÅçÍ¡	     
 1 analysis	¡ÒÃÇÔà¤ÃÒÐËì	     
 1 analytical balance	à¤Ã×èÍ§ªÑè§ª¹Ô´ÇÔà¤ÃÒÐËì	     
 1 analytical method	ÇÔ¸ÕÇÔà¤ÃÒÐËì	     
 1 anaphrodisiac	ÂÒÅ´¡ÓË¹Ñ´	     
 1 anaphylaxis	¡ÒÃá¾éÍÂèÒ§ÃØ¹áÃ§, ààÍ¹Ò¿ÔáÅç¡«ÔÊ	     
 1 anastomosis	¡ÒÃàª×èÍÁ»ÃÐÊÒ¹, ÊèÇ¹àª×èÍÁ»ÃÐÊÒ¹	     
 1 Andreasen pipette	»Ôà»µµìáººáÍ¹à´ÃÕÂàÊ¹	     
 1 androgenic	ãËéÅÑ¡É³ÐªÒÂ	     
 1 androgen	ÎÍÃìâÁ¹à¾ÈªÒÂ, áÍ¹â´Ãà¨¹	     
 1 anemia	ÀÒÇÐàÅ×Í´¨Ò§	     
 1 anesthesia	¡ÒÃäÁèÃÙéÊÖ¡, ¡ÒÃÊÅº	     
 1 anesthetic	ÂÒÃÐ§Ñº¤ÇÒÁÃÙéÊÖ¡, ·ÓãËéËÁ´¤ÇÒÁÃÙéÊÖ¡	     
 1 angle of repose	ÁØÁ·Ã§µÑÇ, ÁØÁÃÕâ¾Ê	     
 1 anhydrous	äÃé¹éÓ, »ÃÒÈ¨Ò¡¹éÓ	     
 1 anionic	»ÃÐ¨ØÅº	     
 1 anisotropic	áÍ¹äÍâ«·ÃÍ»Ô¡	     
 1 anneal	ÍºàË¹ÕÂÇ, áÍ¹¹ÕÅ	     
 1 anorectic	ÂÒàº×èÍÍÒËÒÃ, àº×èÍÍÒËÒÃ	     
 1 anoretic	ÂÒàº×èÍÍÒËÒÃ, àº×èÍÍÒËÒÃ	     
 1 anorexic	ÂÒàº×èÍÍÒËÒÃ, àº×èÍÍÒËÒÃ	     
 1 anoxia	ÀÒÇÐ¢Ò´ÍÍ¡«Ôà¨¹	     
 1 antacid	ÂÒÅ´¡Ã´	     
 1 antagonism	¡ÒÃµèÍµéÒ¹	     
 1 antagonist	ÊÒÃÍÍ¡Ä·¸ÔìµéÒ¹, µÑÇµéÒ¹	     
 1 anthelminthic	ÂÒ¦èÒË¹Í¹¾ÂÒ¸Ô, ¦èÒË¹Í¹¾ÂÒ¸Ô	     
 1 anthelmintic	ÂÒ¦èÒË¹Í¹¾ÂÒ¸Ô, ¦èÒË¹Í¹¾ÂÒ¸Ô	     
 1 antiadherent	ÊÒÃ¡Ñ¹µÔ´, ÊÒÃµéÒ¹¡ÒÃà¡ÒÐµÔ´, ¡Ñ¹µÔ´, µéÒ¹¡ÒÃà¡ÒÐµÔ´	     
 1 antiaging	µéÒ¹¤ÇÒÁá¡è, µéÒ¹¡ÒÃà»ÅÕèÂ¹µÒÁÇÑÂ	     
 1 antianxiety drug	ÂÒ¤ÅÒÂ¡Ñ§ÇÅ, Ê§º»ÃÐÊÒ·, ¤ÅÒÂ¡Ñ§ÇÅ	     
 1 antiasthmatic	ÂÒá¡éË×´, á¡éË×´	     
 1 antibacterial	ÊÒÃµéÒ¹áº¤·ÕàÃÕÂ, µéÒ¹áº¤·ÕàÃÕÂ	     
 1 antibiotic	ÂÒ»¯ÔªÕÇ¹Ð	     
 1 antibody	ÊÒÃÀÙÁÔµéÒ¹·Ò¹, áÍ¹µÔºÍ´Õ	     
 1 anticaking	¡Ñ¹¡ÒÃà»ç¹¡éÍ¹, µéÒ¹¡ÒÃà¡Ô´¡éÍ¹á¢ç§	     
 1 anticholinergic	ÂÒ/ÊÒÃµéÒ¹â¤ÅÔà¹ÍÃì¨Ô¡, áÍ¹µÔâ¤ÅÔà¹ÍÃì¨Ô¡, µéÒ¹â¤ÅÔà¹ÍÃì¨Ô¡	     
 1 anticoagulant	ÊÒÃ¡Ñ¹àÅ×Í´á¢ç§µÑÇ, ÊÒÃ¡Ñ¹àÅ×Í´à»ç¹ÅÔèÁ	     
 1 anticonvulsant	ÂÒ¡Ñ¹ªÑ¡, ÂÒá¡éªÑ¡, ¡Ñ¹ªÑ¡, á¡éªÑ¡	     
 1 anticonvulsive	ÂÒ¡Ñ¹ªÑ¡, ÂÒá¡éªÑ¡, ¡Ñ¹ªÑ¡, á¡éªÑ¡	     
 1 antidepressant	ÂÒá¡é«ÖÁàÈÃéÒ, á¡é«ÖÁàÈÃéÒ	     
 1 antidiarrhea	ÂÒá¡é·éÍ§ÃèÇ§	     
 1 antidiarrhoea	ÂÒá¡é·éÍ§ÃèÇ§	     
 1 antidiuretic	ÂÒÅ´»ÑÊÊÒÇÐ	     
 1 antidote	ÂÒá¡é¾ÔÉ, ÊÒÃá¡é¾ÔÉ	     
 1 antidysenteric	ÂÒá¡éºÔ´, á¡éºÔ´	     
 1 antiemetic	ÂÒá¡éÍÒà¨ÕÂ¹,á¡éÍÒà¨ÕÂ¹	     
 1 antienzyme	ÊÒÃµéÒ¹àÍ¹ä«Áì	     
 1 antifoam	ÊÒÃµéÒ¹¿Í§, ÊÒÃµéÒ¹¡ÒÃà¡Ô´â¿Á, µéÒ¹¿Í§, µéÒ¹¡ÒÃà¡Ô´â¿Á	     
 1 antigen	ÊÒÃ¡èÍÀÙÁÔµéÒ¹·Ò¹, áÍ¹µÔà¨¹	     
 1 antigenic determinant	ÊèÇ¹/µÑÇ¡ÓË¹´Ä·¸ÔìáÍ¹µÔà¨¹	     
 1 antihistamine	ÊÒÃµéÒ¹ÎÔÊ·ÒÁÕ¹	     
 1 anti-infective	ÂÒµéÒ¹¡ÒÃµÔ´àª×éÍ, µéÒ¹¡ÒÃµÔ´àª×éÍ	     
 1 anti-inflammatory	µéÒ¹ÍÑ¡àÊº	     
 1 antileprotic	ÂÒÃÑ¡ÉÒâÃ¤àÃ×éÍ¹, ÃÑ¡ÉÒâÃ¤àÃ×éÍ¹	     
 1 antimalarial	ÂÒµéÒ¹ÁÒÅÒàÃÕÂ, µéÒ¹ÁÒÅÒàÃÕÂ	     
 1 antimanic	ÂÒµéÒ¹¿Øé§¾ÅèÒ¹, µéÒ¹¿Øé§¾ÅèÒ¹	     
 1 antimicrobial	ÂÒµéÒ¹¨ØÅªÕ¾, µéÒ¹¨ØÅªÕ¾	     
 1 antimycotic	ÂÒµéÒ¹àª×éÍÃÒ, µéÒ¹àª×éÍÃÒ	     
 1 antineuritic	ÂÒÃÑ¡ÉÒ»ÃÐÊÒ·ÍÑ¡àÊº, ÃÑ¡ÉÒ»ÃÐÊÒ·ÍÑ¡àÊº	     
 1 antioxidant	ÊÒÃµéÒ¹ÍÍ¡«Ôà´ªÑ¹, ÊÒÃ¡Ñ¹Ë×¹	     
 1 antiparasitic	ÂÒµéÒ¹»ÃÊÔµ, µéÒ¹»ÃÊÔµ, µéÒ¹¾ÂÒ¸Ô	     
 1 antiperistalsis	¡ÒÃºÕºÃÙ´ÂéÍ¹	     
 1 antipruritic	ÂÒá¡é¤Ñ¹, á¡é¤Ñ¹	     
 1 antipsychotic	ÂÒÃÑ¡ÉÒâÃ¤¨Ôµ, ÃÑ¡ÉÒâÃ¤¨Ôµ	     
 1 antipyretic	ÂÒÅ´ä¢é, Å´ä¢é	     
 1 antiserum	áÍ¹µÔ«ÕÃÑÁ	     
 1 antispasmodic	ÂÒá¡éà¡Ãç§, á¡éà¡Ãç§	     
 1 antistatic	ÊÒÃµéÒ¹ä¿¿éÒÊ¶Ôµ, µéÒ¹ä¿¿éÒÊ¶Ôµ	     
 1 antitack	ÊÒÃ¡Ñ¹àË¹ÍÐ, ¡Ñ¹àË¹ÍÐ	     
 1 antitoxin	ÊÒÃµéÒ¹ªÕÇ¾ÔÉ, áÍ¹µÔ·Í¡«Ô¹	     
 1 antitussive	ÂÒá¡éäÍ,á¡éäÍ	     
 1 antiviral	ÂÒµéÒ¹äÇÃÑÊ, µéÒ¹äÇÃÑÊ	     
 1 anxiolytic	ÂÒ¤ÅÒÂ¡Ñ§ÇÅ, Ê§º»ÃÐÊÒ·, ¤ÅÒÂ¡Ñ§ÇÅ	     
 1 aphasia	ÀÒÇÐàÊÕÂ¡ÒÃÊ×èÍ¤ÇÒÁ	     
 1 aphrodisiac	ÂÒàÃéÒ¡ÓË¹Ñ´	     
 1 aplastic anemia	ÀÒÇÐàÅ×Í´¨Ò§ª¹Ô´ä¢¡ÃÐ´Ù¡½èÍ	     
 1 apnea	ÀÒÇÐËÂØ´ËÒÂã¨ªèÇ§ËÒÂã¨ÍÍ¡	     
 1 apneusis	ÀÒÇÐËÂØ´ËÒÂã¨ªèÇ§ËÒÂã¨à¢éÒ	     
 1 apothecary	àÀÊÑª¡Ã, ¼Ùé¼ÊÁÂÒ	     
 1 apotheke	ÃéÒ¹ÂÒ	     
 1 apparent density	¤ÇÒÁË¹Òá¹è¹»ÃÒ¡¯ (¢Í§¼§)	     
 1 appestat	ÈÙ¹Âì¤Çº¤ØÁ¤ÇÒÁÍÂÒ¡ÍÒËÒÃ	     
 1 appropriate technology	à·¤â¹âÅÂÕ·ÕèàËÁÒÐÊÁ	     
 1 aqueous	¹éÓ	     
 1 aqueous-based coating	¡ÒÃà¤Å×ÍºÃÐºº¹éÓ	     
 1 aqueous humour	¢Í§àËÅÇã¹ÅÙ¡µÒË¹éÒàÅ¹Êì	     
 1 aromatherapy	ÊØ¤¹¸ºÓºÑ´	     
 1 aromatic water	¹éÓ»ÃØ§, ¹éÓ¡ÅÔè¹ËÍÁ, ¹éÓ»ÃØ§ËÍÁ, ¹éÓ»ÃØ§¡ÅÔè¹	     
 1 Arrhenius equation	ÊÁ¡ÒÃÍÒÃìàÃà¹ÕÂÊ	     
 1 arrhythmia	ÀÒÇÐËÑÇã¨àµé¹¼Ô´¨Ñ§ËÇÐ	     
 1 arteriosclerosis	ÀÒÇÐËÅÍ´àÅ×Í´á´§á¢ç§	     
 1 artery	ËÅÍ´àÅ×Í´á´§	     
 1 artificial sweetener	ÊÒÃáµè§ÃÊËÇÒ¹à·ÕÂÁ, ¹éÓµÒÅà·ÕÂÁ	     
 1 aseptic	»ÅÍ´àª×éÍ, »éÍ§¡Ñ¹àª×éÍ	     
 1 aseptic filtration	¡ÒÃ¡ÃÍ§»ÃÒÈ¨Ò¡àª×éÍ	     
 1 aseptic technique	à·¤¹Ô¤äÃéàª×éÍ, à·¤¹Ô¤»ÅÍ´àª×éÍ	     
 1 asphyxia	ÀÒÇÐËÒÂã¨äÁèÍÍ¡	     
 1 assay	¡ÒÃËÒ»ÃÔÁÒ³, ËÒ»ÃÔÁÒ³	     
 1 asthenia	ÍèÍ¹áÃ§	     
 1 astringent	ÂÒ½Ò´ÊÁÒ¹, ÂÒÊÁÒ¹, ½Ò´ÊÁÒ¹	     
 1 ataxia	ÀÒÇÐ¡ÅéÒÁà¹×éÍäÁè»ÃÐÊÒ¹§Ò¹	     
 1 atelectasis	»Í´á¿º	     
 1 atheroma	µÐ¡ÃÑ¹ËÅÍ´àÅ×Í´á´§	     
 1 atherosclerosis	ÀÒÇÐËÅÍ´àÅ×Í´á´§á¢ç§ª¹Ô´ÁÕµÐ¡ÃÑ¹·Õè¼¹Ñ§ªÑé¹ã¹	     
 1 atomic absorption spectroscopy	Êà»¡â·ÃÊâ¡»Õ¡ÒÃ´Ù´¡Å×¹â´ÂÍÐµÍÁ	     
 1 atomization	¡ÒÃ·ÓãËéà»ç¹½ÍÂ, ¡ÒÃ©Õ´¾è¹à»ç¹½ÍÂ	     
 1 atopy	ÀÒÇÐÀÙÁÔá¾é¨Ò¡¡ÃÃÁ¾Ñ¹¸Øì	     
 1 atrophy	¡ÒÃ½èÍÅÕº	     
 1 attractive force	áÃ§´Ö§´Ù´	     
 1 attrition mill	à¤Ã×èÍ§º´´éÇÂ¡ÒÃàÊÕÂ´ÊÕ	     
 1 attrition	¡ÒÃàÊÕÂ´ÊÕ	     
 1 aura	ÊÑ­­Ò³ºÍ¡àËµØ	     
 1 autoclave	ËÁéÍ¹Öè§ÍÑ´äÍ¹éÓ	     
 1 autoimmune	ÀÙÁÔµéÒ¹µ¹àÍ§, ÍÍâµÍÔÁÁÙ¹	     
 1 autolysis	¡ÒÃÊÅÒÂàÍ§	     
 1 autonomic nervous system	ÃÐºº»ÃÐÊÒ·ÍÑµâ¹ÇÑµÔ	     
 1 autonomous hospital	âÃ§¾ÂÒºÒÅã¹¡Ó¡Ñº¢Í§ÃÑ°	     
 1 autooxidation	¡ÒÃÍÍ¡«Ôä´ÊìàÍ§	     
 1 autoregulation	¡ÒÃ¤Çº¤ØÁµÑÇàÍ§	     
 1 auxiliary	ªèÇÂàÊÃÔÁ, àÊÃÔÁ	     
 1 average cost	µé¹·Ø¹à©ÅÕèÂ	     
 1 avoirdupois system	ÃÐººÍÒÇÑÇÃì´Ù¾ÑÇÊì	     
 1 Ayurvedic medicine	¡ÒÃá¾·ÂìÍÒÂØÃàÇ·	     
 1 azeotrope	ÊÒÃ¼ÊÁ¤§¨Ø´à´×Í´	     
 1 azotemia	ÀÒÇÐàÅ×Í´¤Ñè§ÊÒÃä¹âµÃà¨¹	     
 1 bacterial endotoxin test	¡ÒÃ·´ÊÍºªÕÇ¾ÔÉÀÒÂã¹µÑÇáº¤·ÕàÃÕÂ	     
 1 bacteriostatic	ÂÑºÂÑé§¡ÒÃà¨ÃÔ­¢Í§áº¤·ÕàÃÕÂ	     
 1 baffle	á¼è¹¡Ñé¹	     
 1 ball mill	à¤Ã×èÍ§º´áººÅÙ¡ºÍÅ¡ÅÔé§	     
 1 balm	ºÒÅìÁ	     
 1 balsam	ÂÒ§ãÊËÍÁ, ºÍÅ«ÑÁ	     
 1 barrier	ÊÔè§¡Õ´¢ÇÒ§, µÑÇ¡Õ´¡Ñ¹, µÑÇ¡Ñ¹	     
 1 basal metabolic rate	ÍÑµÃÒàÁá·ºÍÅÔ«ÖÁ¾×é¹°Ò¹	     
 1 basicity	ÊÀÒ¾àºÊ	     
 1 batch	ÃØè¹ (¡ÒÃ¼ÅÔµ)	     
 1 batch number	àÅ¢·ÕèÃØè¹ (¡ÒÃ¼ÅÔµ)	     
 1 bead	àÁç´àÅç¡	     
 1 Beer's law	¡®¢Í§àºÕÂÃì	     
 1 behavioral pharmacy	àÀÊÑªÈÒÊµÃì¾ÄµÔ¡ÃÃÁ	     
 1 beneficiary	¼ÙéÃÑº»ÃÐâÂª¹ì	     
 1 benefit package	ªØ´ÊÔ·¸Ô»ÃÐâÂª¹ì	     
 1 beta adrenergic receptor	µÑÇÃÑºáÍ´ÃÕà¹ÍÃì¨Ô¡ª¹Ô´àºµÒ	     
 1 beveled-edge	¢ÍººÒ¡, ¢ÍºÅºàËÅÕèÂÁ	     
 1 binder	ÊÒÃÂÖ´à¡ÒÐ	     
 1 binomial nomenclature	¡ÒÃµÑé§ª×èÍáºº·ÇÔ¹ÒÁ	     
 1 bioadhesion	¡ÒÃÂÖ´µÔ´·Ò§ªÕÇÀÒ¾	     
 1 bioassay	¡ÒÃÊÍº»ÃÔÁÒ³â´ÂªÕÇÇÔ¸Õ, ¡ÒÃÊÍºÇÔà¤ÃÒÐËìâ´ÂªÕÇÇÔ¸Õ	     
 1 bioavailability	ªÕÇ»ÃÐÊÔ·¸Ô¼Å, ªÕÇÍ¹Øà¤ÃÒÐËì, ¡ÒÃàÍ×éÍ»ÃÐâÂª¹ì	     
 1 biocompatible	à¢éÒ¡Ñ¹ä´é·Ò§ªÕÇÀÒ¾	     
 1 biodegradable	ÂèÍÂÊÅÒÂä´éâ´ÂªÕÇÇÔ¸Õ, ÂèÍÂÊÅÒÂä´é·Ò§ªÕÇÀÒ¾	     
 1 bioequivalence	ªÕÇÊÁÁÙÅ	     
 1 bioerodible	¡ÃèÍ¹ä´éâ´ÂªÕÇÇÔ¸Õ, ¡ÃèÍ¹ä´é·Ò§ªÕÇÀÒ¾	     
 1 biofeedback	¡ÒÃ»éÍ¹¡ÅÑº·Ò§ªÕÇÀÒ¾	     
 1 biological	ªÕÇÊÒÃ, ªÕÇÀÒ¾	     
 1 biological clock	¹ÒÌÔ¡ÒªÕÇÀÒ¾	     
 1 biological product	ªÕÇ¼ÅÔµÀÑ³±ì, ªÕÇÇÑµ¶Ø	     
 1 biomaterial	ªÕÇÇÑÊ´Ø	     
 1 biopharmaceutics	ªÕÇàÀÊÑª¡ÃÃÁ, ªÕÇàÀÊÑª¡ÒÃ	     
 1 biosynthesis	ªÕÇÊÑ§à¤ÃÒÐËì	     
 1 biotechnology	à·¤â¹âÅÂÕªÕÇÀÒ¾	     
 1 biotransformation	¡ÒÃà»ÅÕèÂ¹ÃÙ»·Ò§ªÕÇÀÒ¾	     
 1 birefringence	¡ÒÃËÑ¡àËÊÍ§á¹Ç	     
 1 bleeding time	ÃÐÂÐàÇÅÒàÅ×Í´ÍÍ¡	     
 1 blender	à¤Ã×èÍ§¼ÊÁ	     
 1 blend	¢Í§¼ÊÁ, ¼ÊÁ	     
 1 blind spot	¨Ø´ºÍ´	     
 1 blistering	¡ÒÃ»Ù´¾Í§ (¢Í§¿ÔÅìÁà¤Å×Íº)	     
 1 blister pack	ºÅÔÊàµÍÃìá¾ç¡	     
 1 blood brain barrier	µÑÇ¡Ñé¹ÊÁÍ§¡ÑºàÅ×Í´	     
 1 blood coagulation	¡ÒÃá¢ç§µÑÇ¢Í§àÅ×Í´, ¡ÒÃ¡ÅÒÂà»ç¹ÅÔèÁàÅ×Í´	     
 1 bloom strength	¤ÇÒÁá¢ç§ (¢Í§à¨ÅÒµÔ¹) ã¹Ë¹èÇÂºÅÙÁ	     
 1 bodying agent	ÊÒÃà¾ÔèÁà¹×éÍ, ÊÒÃà¾ÔèÁ¤ÇÒÁ¢é¹	     
 1 boiling point elevation	¡ÒÃà¾ÔèÁ¨Ø´à´×Í´	     
 1 boiling point	¨Ø´à´×Í´	     
 1 bolus	¡ÅØèÁ¡éÍ¹ (ÍÒËÒÃ, ÂÒ)	     
 1 bonding	¡ÒÃà¡Ô´¾Ñ¹¸Ð	     
 1 borosilicate glass	á¡éÇºÍâÃ«ÔÅÔà¡µ	     
 1 botanical medicine	ÂÒÊÁØ¹ä¾Ã	     
 1 botanical origin	áËÅè§·Ò§¾Ä¡ÉÈÒÊµÃì	     
 1 botanical preparation	ÂÒàµÃÕÂÁÊÁØ¹ä¾Ã	     
 1 botanicals	¾Ä¡ÉÒÀÑ³±ì	     
 1 boundary	¢Íºà¢µ	     
 1 bridging	¡ÒÃàª×èÍÁ¡Ñ¹	     
 1 British Herbal Pharmacopoeia	àÀÊÑªµÓÃÑºÊÁØ¹ä¾Ã»ÃÐà·ÈÊËÃÒªÍÒ³Ò¨Ñ¡Ã	     
 1 British Pharmacopoeia (BP)	àÀÊÑªµÓÃÑº»ÃÐà·ÈÊËÃÒªÍÒ³Ò¨Ñ¡Ã	     
 1 brittle	à»ÃÒÐ	     
 1 bronchiectasis	âÃ¤ËÅÍ´ÅÁâ»è§¾Í§, âÃ¤ÁÍ§¤ÃèÍ	     
 1 bronchiolitis	ËÅÍ´ÅÁ½ÍÂÍÑ¡àÊº	     
 1 bronchitis	ËÅÍ´ÅÁÍÑ¡àÊº	     
 1 Brookfield viscometer	à¤Ã×èÍ§ÇÑ´¤ÇÒÁË¹×´áºººÃÙ¡¿ÔÅ´ì	     
 1 Brownian movement	¡ÒÃà¤Å×èÍ¹äËÇáºººÃÒÇà¹ÕÂ¹	     
 1 brush border	¢Íº¢¹á»Ã§, ºÃÑªºÍÃìà´ÍÃì	     
 1 bubble pack	ºÑºàºÔÅá¾ç¡	     
 1 bubble point test	¡ÒÃ·´ÊÍººÑºàºÔÅ¾ÍÂµì	     
 1 buccal	á¡éÁ	     
 1 buffer capacity	¤ÇÒÁ¨ØºÑ¿à¿ÍÃì	     
 1 buffering agent	ÊÒÃ·ÓºÑ¿à¿ÍÃì	     
 1 buffer	ºÑ¿à¿ÍÃì	     
 1 bulk density	¤ÇÒÁË¹Òá¹è¹»ÃÒ¡¯ (¢Í§¼§)	     
 1 bulkiness	¤ÇÒÁ¿Ù (¢Í§¼§ÂÒ)	     
 1 bulk laxative	ÂÒÃÐºÒÂà¾ÔèÁ¡Ò¡	     
 1 bulk powder	ÂÒ¼§»ÃÔÁÒ³ÁÒ¡	     
 1 Bunsen burner	µÐà¡ÕÂ§ºØ¹àÊ¹	     
 1 burst effect	¼Å¡ÒÃ»Å´»ÅèÍÂÂÒÍÂèÒ§ÃÇ´àÃçÇã¹ªèÇ§µé¹	     
 1 cachet	ÂÒ¤Òàªµì	     
 1 caking	¡ÒÃà¡Ô´µÐ¡Í¹á¢ç§	     
 1 calibration	¡ÒÃà·ÕÂºÁÒµÃ°Ò¹	     
 1 calorie	á¤ÅÍÃÕ	     
 1 calorimeter	ÁÒµÃ»ÃÔÁÒ³¤ÇÒÁÃéÍ¹	     
 1 capillary viscometer	à¤Ã×èÍ§ÇÑ´¤ÇÒÁË¹×´áººá¤¾ÔÅÅÒÃÕ	     
 1 capital cost	¤èÒÅ§·Ø¹.µé¹·Ø¹¤èÒÅ§·Ø¹	     
 1 capitation	¡ÒÃàËÁÒ¨èÒÂÃÒÂËÑÇ	     
 1 capping	¡ÒÃ¡Ðà·ÒÐà»ç¹á¼è¹(¢Í§àÁç´ÂÒ)	     
 1 capsule	á¤»«ÙÅ.ÂÒá¤»«ÙÅ	     
 1 carcinogen	ÊÒÃ¡èÍÁÐàÃç§	     
 1 caregiver	¼Ùé´ÙáÅ,¼ÙéãËé¡ÒÃ´ÙáÅ	     
 1 care plan	á¼¹¡ÒÃ´ÙáÅ, á¼¹¡ÒÃºÃÔºÒÅ	     
 1 carrier	¾ÒËÐ, µÑÇ¾Ò	     
 1 carrier-mediated transport	¡ÒÃ¢¹Êè§â´Âãªé¾ÒËÐ, ¡ÒÃ¢¹Êè§â´ÂãªéµÑÇ¾Ò	     
 1 carrying capacity	¤ÇÒÁÊÒÁÒÃ¶¾Ò (ÊÒÃ, µÑÇÂÒÊÓ¤Ñ­)	     
 1 catabolic	áÂ¡ÊÅÒÂ	     
 1 catabolism	¡ÃÐºÇ¹¡ÒÃáÂ¡ÊÅÒÂ	     
 1 catalysis	¡ÒÃàÃè§»¯Ô¡ÔÃÔÂÒ	     
 1 catalyst	ÊÒÃàÃè§»¯Ô¡ÔÃÔÂÒ	     
 1 catecholamine	á¤·Õâ¤ÅÒÁÕ¹	     
 1 cationic	-»ÃÐ¨ØºÇ¡	     
 1 celebrospinal fluid (CSF)	¹éÓä¢ÊÑ¹ËÅÑ§	     
 1 cell	à«ÅÅì	     
 1 centipoise	à«¹µÔ¾ÍÂÊì	     
 1 central nervous system (CNS)	ÃÐºº»ÃÐÊÒ·¡ÅÒ§	     
 1 centrifuge	à¤Ã×èÍ§ËÁØ¹àËÇÕèÂ§áÂ¡µÐ¡Í¹.ËÁØ¹àËÇÕèÂ§áÂ¡µÐ¡Í¹	     
 1 certified color	ÊÕ·Õèä´éÃÑº¡ÒÃÃÑºÃÍ§	     
 1 chain pharmacy	ÃéÒ¹ÂÒà¤Ã×Í¢èÒÂ	     
 1 chain reaction	»¯Ô¡ÔÃÔÂÒÅÙ¡â«è	     
 1 channeling agent	ÊÒÃ·ÓãËéà¡Ô´ªèÍ§ËÃ×ÍÃÙ¾ÃØ¹	     
 1 characterization	¡ÒÃáÊ´§ÅÑ¡É³Ðà©¾ÒÐ	     
 1 chelating agent	ÊÒÃ¤ÕàÅµ	     
 1 chelation	¤ÕàÅªÑ¹	     
 1 chemisorption	¡ÒÃ´Ù´«Ñº·Ò§à¤ÁÕ	     
 1 chemoreceptor	µÑÇÃÑº·Ò§à¤ÁÕ	     
 1 chemosystematic	à¤ÁÕÍ¹Ø¡ÃÁÇÔ¸Ò¹	     
 1 chemotaxis	¡ÒÃà¤Å×èÍ¹àËµØÊÒÃà¤ÁÕ, ¤ÕâÁá·¡«ÔÊ	     
 1 chemotaxonomy	à¤ÁÕÍ¹Ø¡ÃÁÇÔ¸Ò¹	     
 1 chewable tablet	ÂÒàÁç´ÊÓËÃÑºà¤ÕéÂÇ	     
 1 chief complaint	ÍÒ¡ÒÃÊÓ¤Ñ­ (·Õè·ÓãËé¼Ùé»èÇÂµéÍ§ÁÒ¾ºá¾·Âì)	     
 1 child-resistant container	ÀÒª¹Ð»éÍ§¡Ñ¹à´ç¡à»Ô´	     
 1 chipping	¡ÒÃºÔè¹ (¢Í§àÁç´ÂÒ)	     
 1 chiral drug	ÂÒä¤ÃÑÅ	     
 1 cholagogue	ÊÒÃ¢Ñº¹éÓ´Õ	     
 1 cholecystagogue	ÊÒÃ¡ÃÐµØé¹¡ÒÃºÕºµÑÇ¢Í§¶Ø§¹éÓ´Õ	     
 1 choleresis	¡ÒÃËÅÑè§¹éÓ´Õ	     
 1 choleretic	ÊÒÃ¢Ñº¹éÓ´Õ, -ËÅÑè§¹éÓ´Õ	     
 1 cholestasis	ÀÒÇÐ¹éÓ´Õ¤Ñè§	     
 1 cholesterol	¤ÍàÅÊàµÍÃÍÅ	     
 1 cholinergic	â¤ÅÔà¹ÍÃì¨Ô¡	     
 1 chromatography	â¤ÃÁÒâ·¡ÃÒ¿Õ	     
 1 chromophore	â¤ÃâÁ¿ÍÃì	     
 1 chronotropic	-à»ÅÕèÂ¹ÍÑµÃÒàµé¹ (ËÑÇã¨)	     
 1 chyme	ÍÒËÒÃ¡Öè§àËÅÇã¹¡ÃÐà¾ÒÐ, ä¤Áì	     
 1 cilia	¢¹¡ÇÑ´	     
 1 circadian rhythm	¡ÒÃà»ÅÕèÂ¹á»Å§·Ò§ªÕÇÀÒ¾ã¹ÃÍºÇÑ¹	     
 1 circular dichroism	à«ÍÃì¤ÙÅÒÃì ä´â¤ÃÍÔ«ÖÁ	     
 1 clarification	¡ÒÃ·ÓãËéãÊ	     
 1 clarity test	¡ÒÃ·´ÊÍº¤ÇÒÁãÊ, ¡ÒÃ·´ÊÍº½Øè¹µÐ¡Í¹	     
 1 clay	´Ô¹àË¹ÕÂÇ	     
 1 clean room class 10000	ËéÍ§ÊÐÍÒ´ÃÐ´Ñº 10000	     
 1 clean room class 100	ËéÍ§ÊÐÍÒ´ÃÐ´Ñº 100	     
 1 clearance	ÍÑµÃÒ¡ÒÃ¡Ó¨Ñ´	     
 1 clerkship	¡ÒÃ½Ö¡»¯ÔºÑµÔ§Ò¹ (à¡ÕèÂÇ¡Ñº¼Ùé»èÇÂ)	     
 1 climacteric	ÇÑÂàÊ×èÍÁ·Ò§à¾È	     
 1 clinical chemistry	à¤ÁÕ¤ÅÔ¹Ô¡	     
 1 clinical pharmacokinetics	àÀÊÑª¨Å¹ÈÒÊµÃì¤ÅÔ¹Ô¡	     
 1 clinical  pharmacy	àÀÊÑª¡ÃÃÁ¤ÅÔ¹Ô¡	     
 1 clinical pharmacy	àÀÊÑª¡ÃÃÁ¤ÅÔ¹Ô¡	     
 1 clinical trial	¡ÒÃ·´ÊÍº·Ò§¤ÅÔ¹Ô¡	     
 1 clotting time	ÃÐÂÐàÇÅÒá¢ç§µÑÇ (àÅ×Í´)	     
 1 cloud point	¨Ø´àÃÔèÁ¢Øè¹	     
 1 CMC (critical micelle concentration)	¤ÇÒÁà¢éÁ¢é¹ÇÔ¡ÄµäÁà«ÅÅì	     
 1 CNS (central nervous system)	ÃÐºº»ÃÐÊÒ·¡ÅÒ§	     
 1 coacervation	â¤ÍÐà«ÍÃìàÇªÑ¹	     
 1 coagulate	¨Ñºà»ç¹ÅÔèÁ, ¨Ñºà»ç¹¡éÍ¹	     
 1 coagule	ÅÔèÁ, ¡éÍ¹	     
 1 coalescence	¡ÒÃÃÇÁËÂ´	     
 1 coarse dispersion	ÂÒ¡ÃÐ¨ÒÂµÑÇª¹Ô´ËÂÒº	     
 1 coating	¡ÒÃà¤Å×Íº	     
 1 coating pan	ËÁéÍà¤Å×Íº (ÂÒ)	     
 1 cohesion	¡ÒÃàª×èÍÁµÔ´	     
 1 cold cream	â¤Å´ì¤ÃÕÁ	     
 1 cold press	ºÕºÍÑ´â´ÂäÁèãªé¤ÇÒÁÃéÍ¹	     
 1 collapsible tube	ËÅÍ´ºÕº	     
 1 colligative properties	ÊÁºÑµÔ¤ÍÅÅÔà¡·Ô¿	     
 1 collodion	¤ÍÅâÅà´ÕÂ¹	     
 1 colloidal dispersion	¡ÒÃ¡ÃÐ¨ÒÂµÑÇáºº¤ÍÅÅÍÂ´ì, ÂÒ/ÊÒÃ¡ÃÐ¨ÒÂµÑÇáºº¤ÍÅÅÍÂ´ì	     
 1 colloidal silica	«ÔÅÔ¡Òª¹Ô´¤ÍÅÅÍÂ´ì	     
 1 colloid	¤ÍÅÅÍÂ´ì	     
 1 colloid mill	à¤Ã×èÍ§º´áºº¤ÍÅÅÍÂ´ì	     
 1 colorant	ÊÒÃáµè§ÊÕ	     
 1 colorimetric method	ÇÔ¸Õ¡ÒÃÇÑ´à·ÕÂºÊÕ	     
 1 coloring agent	ÊÒÃáµè§ÊÕ	     
 1 colostrum	¹Á¹éÓàËÅ×Í§	     
 1 coma	â¤ÁèÒ, µÃÕ·Ùµ	     
 1 comminution	¡ÒÃÅ´¢¹Ò´Í¹ØÀÒ¤	     
 1 common ion	äÍÍÍ¹ÃèÇÁ	     
 1 community pharmacy	àÀÊÑª¡ÃÃÁªØÁª¹	     
 1 compactibility	¤ÇÒÁÊÒÁÒÃ¶ÍÑ´á¹è¹	     
 1 compaction	¡ÒÃÍÑ´á¹è¹	     
 1 compatibility	¤ÇÒÁà¢éÒ¡Ñ¹ä´é	     
 1 compatible	-à¢éÒ¡Ñ¹ä´é	     
 1 complexation	¡ÒÃà¡Ô´ÊÒÃàªÔ§«éÍ¹	     
 1 complex coacervation	â¤ÍÐà«ÍÃìàÇªÑ¹àªÔ§«éÍ¹	     
 1 complex	ÊÒÃàªÔ§«éÍ¹, àªÔ§«éÍ¹	     
 1 compliance	¡ÒÃ»¯ÔºÑµÔµÒÁÊÑè§, ¤ÇÒÁËÂØè¹ (ËÅÍ´àÅ×Í´)	     
 1 complimentary medicine	¡ÒÃá¾·ÂìàÊÃÔÁ	     
 1 compound	ÊÒÃ»ÃÐ¡Íº, ¤ÍÁ¾ÒÇ´ì	     
 1 compounding	¡ÒÃ»ÃØ§ÂÒ	     
 1 compressibility	¤ÇÒÁÊÒÁÒÃ¶µÍ¡ÍÑ´	     
 1 compression-coated tablet	ÂÒàÁç´µÍ¡à¤Å×Íº	     
 1 compression	¡ÒÃµÍ¡ÍÑ´	     
 1 compulsory	ÁÒµÃ¡ÒÃºÑ§¤ÑºãªéÊÔ·¸Ô	     
 1 concentration gradient	¤ÇÒÁµèÒ§ÃÐ´Ñº¢Í§¤ÇÒÁà¢éÁ¢é¹	     
 1 conception	¡ÒÃ¼ÊÁ(¾Ñ¹¸Øì)µÔ´	     
 1 conductivity	ÊÀÒ¾¹Ó	     
 1 cone and plate viscometer	à¤Ã×èÍ§ÇÑ´¤ÇÒÁË¹×´áººâ¤¹áÅÐà¾Åµ	     
 1 configuration	â¤Ã§áºº	     
 1 conformation	â¤Ã§ÃÙ»	     
 1 congeal	á¢ç§µÑÇ, ¢é¹á¢ç§	     
 1 congelation	¡ÒÃá¢ç§µÑÇ, ¡ÒÃ¢é¹á¢ç§	     
 1 conjugate	¤Çº¤Ùè	     
 1 conjunctival	·Ò§àÂ×èÍµÒ	     
 1 constituent	ÊèÇ¹»ÃØ§áµè§, ÊèÇ¹»ÃÐ¡Íº	     
 1 constitutive properties	ÊÁºÑµÔà¹×èÍ§¨Ò¡ÊèÇ¹»ÃÐ¡Íº	     
 1 contact angle	ÁØÁÊÑÁ¼ÑÊ	     
 1 contaminant	ÊÔè§»¹à»×éÍ¹	     
 1 contamination	¡ÒÃ»¹à»×éÍ¹	     
 1 content uniformity	¤ÇÒÁÊÁèÓàÊÁÍ¢Í§µÑÇÂÒ, ¤ÇÒÁÊÁèÓàÊÁÍ¢Í§ÊÒÃ	     
 1 continental method	ÇÔ¸ÕàµÃÕÂÁ(ÍÔÁÑÅªÑ¹)áºº¡ÑÁáËé§	     
 1 continuing pharmacy education (CPE)	¡ÒÃÈÖ¡ÉÒµèÍà¹×èÍ§·Ò§àÀÊÑªÈÒÊµÃì	     
 1 contraception	¡ÒÃ¤ØÁ¡Óà¹Ô´	     
 1 contractility	¤ÇÒÁÊÒÁÒÃ¶Ë´µÑÇ (¢Í§¡ÅéÒÁà¹×éÍ)	     
 1 contracture	¡ÒÃË´¤éÒ§ (¢Í§¡ÅéÒÁà¹×éÍ)	     
 1 contraindication	¢éÍËéÒÁãªé	     
 1 controlled release	¡ÒÃ¤Çº¤ØÁ¡ÒÃ»Å´»ÅèÍÂÂÒ, -¤Çº¤ØÁ¡ÒÃ»Å´»ÅèÍÂÂÒ	     
 1 control number	ËÁÒÂàÅ¢¤Çº¤ØÁ (¤Ø³ÀÒ¾)	     
 1 conveyor dryer	à¤Ã×èÍ§·ÓãËéáËé§áººÊÒÂ¾Ò¹	     
 1 convulsion	¡ÒÃªÑ¡	     
 1 copolymer	â¤¾ÍÅÔàÁÍÃì	     
 1 cornwall syringe	¡ÃÐºÍ¡©Õ´¤ÍÃì¹ÇÍÅÅì	     
 1 cosolvent	µÑÇ·ÓÅÐÅÒÂÃèÇÁ	     
 1 cost-benefit analysis	¡ÒÃÇÔà¤ÃÒÐËìµé¹·Ø¹¼Åä´é	     
 1 cost consciousness	¨ÔµÊÓ¹Ö¡´éÒ¹µé¹·Ø¹	     
 1 cost-effectiveness analysis	¡ÒÃÇÔà¤ÃÒÐËìµé¹·Ø¹»ÃÐÊÔ·¸Ô¼Å	     
 1 cost-utility analysis	¡ÒÃÇÔà¤ÃÒÐËìµé¹·Ø¹ÍÃÃ¶»ÃÐâÂª¹ì	     
 1 cosurfactant	ÊÒÃÅ´áÃ§µÖ§¼ÔÇÃèÇÁ	     
 1 Coulter counter	à¤Ã×èÍ§ÇÑ´¢¹Ò´(Í¹ØÀÒ¤)áºº¤ÙÅà·ÍÃì	     
 1 counselling	¡ÒÃãËé¤Ó»ÃÖ¡ÉÒ	     
 1 counselor	¼ÙéãËé¤Ó»ÃÖ¡ÉÒ	     
 1 counterion	äÍÍÍ¹µÃ§¢éÒÁ	     
 1 counterirritant	-ÃÐ¤ÒÂÅéÒ§ÃÐ¤ÒÂ	     
 1 cream	¤ÃÕÁ, ÂÒ¤ÃÕÁ	     
 1 creaming	¡ÒÃáÂ¡ªÑé¹à»ç¹¤ÃÕÁ (¢Í§ÍÔÁÑÅªÑ¹)	     
 1 crosslinking agent	ÊÒÃàª×èÍÁ¢ÇÒ§	     
 1 crude drug	à¤Ã×èÍ§ÂÒ	     
 1 crude extract	ÊÒÃÊ¡Ñ´ËÂÒº	     
 1 crushing strength	áÃ§ÍÑ´áµ¡	     
 1 crystal habit	ÅÑ¡É³Ð¼ÅÖ¡	     
 1 crystal lattice	â¤Ã§ÃèÒ§¼ÅÖ¡	     
 1 crystalline	-à»ç¹¼ÅÖ¡	     
 1 cube mixer	à¤Ã×èÍ§¼ÊÁáººÅÙ¡àµëÒ	     
 1 cup and bob viscometer	à¤Ã×èÍ§ÇÑ´¤ÇÒÁË¹×´áºº¤ÑºáÅÐºçÍº	     
 1 cutting mill	à¤Ã×èÍ§º´µÑ´	     
 1 cyanosis	ÍÒ¡ÒÃà¢ÕÂÇ¤ÅéÓ	     
 1 cytotoxic	-à»ç¹¾ÔÉµèÍà«ÅÅì	     
 1 decantation	¡ÒÃÃÔ¹áÂ¡µÐ¡Í¹	     
 1 decay	¡ÒÃÊÅÒÂ	     
 1 decoction	¡ÒÃµéÁ (ÂÒ), ÂÒµéÁ	     
 1 decomposition	¡ÒÃàÊ×èÍÁÊÀÒ¾	     
 1 decontamination	¡ÒÃ¡Ó¨Ñ´ÊÔè§»¹à»×éÍ¹, ¡ÒÃÅ´ÊÔè§»¹à»×éÍ¹	     
 1 dedusting	¡ÒÃ¡Ó¨Ñ´½Øè¹¼§ (¨Ò¡àÁç´ÂÒ)	     
 1 deep concave	àÇéÒÅÖ¡	     
 1 defined daily dose (DDD)	¢¹Ò´ÂÒà©ÅÕèÂµèÍÇÑ¹	     
 1 defined medium	ÍÒËÒÃàÅÕéÂ§àª×éÍ·Õè¡ÓË¹´ÊèÇ¹»ÃÐ¡Íº	     
 1 deflocculation	¡ÒÃ¡ÃÐ¨ÒÂ¡ÅØèÁ	     
 1 defoaming	¡ÒÃ¡Ó¨Ñ´¿Í§, ¡ÒÃÅ´¿Í§	     
 1 deformation	¡ÒÃà»ÅÕèÂ¹ÃÙ»	     
 1 dehydration	¡ÒÃàÊÕÂ¹éÓ, ¡ÒÃ¢¨Ñ´¹éÓ, ÀÒÇÐ¢Ò´¹éÓ	     
 1 deionized water	¹éÓ¢¨Ñ´äÍÍÍ¹áÅéÇ	     
 1 delayed type hypersensitivity	ÀÒÇÐÀÙÁÔäÇà¡Ô¹ª¹Ô´¤èÍÂà»ç¹¤èÍÂä»	     
 1 deliquescence	¡ÒÃª×é¹àËÅÇ	     
 1 demulcent	ÂÒºÃÃà·ÒÃÐ¤ÒÂ (¤Í)	     
 1 denature	á»Å§ÊÀÒ¾	     
 1 densitometer	ÁÒµÃ¤ÇÒÁ·ÖºáÊ§, à¤Ã×èÍ§ÇÑ´¤ÇÒÁà¢éÁ (áÊ§)	     
 1 density	¤ÇÒÁË¹Òá¹è¹	     
 1 dentifrice	ÂÒÊÕ¿Ñ¹, ÂÒÊÕ¿Ñ¹¼§	     
 1 depolarization	¡ÒÃ¡ÅÑº¢ÑéÇä¿¿éÒ, ´Õâ¾ÅÒäÃà«ªÑ¹	     
 1 dermal	-Ë¹Ñ§á·é	     
 1 dermatological	-¼ÔÇË¹Ñ§	     
 1 desiccant	ÊÒÃ´Ù´¤ÇÒÁª×é¹	     
 1 desiccation	¡ÒÃ·ÓãËéáËé§	     
 1 desiccator	ÀÒª¹Ðãªé·ÓáËé§	     
 1 desorption	¡ÒÃ¤ÒÂ (¨Ò¡¡ÒÃ´Ù´«Ñº)	     
 1 detoxification	¡ÒÃ¢¨Ñ´¾ÔÉ, ¡ÒÃ¶Í¹¾ÔÉ (ÊÒÃàÊ¾µÔ´)	     
 1 dextr(o)	-¢ÇÒ	     
 1 dextrorotatory	-ËÁØ¹¢ÇÒ (áÊ§ÃÐ¹Òºà´ÕÂÇ)	     
 1 diagnosis-related groups (DRGs)	¡ÅØèÁÇÔ¹Ô¨©ÑÂâÃ¤ÃèÇÁ	     
 1 dialysis	¡ÒÃáÂ¡ÊÒÃ¼èÒ¹àÂ×èÍ, ä´áÍÅÔ«ÔÊ	     
 1 diaphoretic	ÊÒÃ/ÂÒ¢ÑºàË§×èÍ	     
 1 die	àºéÒ	     
 1 dielectric constant	¤èÒ¤§·Õèä´ÍÔàÅç¡·ÃÔ¡	     
 1 dietary supplement	¼ÅÔµÀÑ³±ìàÊÃÔÁÍÒËÒÃ	     
 1 differential medium	ÍÒËÒÃàÅÕéÂ§àª×éÍà¾×èÍáÂ¡ª¹Ô´àª×éÍ	     
 1 differential staining	¡ÒÃÂéÍÁÊÕà¾×èÍáÂ¡ª¹Ô´àª×éÍ	     
 1 diffusion coefficient	ÊÑÁ»ÃÐÊÔ·¸Ôì¡ÒÃá¾Ãè	     
 1 diffusion-controlled	-¤Çº¤ØÁâ´Â¡ÒÃá¾Ãè	     
 1 diffusion	¡ÒÃá¾Ãè	     
 1 diffusivity	ÊÑÁ»ÃÐÊÔ·¸Ôì¡ÒÃá¾Ãè	     
 1 digestant	ÂÒ(ªèÇÂ)ÂèÍÂ (ÍÒËÒÃ)	     
 1 digestive	ÂÒ(ªèÇÂ)ÂèÍÂ (ÍÒËÒÃ)	     
 1 dilatant	ä´àÅá·¹µì	     
 1 diluent	µÑÇ·Óà¨×Í¨Ò§	     
 1 dilution potential	¤ÇÒÁÊÒÁÒÃ¶¾ÒÊÒÃ, ¤ÇÒÁÊÒÁÒÃ¶¾ÒµÑÇÂÒÊÓ¤Ñ­	     
 1 dip coating	¡ÒÃ¨ØèÁà¤Å×Íº	     
 1 diploid	â¤ÃâÁâ«Á¤ÃºªØ´, ´Ô¾ÅÍÂ´ì	     
 1 direct compression	¡ÒÃµÍ¡µÃ§	     
 1 direct compression	¡ÒÃµÍ¡ÍÑ´â´ÂµÃ§	     
 1 discharged counseling	¡ÒÃãËé¤Ó»ÃÖ¡ÉÒá¡è¼Ùé»èÇÂ¡èÍ¹¨ÓË¹èÒÂ (ÍÍ¡¨Ò¡âÃ§¾ÂÒºÒÅ)	     
 1 discoloration	¡ÒÃà»ÅÕèÂ¹ÊÕ	     
 1 discount rate	ÍÑµÃÒ»ÃÑºÅ´, ÍÑµÃÒ«×éÍÅ´	     
 1 disinfectant	ÊÒÃ¦èÒàª×éÍ,-¦èÒàª×éÍ	     
 1 disinfection	¡ÒÃ¦èÒàª×éÍ	     
 1 disintegrant	ÊÒÃªèÇÂáµ¡µÑÇ	     
 1 disintegration	¡ÒÃáµ¡µÑÇ	     
 1 dispensing fee	¤èÒ¸ÃÃÁà¹ÕÂÁ¡ÒÃ¨èÒÂÂÒ	     
 1 dispensing	¡ÒÃ¨èÒÂÂÒ	     
 1 dispensing pharmacy	àÀÊÑª¡ÃÃÁ¨èÒÂÂÒ	     
 1 dispersed phase	ÇÑ¯ÀÒ¤¡ÃÐ¨ÒÂµÑÇ	     
 1 disperse system	ÃÐºº¡ÃÐ¨ÒÂµÑÇ	     
 1 dispersing agent	ÊÒÃªèÇÂ¡ÃÐ¨ÒÂ(µÑÇ)	     
 1 dispersion medium	µÑÇ¡ÅÒ§¡ÒÃ¡ÃÐ¨ÒÂ	     
 1 disposition (drug)	¡ÒÃà»ÅÕèÂ¹·Õè (ÂÒã¹ÃèÒ§¡ÒÂ)	     
 1 dissolution-controlled	-¤Çº¤ØÁâ´Â¡ÒÃÅÐÅÒÂ	     
 1 dissolution	¡ÒÃÅÐÅÒÂ	     
 1 dissolution profile	à¤éÒâ¤Ã§¡ÒÃÅÐÅÒÂ	     
 1 distribution agent	ÊÒÃ(ªèÇÂ)á¼è¡ÃÐ¨ÒÂ	     
 1 divided powder	ÂÒ¼§áºè§¢¹Ò´, ÂÒ¼§áºè§ºÃÃ¨Ø	     
 1 DNA replication	¡ÒÃ¶èÒÂáºº´ÕàÍç¹àÍ	     
 1 domain	ÊèÇ¹¨Óà¾ÒÐ	     
 1 dosage form	ÃÙ»áººÂÒ	     
 1 dosage regimen	á¼¹¡ÓË¹´¡ÒÃãªéÂÒ	     
 1 dose	¢¹Ò´(¡ÒÃãªé)ÂÒ	     
 1 dose dumping	¡ÒÃáµ¡·ÐÅÑ¡¢Í§ÂÒ (ã¹ÃèÒ§¡ÒÂ)	     
 1 douche	ÂÒÊÇ¹ÅéÒ§, ÊÇ¹ÅéÒ§, ©Õ´ÅéÒ§	     
 1 down-regulation	¡ÒÃ¤Çº¤ØÁ»ÃÔÁÒ³ÁÒ¡/¤ÇÒÁà¢éÁ¢é¹ÊÙ§ãËéÅ´Å§	     
 1 dragée	ยาเม็ดเคลือบ	     
 1 drug abuse	¡ÒÃãªéÂÒã¹·Ò§·Õè¼Ô´	     
 1 drug addiction	¡ÒÃµÔ´ÂÒ	     
 1 drug dependence	¡ÒÃµÔ´ÂÒ	     
 1 drug design	¡ÒÃÍÍ¡áººÂÒ, ¡ÒÃ»ÃÐ´ÔÉ°ìÂÒ	     
 1 drug entrapment	¡ÒÃËèÍËØéÁÂÒ, ¡ÒÃ¡Ñ¡à¡çºÂÒäÇéÀÒÂã¹	     
 1 drug expenditure	¤èÒãªé¨èÒÂ´éÒ¹ÂÒ	     
 1 drug  formulary	àÀÊÑªµÓÃÑº	     
 1 drug information	àÀÊÑªÊ¹à·È	     
 1 drug information center (DIC)	ÈÙ¹ÂìàÀÊÑªÊ¹à·È	     
 1 drug information	ÊÒÃÊ¹à·È·Ò§ÂÒ	     
 1 drug information service (DIS)	¡ÒÃºÃÔ¡ÒÃàÀÊÑªÊ¹à·È	     
 1 drug interaction	»¯Ô¡ÔÃÔÂÒ¢Í§ÂÒ, ÍÑ¹µÃ¡ÔÃÔÂÒ¢Í§ÂÒ	     
 1 drug intolerance	¤ÇÒÁäÁè·¹(µèÍ)ÂÒ	     
 1 drug misadventuring	»Ñ­ËÒ¨Ò¡¡ÒÃãªéÂÒ	     
 1 drug monitoring	¡ÒÃµÃÇ¨µÔ´µÒÁ¡ÒÃãªéÂÒ	     
 1 drug monograph	ÃÒÂÅÐàÍÕÂ´¢Í§ÂÒ (·Õè¡ÓË¹´ã¹áººá¼¹à´ÕÂÇ¡Ñ¹)	     
 1 drug procurement	¡ÒÃ¨Ñ´ËÒÂÒ	     
 1 drug profile	ºÑ¹·Ö¡¡ÒÃãªéÂÒ (¢Í§¼Ùé»èÇÂ)	     
 1 drug receptor	µÑÇ¨ÑºÂÒà©¾ÒÐ	     
 1 drug related problem (DRP)	»Ñ­ËÒ¨Ò¡¡ÒÃãªéÂÒ	     
 1 drug release	¡ÒÃ»Å´»ÅèÍÂÂÒ	     
 1 drug reservoir	ºÃÔàÇ³¡Ñ¡à¡çºÂÒ	     
 1 drug screening	¡ÒÃ¤Ñ´¡ÃÍ§ÊÒÃ·ÕèÁÕÄ·¸Ôì·Ò§ÂÒ	     
 1 drug targeting	¡ÒÃ¹ÓÊè§ÂÒÊÙèà»éÒËÁÒÂ	     
 1 drug therapy	¡ÒÃºÓºÑ´´éÇÂÂÒ, ¡ÒÃÃÑ¡ÉÒ´éÇÂÂÒ	     
 1 drug tolerance	¤ÇÒÁ·¹(µèÍ)ÂÒ, ¤ÇÒÁªÔ¹ÂÒ	     
 1 drug treatment	¡ÒÃºÓºÑ´´éÇÂÂÒ, ¡ÒÃÃÑ¡ÉÒ´éÇÂÂÒ	     
 1 drug use evaluation (DUE)	¡ÒÃ»ÃÐàÁÔ¹¡ÒÃãªéÂÒ	     
 1 drug utilization evaluation (DUE)	¡ÒÃ»ÃÐàÁÔ¹¡ÒÃãªéÂÒ	     
 1 dry granulation	¡ÒÃ·Óá¡Ã¹ÙÅáËé§	     
 1 dry gum method	ÇÔ¸ÕàµÃÕÂÁ(ÍÔÁÑÅªÑ¹)áºº¡ÑÁáËé§	     
 1 duration of action	ªèÇ§àÇÅÒÍÍ¡Ä·¸Ôì	     
 1 dusting powder	ÂÒ¼§âÃÂ (¼ÔÇË¹Ñ§)	     
 1 dye	ÊÕ(ª¹Ô´ÅÐÅÒÂ¹éÓ)	     
 1 dynamic	¾ÅÇÑµ	     
 1 dyne	´ÒÂ¹ì	     
 1 Ebers Papyrus	ÍÕàºÍÃìÊ¾Òä¾ÃØÊ (µÓÃÒÂÒÊÁÑÂÍÕÂÔ»µì)	     
 1 ecbolic	ÂÒºÕºÁ´ÅÙ¡	     
 1 effectiveness	»ÃÐÊÔ·¸Ô¼Å	     
 1 effervescence	¡ÒÃà¡Ô´¿Í§¿Ùè	     
 1 effervescent	-¿Í§¿Ùè	     
 1 efficacy	»ÃÐÊÔ·¸ÔÈÑ¡Âì	     
 1 efficiency	»ÃÐÊÔ·¸ÔÀÒ¾	     
 1 efflorescence	¡ÒÃàÊÕÂ¹éÓ¼ÅÖ¡	     
 1 ejection force	áÃ§´Ñ¹ (àÁç´ÂÒ) ÍÍ¡¨Ò¡àºéÒ	     
 1 ejection	¡ÒÃ´Ñ¹ (àÁç´ÂÒ) ÍÍ¡¨Ò¡àºéÒ	     
 1 elastic deformation	¡ÒÃà»ÅÕèÂ¹ÃÙ»áººÂ×´ËÂØè¹	     
 1 elasticity	ÊÀÒ¾Â×´ËÂØè¹	     
 1 electric double layer	ªÑé¹»ÃÐ¨Øä¿¿éÒ¤Ùè	     
 1 electrodialysis	¡ÒÃáÂ¡ÊÒÃ¼èÒ¹àÂ×èÍ´éÇÂä¿¿éÒ, ä´áÍÅÔ«ÔÊ´éÇÂä¿¿éÒ	     
 1 electrokinetic	-¨Å¹ìä¿¿éÒ	     
 1 electrolyte	ÍÔàÅç¡â·ÃäÅµì	     
 1 electrophoresis	¡ÒÃà¤Å×èÍ¹ÊÙè¢ÑéÇä¿¿éÒ, ÍÔàÅç¡â·Ãâ¿ÃÕ«ÔÊ	     
 1 electrostatic	-ä¿¿éÒÊ¶Ôµ	     
 1 elementary osmotic pump	ÍÍÊâÁµÔ¡»ÑêÁáºº¾×é¹°Ò¹	     
 1 elimination	¡ÒÃ¡Ó¨Ñ´ (ÂÒ)	     
 1 elixir	ÍÔÅÔ¡à«ÍÃì, ÂÒÍÔÅÔ¡à«ÍÃì	     
 1 elongation	¡ÒÃÂ×´	     
 1 elution	¡ÒÃªÐ	     
 1 embed	½Ñ§	     
 1 emboss	»ÑêÁÅÒÂ¹Ù¹ (º¹àÁç´ÂÒ)	     
 1 embrocation	¡ÒÃ·Ò (ÂÒ), ¡ÒÃ·Ò¶Ù¹Ç´ (ÂÒ), ÂÒ·Ò, ÂÒ·Ò¶Ù¹Ç´	     
 1 emetic	ÂÒ·ÓãËéÍÒà¨ÕÂ¹	     
 1 emmenagogue	ÂÒ¢ÑºÃÐ´Ù, ÂÒ¢Ñº»ÃÐ¨Óà´×Í¹	     
 1 emollient	ÊÒÃ·ÓãËé¹ØèÁáÅÐªØèÁª×é¹	     
 1 empirical	â´Â»ÃÐÊº¡ÒÃ³ì	     
 1 emulsification	¡ÒÃ·ÓãËéà¡Ô´ÍÔÁÑÅªÑ¹	     
 1 emulsifier	ÊÒÃ·ÓÍÔÁÑÅªÑ¹	     
 1 emulsifying agent	ÊÒÃ·ÓÍÔÁÑÅªÑ¹	     
 1 emulsion	ÍÔÁÑÅªÑ¹, ÂÒÍÔÁÑÅªÑ¹	     
 1 encapsulation	¡ÒÃÁÕ¶Ø§ËØéÁ, ¡ÒÃËèÍËØéÁ	     
 1 encode	à¢éÒÃËÑÊ	     
 1 endocytosis	¡ÒÃ¹Óà¢éÒà«ÅÅì, àÍ¹â´ä«â·«ÔÊ	     
 1 endothermic	-´Ù´¤ÇÒÁÃéÍ¹	     
 1 endotoxin	ªÕÇ¾ÔÉÀÒÂã¹µÑÇ	     
 1 enema	ÂÒÊÇ¹·ÇÒÃ	     
 1 English method	ÇÔ¸ÕàµÃÕÂÁ (ÍÔÁÑÅªÑ¹) áººÍÑ§¡ÄÉ	     
 1 engrave	»ÑêÁÅÒÂ¨Á (º¹àÁç´ÂÒ)	     
 1 enteric coating	¡ÒÃà¤Å×Íºà¾×èÍãËéáµ¡µÑÇã¹ÅÓäÊé, ¡ÒÃà¤Å×ÍºàÍ¹à·ÍÃÔ¡	     
 1 enterotoxin	ªÕÇ¾ÔÉÍÍ¡Ä·¸Ôìã¹ÅÓäÊé	     
 1 epitope	ÊèÇ¹¢Í§áÍ¹µÔà¨¹·Õè¨Ñº¡ÑºáÍ¹µÔºÍ´Õ	     
 1 equality	¤ÇÒÁà·èÒà·ÕÂÁ	     
 1 equity	¤ÇÒÁà»ç¹¸ÃÃÁ	     
 1 erosion	¡ÒÃ¡ÃèÍ¹	     
 1 essence	ËÑÇ¹éÓËÍÁ	     
 1 essential drug	ÂÒ¨Óà»ç¹	     
 1 essential drugs list	ºÑ­ªÕÂÒËÅÑ¡	     
 1 essential oil	¹éÓÁÑ¹ËÍÁÃÐàËÂ	     
 1 ethnobotany	¾Ä¡ÉÈÒÊµÃìàªÔ§ªÒµÔ¾Ñ¹¸Øì, ¾Ä¡ÉÈÒÊµÃì¾×é¹ºéÒ¹	     
 1 ethnopharmacology	àÀÊÑªÇÔ·ÂÒàªÔ§ªÒµÔ¾Ñ¹¸Øì, àÀÊÑªÇÔ·ÂÒ¾×é¹ºéÒ¹	     
 1 etiology	ÊÁØ¯°Ò¹ÇÔ·ÂÒ, ÊÁØ¯°Ò¹ (¢Í§âÃ¤)	     
 1 eutectic mixture	ÊÒÃ¼ÊÁÂÙà·¡µÔ¡	     
 1 excipient	ÊÒÃ»ÃØ§áµè§ (ÂÒ)	     
 1 excretion	¡ÒÃ¢Ñº¶èÒÂ, ÊÔè§¢Ñº¶èÒÂ	     
 1 exocytosis	¡ÒÃ¹ÓÍÍ¡¨Ò¡à«ÅÅì, àÍ¡â«ä«â·«ÔÊ	     
 1 exoreceptor	µÑÇÃÑºÀÒÂ¹Í¡	     
 1 exothermic	-¤ÒÂ¤ÇÒÁÃéÍ¹	     
 1 exotoxin	ªÕÇ¾ÔÉ¤ÒÂÍÍ¡	     
 1 expiration date	ÇÑ¹ËÁ´ÍÒÂØ, ÇÑ¹ÊÔé¹ÍÒÂØ	     
 1 expiry date	ÇÑ¹ËÁ´ÍÒÂØ, ÇÑ¹ÊÔé¹ÍÒÂØ	     
 1 expression	¡ÒÃ¤Ñé¹, ¡ÒÃºÕºÍÍ¡	     
 1 exsiccation	¡ÒÃÊµØ, ¡ÒÃ·ÓãËéáËé§Ê¹Ô·	     
 1 extemporaneous preparation	ÂÒàµÃÕÂÁà©¾ÒÐ¤ÃÒÇ	     
 1 extended release	¡ÒÃÍÍ¡Ä·¸Ôì¹Ò¹ (¢Í§ÂÒ)	     
 1 external phase	ÇÑ¯ÀÒ¤ÀÒÂ¹Í¡	     
 1 extract	ÂÒÊ¡Ñ´, ÊÔè§Ê¡Ñ´, ÊÒÃÊ¡Ñ´, Ê¡Ñ´	     
 1 extraction	¡ÒÃÊ¡Ñ´	     
 1 extragranular disintegrant	ÊÒÃªèÇÂáµ¡µÑÇÀÒÂ¹Í¡á¡Ã¹ÙÅ	     
 1 extrudate	àÊé¹·Õèä´é¨Ò¡à¤Ã×èÍ§ÍÑ´àÊé¹	     
 1 extruder	à¤Ã×èÍ§ÍÑ´àÊé¹	     
 1 extrusion	¡ÒÃÍÑ´ãËéà»ç¹àÊé¹	     
 1 exudate	ÊÒÃàËÅÇ¢é¹«Öè§«ÖÁ¼èÒ¹àÂ×èÍ	     
 1 eye drop	ÂÒËÂÍ´µÒ	     
 1 eye ointment	¢Õé¼Öé§»éÒÂµÒ	     
 1 facilitated diffusion	¡ÒÃá¾ÃèáººÁÕµÑÇªèÇÂ	     
 1 facultative anaerobe	¨ØÅÔ¹·ÃÕÂì·Õèà¨ÃÔ­ä´é·Ñé§ã¹·ÕèÁÕËÃ×ÍäÁèÁÕÍÒ¡ÒÈ	     
 1 falling sphere viscometer	à¤Ã×èÍ§ÇÑ´¤ÇÒÁË¹×´áºº¡ÒÃµ¡¢Í§ÅÙ¡·Ã§¡ÅÁ	     
 1 false transmitter	ÊÒÃÊ×èÍÅÇ§	     
 1 feed shoe	à¡×Í¡»éÍ¹¼§ÂÒáÅÐ»Ñ´àÁç´ÂÒ (¢Í§à¤Ã×èÍ§µÍ¡)	     
 1 fellow	¼ÙéÃÑº¡ÒÃ½Ö¡ÍºÃÁà©¾ÒÐÊÒ¢Ò, ÇØ²ÔºÑ³±Ôµ	     
 1 fellowship	°Ò¹ÀÒ¾¼ÙéÃÑº¡ÒÃ½Ö¡ÍºÃÁà©¾ÒÐÊÒ¢Ò	     
 1 fetotoxic	à»ç¹¾ÔÉµèÍ·ÒÃ¡ã¹¤ÃÃÀì	     
 1 filler	ÊÒÃà¾ÔèÁ»ÃÔÁÒ³	     
 1 film-coated tablet	ÂÒàÁç´à¤Å×Íº¿ÔÅìÁ	     
 1 film coating	¡ÒÃà¤Å×Íº¿ÔÅìÁ	     
 1 film formation	¡ÒÃ¡èÍ¿ÔÅìÁ	     
 1 film former	ÊÒÃ¡èÍ¿ÔÅìÁ	     
 1 filter aid	ÊÒÃªèÇÂã¹¡ÒÃ¡ÃÍ§	     
 1 filter media	µÑÇ¡ÅÒ§ÊÓËÃÑº¡ÃÍ§	     
 1 filter paper	¡ÃÐ´ÒÉ¡ÃÍ§	     
 1 filtrate	¢Í§àËÅÇ·Õèä´é¨Ò¡¡ÒÃ¡ÃÍ§	     
 1 fine	ÅÐàÍÕÂ´, ¼§ÅÐàÍÕÂ´	     
 1 fingerprint	ÅÒÂ¾ÔÁ¾ì¨Óà¾ÒÐ (ã¹Êà»¡µÃÑÁ)	     
 1 first messenger	µÑÇÊè§¢èÒÇµÑÇáÃ¡	     
 1 first-order kinetics	¨Å¹ÈÒÊµÃìÍÑ¹´ÑºË¹Öè§	     
 1 flat-faced	(ÊÒ¡) Ë¹éÒàÃÕÂº	     
 1 flat-face	(ÊÒ¡) Ë¹éÒàÃÕÂº	     
 1 flavor	ÊÒÃáµè§¡ÅÔè¹, ÊÒÃáµè§¡ÅÔè¹ÃÊ	     
 1 flavoring agent	ÊÒÃáµè§¡ÅÔè¹, ÊÒÃáµè§¡ÅÔè¹ÃÊ	     
 1 floc	¿ÅçÍ¡	     
 1 flocculation	¡ÒÃà¡ÒÐ¡ÅØèÁÍÂèÒ§ËÅÇÁ	     
 1 floccule	¿ÅçÍ¡¤ÙÅ	     
 1 flowability	¤ÇÒÁÊÒÁÒÃ¶ã¹¡ÒÃäËÅ	     
 1 fluid bed coating	¡ÒÃà¤Å×Íºáºº¿ÅÙÍÔ´àº´	     
 1 fluid bed granulator	à¤Ã×èÍ§·Óá¡Ã¹ÙÅáºº¿ÅÙÍÔ´àº´	     
 1 fluid bed technology	à·¤â¹âÅÂÕ¿ÅÙÍÔ´àº´	     
 1 fluid energy mill	à¤Ã×èÍ§º´ÅÐàÍÕÂ´´éÇÂáÃ§ÅÁ	     
 1 fluidextract	ÂÒÊ¡Ñ´àËÅÇ	     
 1 fluidity	ÊÀÒ¾àËÅÇ, ÊÀÒ¾äËÅä´é	     
 1 fluidized bed granulator	à¤Ã×èÍ§·Óá¡Ã¹ÙÅáºº¿ÅÙÍÔ´àº´	     
 1 fluidized bed technology	à·¤â¹âÅÂÕ¿ÅÙÍÔ´àº´	     
 1 foam	â¿Á, ¿Í§	     
 1 foam booster	ÊÒÃà¾ÔèÁ¿Í§	     
 1 folk medicine	¡ÒÃá¾·Âì¾×é¹ºéÒ¹	     
 1 food intoxication	ÍÒËÒÃ»¹à»×éÍ¹´éÇÂ·Í¡«Ô¹	     
 1 formula	ÊÙµÃ, µÓÃÑº	     
 1 formulation	¡ÒÃµÑé§µÓÃÑº	     
 1 Fourier transform infrared spectroscopy (FTIR)	Êà»¡â·ÃÊâ¡»ÕÍÔ¹¿ÃÒàÃ´ª¹Ô´¿ÙàÃÕÂÃì·ÃÒ¹Ê¿ÍÃìÁ	     
 1 fragrance	¹éÓËÍÁ	     
 1 free-flowing	¤ÇÒÁäËÅ¤ÅèÍ§ (¢Í§¼§ÂÒ), -äËÅÍÂèÒ§ÍÔÊÃÐ, -äËÅ¤ÅèÍ§	     
 1 free radical	Í¹ØÁÙÅÍÔÊÃÐ	     
 1 free radical scavenger	µÑÇ¨ÑºÍ¹ØÁÙÅÍÔÊÃÐ	     
 1 freeze dryer	à¤Ã×èÍ§·ÓãËéáËé§(áºº)àÂ×Í¡á¢ç§	     
 1 freeze drying	¡ÒÃ·ÓãËéáËé§(áºº)àÂ×Í¡á¢ç§	     
 1 freeze fracture	¡ÒÃËÑ¡ã¹ÀÒÇÐàÂ×Í¡á¢ç§	     
 1 freeze-thaw cycle	ÃÍº¡ÒÃ·ÓãËéàÂ×Í¡á¢ç§-¡ÒÃÍØè¹ÅÐÅÒÂ	     
 1 freezing point depression	¡ÒÃÅ´Å§¢Í§¨Ø´àÂ×Í¡á¢ç§	     
 1 friabilator	à¤Ã×èÍ§ÇÑ´¤ÇÒÁ¡ÃèÍ¹	     
 1 friability	¤ÇÒÁ¡ÃèÍ¹	     
 1 fungicide	ÂÒ¦èÒàª×éÍÃÒ	     
 1 fungistatic	ÂÒÂÑºÂÑé§¡ÒÃà¨ÃÔ­¢Í§àª×éÍÃÒ, –ÂÑºÂÑé§¡ÒÃà¨ÃÔ­¢Í§àª×éÍÃÒ	     
 1 fusion	¡ÒÃËÅÍÁ, ¡ÒÃÃÇÁµÑÇ	     
 1 galeni	-áºº¡ÒàÅ¹	     
 1 galenical	-áºº¡ÒàÅ¹	     
 1 gargle	ÂÒ¡ÅÑéÇ¤Í	     
 1 gas chromatography	â¤ÃÁÒâ·¡ÃÒ¿Õª¹Ô´á¡êÊ (¨Õ«Õ)	     
 1 gas sterilization	¡ÒÃ·ÓãËé»ÃÒÈ¨Ò¡àª×éÍ´éÇÂá¡êÊ	     
 1 gel	à¨Å, ÂÒà¨Å	     
 1 gelation	¡ÒÃà¡Ô´à¨Å	     
 1 gel permeation chromatography	â¤ÃÁÒâ·¡ÃÒ¿Õª¹Ô´«ÖÁá·Ã¡à¨Å (¨Õ¾Õ«Õ)	     
 1 gel-sol transition	¡ÒÃà»ÅÕèÂ¹ÊÀÒ¾à¨Å-¢Í§àËÅÇ	     
 1 general anesthetic	ÂÒÊÅº	     
 1 generic drug	ÂÒÊÒÁÑ­	     
 1 generic name	ª×èÍÊÒÁÑ­·Ò§ÂÒ	     
 1 genetic engineering	¾Ñ¹¸ØÇÔÈÇ¡ÃÃÁ	     
 1 genetic polymorphism	ÀÒÇÐ¾ËØÊÑ³°Ò¹·Ò§¾Ñ¹¸Ø¡ÃÃÁ	     
 1 genome	¨Õâ¹Á	     
 1 genotoxic	à»ç¹¾ÔÉ·Ò§¾Ñ¹¸Ø¡ÃÃÁ	     
 1 genotype	ÃÙ»áºº¾Ñ¹¸Ø¡ÃÃÁ, ¨Õâ¹ä·»ì	     
 1 geometric dilution	¡ÒÃà¨×Í¨Ò§áººàÃ¢Ò¤³Ôµ	     
 1 germicide	ÊÒÃ¦èÒ¨ØÅÔ¹·ÃÕÂì	     
 1 germination	¡ÒÃ§Í¡	     
 1 glass transition temperature	ÍØ³ËÀÙÁÔ¡ÅÒÊá·Ã¹ÊÔªÑ¹	     
 1 glidant	ÊÒÃªèÇÂäËÅ	     
 1 goitrogen	ÊÒÃ¡èÍ¤Í¾Í¡	     
 1 Good Agricultural Practice (GAP)	ÇÔ¸Õ»¯ÔºÑµÔ·Õè´Õã¹¡ÒÃà¾ÒÐ»ÅÙ¡	     
 1 Good Clinical Practice (GCP)	ÇÔ¸Õ»¯ÔºÑµÔ·Õè´Õã¹¡ÒÃ·´ÅÍ§·Ò§¤ÅÔ¹Ô¡	     
 1 Good Harvesting Practice (GHP)	ÇÔ¸Õ»¯ÔºÑµÔ·Õè´Õã¹¡ÒÃà¡çºà¡ÕèÂÇ	     
 1 Good Laboratory Practice (GLP)	ÇÔ¸Õ»¯ÔºÑµÔ·Õè´Õã¹¡ÒÃ·´ÅÍ§·Ò§ËéÍ§»¯ÔºÑµÔ¡ÒÃ	     
 1 Good Manufacturing Practice (GMP)	ÇÔ¸Õ»¯ÔºÑµÔ·Õè´Õã¹¡ÒÃ¼ÅÔµÂÒ	     
 1 Good Pharmacy Practice (GPP)	ÇÔ¸Õ»¯ÔºÑµÔ·Õè´Õ·Ò§àÀÊÑª¡ÃÃÁ	     
 1 grain	à¡Ã¹ (Ë¹èÇÂ¹éÓË¹Ñ¡)	     
 1 gram stain	¡ÒÃÂéÍÁÊÕá¡ÃÁ	     
 1 granulation	¡ÒÃ·Óá¡Ã¹ÙÅ	     
 1 granulator	à¤Ã×èÍ§·Óá¡Ã¹ÙÅ	     
 1 granule	á¡Ã¹ÙÅ, ÂÒá¡Ã¹ÙÅ	     
 1 granule density	¤ÇÒÁË¹Òá¹è¹¢Í§á¡Ã¹ÙÅ	     
 1 grievance	¡ÒÃÃéÍ§·Ø¡¢ì, ¡ÒÃÃéÍ§àÃÕÂ¹	     
 1 grinding	¡ÒÃº´, ¡ÒÃÅ´¢¹Ò´	     
 1 grinding stone	ËÔ¹º´ÂÒ	     
 1 gum	¡ÑÁ, ÂÒ§äÁé	     
 1 hard gelatin capsule	á¤»«ÙÅà¨ÅÒµÔ¹ª¹Ô´á¢ç§	     
 1 hemolytic anemia	ÀÒÇÐàÅ×Í´¨Ò§ª¹Ô´àÁç´àÅ×Í´á´§áµ¡	     
 1 herbal medicine	ÂÒÊÁØ¹ä¾Ã	     
 1 hermetic container	ÀÒª¹ÐºÃÃ¨Ø»Ô´Ê¹Ô·	     
 1 hospital pharmacy	àÀÊÑª¡ÃÃÁâÃ§¾ÂÒºÒÅ	     
 1 hypochromic microcytic anemia	ÀÒÇÐàÅ×Í´¨Ò§ª¹Ô´àÁç´àÅ×Í´á´§àÅç¡áÅÐµÔ´ÊÕ¨Ò§	     
 1 industrial pharmacy	àÀÊÑªÍØµÊÒË¡ÃÃÁ	     
 1 ionisation constant	¤èÒ¤§·Õè¡ÒÃáµ¡µÑÇà»ç¹äÍÍÍ¹	     
 1 iron deficiency anemia	ÀÒÇÐàÅ×Í´¨Ò§ª¹Ô´¢Ò´àËÅç¡	     
 1 jet mill	à¤Ã×èÍ§º´ÅÐàÍÕÂ´´éÇÂáÃ§ÅÁ	     
 1 literature evaluation	¡ÒÃ»ÃÐàÁÔ¹¤Ø³¤èÒ¢Í§º·¤ÇÒÁ	     
 1 local anesthetic	ÂÒªÒ	     
 1 malformation	ÃÙ»¾Ô¡ÒÃ, ÊÀÒ¾ÇÔÃÙ»	     
 1 medication adherence	¡ÒÃãªéÂÒµÒÁ¤Óá¹Ð¹Ó	     
 1 medication concordance	¡ÒÃãªéÂÒµÒÁ¤Óá¹Ð¹Ó	     
 1 medicinal chemistry	àÀÊÑªà¤ÁÕ, à¤ÁÕ¢Í§ÂÒ	     
 1 minor tranquilizer	ÂÒ¤ÅÒÂ¡Ñ§ÇÅ, Ê§º»ÃÐÊÒ·, ¤ÅÒÂ¡Ñ§ÇÅ	     
 1 notification	¡ÒÃ¨´á¨é§ÃÒÂÅÐàÍÕÂ´	     
 1 oxytocic	ÂÒºÕºÁ´ÅÙ¡	     
 1 parenteral feeding	¡ÒÃãËéÍÒËÒÃ·Ò§ËÅÍ´àÅ×Í´´Ó	     
 1 pathophysiology	¾ÂÒ¸ÔÊÃÕÃÇÔ·ÂÒ	     
 1 pernicious anemia	ÀÒÇÐàÅ×Í´¨Ò§ª¹Ô´¢Ò´ÍÔ¹·ÃÔ¹ÊÔ¡á¿¡àµÍÃìËÃ×ÍÇÔµÒÁÔ¹ºÕ 12	     
 1 pharmaceutical care	¡ÒÃºÃÔºÒÅ·Ò§àÀÊÑª¡ÃÃÁ	     
 1 pharmaceutical chemistry	àÀÊÑªà¤ÁÕ, à¤ÁÕ¢Í§ÂÒ	     
 1 pharmaceutical sciences	àÀÊÑªÈÒÊµÃì	     
 1 pharmaceutics	àÀÊÑª¡ÃÃÁ, àÀÊÑª¡ÒÃ	     
 1 pharmacodynamics	àÀÊÑª¾ÅÈÒÊµÃì	     
 1 pharmacoeconomics	àÀÊÑªàÈÃÉ°ÈÒÊµÃì	     
 1 pharmacognosy	àÀÊÑªàÇ·, àÀÊÑªÇÔ¹Ô¨©ÑÂ	     
 1 pharmacokinetics	àÀÊÑª¨Å¹ÈÒÊµÃì	     
 1 pharmacology	àÀÊÑªÇÔ·ÂÒ	     
 1 pharmacotherapy	àÀÊÑªºÓºÑ´	     
 1 pharmacy orientation	àÀÊÑªÈÒÊµÃìÊÑÁ¾Ñ¹¸ì, ¹Ôà·ÈàÀÊÑªÈÒÊµÃì	     
 1 pharmacy practice	àÀÊÑª¡ÃÃÁ»®ÔºÑµÔ	     
 1 prolonged release	¡ÒÃÍÍ¡Ä·¸Ôì¹Ò¹ (¢Í§ÂÒ)	     
 1 public health pharmacy	àÀÊÑªÊÒ¸ÒÃ³ÊØ¢	     
 1 registration	¡ÒÃ¢Öé¹·ÐàºÕÂ¹	     
 1 regulation harmonization	¡ÒÃºÃÃ³ÊÒ¹¡®ÃÐàºÕÂº	     
 1 sickle cell anemia	ÀÒÇÐàÅ×Í´¨Ò§ª¹Ô´àÁç´àÅ×Í´á´§ÃÙ»¨Ñ¹·ÃìàÊÕéÂÇ	     
 1 simple coacervation	â¤ÍÐà«ÍÃìàÇªÑ¹¸ÃÃÁ´Ò	     
 1 soft gelatin capsule	á¤»«ÙÅà¨ÅÒµÔ¹ª¹Ô´¹ÔèÁ	     
 1 soft gelatin capsule	á¤»«ÙÅà¨ÅÒµÔ¹ª¹Ô´ÍèÍ¹	     
 1 structure elucidation	¡ÒÃÍ¸ÔºÒÂâ¤Ã§ÊÃéÒ§, ¡ÒÃáÊ´§â¤Ã§ÊÃéÒ§	     
 1 sustained release	¡ÒÃÍÍ¡Ä·¸Ôì¹Ò¹ (¢Í§ÂÒ)	     
 1 toxicology	¾ÔÉÇÔ·ÂÒ	     
 1 volatile oil	¹éÓÁÑ¹ËÍÁÃÐàËÂ	     
