Abklärung	averiguação, estudo
Ablagerung	depósito
Allergologe	alergologista
allseits lebhaft seitengleich auslösbare Reflexe	os reflexos podem ser provocados de igual modo em ambos os lados
Amenorrhoe	amenorréia
Aminosäure	aminoácido
Anamnese	anamnese
Andrologie	andrologia
Arbeitstemperatur	temperatura corporal
Atemgymnastik	ginástica de respiração
Atemweg	via respiratória
atypische Pneumonie	pneumonia atipica
Aufnahmebefund	diagnóstico de entrada
ärztliche Untersuchung	tratamento médico
Bandscheibe	disco vertebral
Bandscheibenvorfall	hérnia discal
Base	alcalino
Beckenboden	pavimento pélvico
Beckenkamm	crista iliaca
Befund	diagnóstico
Belastungsinkontinenz	incontinência de stress
Bewegungsapparat	aparelho locomotor
Blasen-/Mastdarmstörung	distúrbio recto-vesical
Blasenverweilkatheter	cateter urinário permanente
Blutdruckmessgerät	esfigmomanómetro
Blutvergiftung	sepsia (envenenamento do sangue)
Blutzuckerspiegel	taxa de glicemia
Bronchoskopie	broncoscopia
Cage	cage
Cageplastik	cage sintético
Cervikobrachialgie	cervicobraquialgia
Chefarzt	médico-chefe
verwaltungsrechtliche Rechtsstreitigkeit	contencioso administrativo
Cystocele	cistocele
cystotonometrisch	cistotonométrico
dorsaler Oberarm	braço superior dorsal
dreifach orientiert	com orientação tripla
Dysästhesie	disestesia
Eiweissynthese	sintese de albumina
Entlassungsbericht	relatório de alta
Entnahmestelle	local da colheita
Entschlackung	purificação
Erkältungsvirus	virus de constipação
ernährungsphysiologisch	do ponto de vista da ciência de nutrição
Fadenentfernung	remoção dos pontos
fiberoptisches Instrument	feixe de fibras ópticas
Generikum	genérico
Haemophilus	haemophilus
Hauptast der Bronchien	ramo principal dos brônquios
Hausbesuch	visita ao domicílio
Herz- Kreislaufbelastung	sobrecarga do sistema cardio-vascular
Herzstörung	perturbações cardíacas
Heuschnupfen	febre dos fenos
Hypästhesie	hipestesia
Hyposensibilität	hiposensibilidade
in stationärer Behandlung befinden	estar internado nos serviços
infektiöser Krankheitserreger	micróbio patogénico infeccioso
intravenös	intravenoso
Intubationsnarkose	anestesia com intuabação traqueal
Kalkeinlagerung	depósito de cálcio
Keim	germe
Knochenmark	medula óssea
Kraftgrad	grau de força
Krankheitsbild	quadro clínico, descrição da doença
Krankheitserreger	micróbio patagénico
Krankheitsverlauf	decurso da doença
Krankheitsverlauf	evolução de uma doença
Kreuzschmerzen	dores da região lombar
Legionellen	legionellas
Leistungsknick	redução de forças
Lungengewebe+	tecido pulmonar
Lymphflüssigkeit	linfa
Magen-Darm-Trakt	aparelho digestivo
Manschette	braçadeira
Medikament verabreichen	ministrar um medicamento
mobilisierendes Bewegungstraining	ginástica mobilizadora
motorisch lässt sich feststellen	Ao nivel motor / Relativamente à função motora comprova-se
Muskeleigenreflexe	reflexos musculares próprios
Muskulaturverkrampfung	contracção da musculatura
Nasennebenhöhle	seio nasal/perinasal
Nasenschleimhaut	mucosas nasais
Nährflüssigkeit	substância nutritiva
Nervenblockierung	bloqueio de nervos
Mammapathologie	patologia mamária
Penicillin	penicilina
Pneumokokken	pneumococos
Pseudomonas	pseudomonas
radialseitiger Unterarm	lado radial do antebraço
Raucherlunge	pulmões de fumador
Rectocele	rectocele
gerontologische Pflege-/Betreuungseinrichtung	recursos gerontologicos
reduzierter AZ (Aufnahmezustand)	estado geral debilitado
Reflexzonenverbreiterung	alargamento das zonas de reflexo
Reithosenhypästhesie	hipestesia na zona das nádegas
Restharn	urina residual
Restharnbildung	formação de resíduos urinários
Schutzstoffe	substâncias protectoras
Sepsis	sepsia
Spiegelung	endoscopia
Spurenelement	oligoelemento
stationärer Aufenthalt	internamento
Stethosphon	estetoscópio
Suspensionsplastik	cirurgia/plastia de suspensão
Suspensionsplastik	cirurgia/plastia de suspensão
Trizepsparese	paresia do triceps
Um- und Abbau der Nahrungsbestandteile	transformação e degradação de nutrientes
untergewichtiger EZ (Ernährungszustand)	estado nutricional deficitário
Uroonkologie	uro-oncologia
ventrale Deskektomie	discectomia ventral
Verhärtung	esclerose
verzweigkettige Aminosäuren	aminoácidos ramificados em cadeias
Viruspneumonie	pneumonia viral
Wirbelkörper	vértebra
Wirbelsäule	coluna vertebral
Wundverhältnis	situação das feridas
Z. n.	condição após
Zellstruktur	estrutura célular
Zellwände	paredes célulares
Zytomegalie-Virus	cetomegalovirus
A.L.T.	A.L.T. (alanine transaminas)
A.S.T.	A.S.T. (aspartate aminotransferase)
Lungenabszess	abcesso pulmonar
Abdomen, Bauch	abdómen
Abdominoplastik	abdominoplastia
Schürfwunden, Abschürfungen	abrasões
Befund	achado
azyanotisch	acianótico
Gehirnschlagader	ACP
Herz-Lungen-Auskultation	ACP
Akromion	acrómio
Akromion	acrómio
Achromatopsie	acromatopsia
Akromioklavikular	acromioclavicular
Akromioplastik	acromioplastia
Leistung, Eingriff, Massnahme	acto
Diagnosegenauigkeit	acuidade diagnóstica
Sehschärfe	acuidade visual
Sehschärfe	acuidade visual
Zellveränderungen	adaptações celulares
Adenomegalien	adenomegalias
Adenopathie	adenopatia
Seidenpflaster	adesivo de seda
Hypafix Pflaster	adesivo Hypafix
adjuvant	adjuvante
Verabreichung von intravenösen, jodhaltigen Kontrastmitteln	administração endovenosa de contraste iodado
nationale Behörde für Gesundheitsüberwachung	agência nacional de vigilãncia sanitária
Erreger	agente
Hauthefter	agrafador de pele
Kanüle	agulha
Kanüle Biovalve	agulha biovalve
Spinocan Kanüle	agulha spinocan
steroidfreie entzündungshemmende Mittel	Aine's
Ausrichtung der Wirbelsäule	alinhamento vertebral
ALT Alanin-Aminotransferase	ALT
obere zerebrale Konvexität	alta convexidade cerebral
fokale Änderungen	alterações focais
starkes Magnetfeld	alto campo magnético
Amaurosis fugax	amaurose fugaz
intrauterine Umgebung	ambiente intrauterino
Amblyopie	ambliopia
Amygdalae	amigdalas cerebelosas
Amylase	amilase
Abtrennung	amputação
nicht sporenbildende Anaerobier	anaeróbicos não esporulados
Schmerzmittel	analgésico
Analgetika	analgésicos
Mangelanämie	anemia carencial
Spinalanästhesie	anestesia com Raqui
Aneurysma	aneurisma
sakkuläres Aneurysma	aneurisma sacular
CT-Angiographe des Thorax	Angio TC torácico
zerebrale Angiographie	angiografia cerebral
digitale Angiografie	angiografia digital
anikterisch	anictérico
Sprachschwierigkeiten	anodia
persönliche Vorerkrankungen	antecedentes pessoais
Arbeits- und Sozialanamnese	antecedentes socioprofissionais
persönliche Vorerkrankung	AP
langwirkend	ap
Kreislaufsystem	aparelho circulatório
Sehtestgerät	aparelho de rastreio visual
Verdauungsapparat	aparelho digestivo
Harn- und Geschlechtsorgane	aparelho genito-unitário
Bewegungsapparat	aparelho locomotor
Atmungsorgane	aparelho respiratório
transversale Apophysen der Lende	apófises transversas lombares
Assistenz bei der ärztlichen Behandlung	apoio ao acto médico
Zahnarzthilfe	apoio à clínica dentária
Handlungsfähigkeiten	aptidões operacionais
Sehleistung	aptidões visuais
volumetrische Erfassung	aquisição volumétrica
Arachnidismus	aracrneismo
hinterer Rippenbogen	arco posterior
Bettpfanne	arrastadeira
Hirnschlagader	artéria cerebral
hintere Gehirnschlagader	artéria cerebral posterior
Arteria communicans anterior	artéria comunicante anterior
Vertebralarterie	artéria vertrebral
Pulmonalarterien	artérias pulmonares
Artefakt	artefacto
Bewegungsartefakte	artefactos de movimento
kostovertrebales Gelenk	articulação costo-vertebral
Hüiftgelenk	articulação coxo femoral
die Einsatzbeschränkungen bestehen auf Dauer	as restrições são permanentes
Flügel de homolateralen Hüftknochens	asa do ilíaco homolateral
Flügel des Kreuzbeins	asa do sacro
Aszites	ascite
rechtsmedizinische Aspekte	aspectos médico-legais
AST  Aspartat-Aminotransferase	AST
Sprungbein	astrágalo
verteilte Aufmerksamkeit	atenção distribuida
wachsame Aufmerksamkeit	atenção vigilante
Aufnahme	atendimento
zerebrale Atrophie des Kleinhirns	atrofia difusa, cerebral e cerebelosa
Lungenauskultation	aucultação pulmunar
Hörvermögen	audição
Herzkammer	auricula
Kein gruppierter Mikrokalk vorhanden	ausência de microcalcificações em agrupamento
Herzauskultation	auscultação cardiaca
kommunaler Krankenhausträger	autarquia hospitalar
Schlaganfall	AVC
zweifach destilliertes Wasser	água bidestilada
Wasserstoffperoxid	água oxigenada
hypodense, kortiko-subkortikale Areale/Bereiche	áreas hipodensas cortico-subcorticais
Bronchotrachealbaum	árvore traqueobrônquica
G II Anker	âncora G II
Kleinhirnbrückenwinkel	ângulo ponto-cerebeloso
bedindet sich in laufender ambulanter Behandlung	é seguida em consulta
Darmbein	íleo
(angrenzende) Bauchorgane	órgãos abdominais afins
Oberarmbein/knochen	úmero
Gefässhaut, Aderhaut	úvea
Milz	baço
Milz	baço
Becken unter Belastung	bacia em carga
Brechpfanne	bacia vomito
Sehnenscheide	bainha
Prüfungsausschuss	banca examinadora
Blut-Kammerwasserschranke	barreira hemato-aquosa
Schädelbasis	base do crânio
Basophile	basofilos
Chirurgenkittel	bata cirurgica
Testbatterie zur Erfassung der feinmotorischen Fähigkeiten	bateria de performances motoras em periférico
gut differenzierbar	bem especializado
Bizeps	bicipite
Bifukaration	bifucaração
Biliburin	biliburrina
binocular	binocular
Kalziumkanalblocker	bloqueador dos canais de calcio
Düse für Spirometer	bocal para espirómetro
Krankenschwesterhaube	boina de enfermeira
Männer OP-Mütze	boina homem bloco
Untersuchungsbogen	boletim de exame
Beutel unter dem Akromion und Deltamuskel	bolsa subacrómio-deltoideia
Vacoped-Stiefel	bota imobilizadora
LSB Linksschenkelblock	BRE
Bronchiektase	bronquietasia
Herztöne	bulhas cardíacas
BUN Blut-Harnstoff-Stickstoff	BUN
Bupivacain	Bupivacaina
Foramen magnum	buraco magno
Okzipitalöffnung	buraco occipital
Foramen ovale	buraco oval
Zwischenwirbelloch	buracos de conjugação (forman intervertebral)
periartikulärer Schleimbeutel	bursa periarticular
Bursektomie	bursectomia
akromiale Bursitis	bursite acromial reaccional
MCHC	C.H.G. media (concentração de hemoglobina globular média)
Skalpellhalter	cabo de bisturi
Gehörknöchelchenkette	cadeia ossicular
Trommelfell	caixa timpánica
dystrophe Kalzifizierung	calcificação distrófica
Durchmesser des Knochenmarkbildes	calibre da imagem da medula
Feld	campo
OP-Abdecktuch mit Loch	campo com buraco
OP-Abdecktuch für Extremität	campo de extremidade
OP-Abdecktuch mit Klebestreifen	campo fita adesiva
OP-Abdecktuch für Tisch	campo mesa
kleine Inzisionsfolie	campo pequeno adesivo
Kanäle mit durchlässiger Struktur	canais de configuração permeáveis
Wirbelkanal	canal raquidiano
Halswirbelkanal	canal raquidiano
Fähigkeit der Koordination statischer Bewegungen	capacidade de cinestesia estática
Konzentrationsvermögen	capacidade de concentração
invasives duktales Karzinom	carcinoma ductal invasivo
Kardiomegalie	cardiomegalia
ischmämische Kardiopathie	cardiopatia isquemica
Koagulationskaskade	cascata da coagulação
linker Nucleus caudatus	caudado esquerdo
antrotympanische Höhlen, Höhlen des Antrium Tympanicum	cavidade antro-timpânicas
Sinushöhlen	cavidade sinusais
Trommelfellhöhle	cavidade timpânica
supratentorielle ventrikuläre Hohlräume	cavidades ventriculares supra-tentoriais
Mumps	caxumba
ansprechbar, mitwirkend und orientert in räumlich/zeitlicher Beziehung	CCO no E/T/P
Cefazolin	cefazolina
kortikale Blindheit	cegueira cortical
Epithel	celulas epiteliais
Mastoidzellen	celulas mastóideias
Zellgewebsentzündung der Augenhöhle	celulite orbitáris
Betreuungszentrum für Drogenabhängige	Centro de atendimento a toxicodependentes
Gesundheitszentrum	centro de saúde
Regionalstelle	Centro Distrital
Klinik-/Krankenhauszentrum	centro hospitalar
C-Erb 2	Cerb 2
zurückgebliebene Zervikalgie	cervicalgia residual
Zervikobrachialgie	cervico braquialgia
Beendigung der Erwerbstätigkeit	cessão do trabalho
Stationsleiter	chefe der serviço
Ischialgie	ciatalgia
dorsale Kyphose	cifose dorsal
begleitende Umstände	circunstâncias ambientais
plastische Wiederherstellungschirurgie	cirurgia plástica reparadora
vitreoretinale Chirurgie	cirurgia vitreo-retiniana
Zisterne	cisterna
Cisterna interpeduncularis	cisterna da base
interventrikuläre Kommunikation	CIV
Innere Medizin	clínica médica
Clipping	clip
Aneurysma-Clipping	clipagem de aneurisma
Natriumchlorid	cloreto sódio
Schuhüberzieher	cobre sapatos
Schulterkapsel	coifa do ombro
Haube der Drehmuskeln	coifa dos rotadores
Halskrawatte	colarinho cervical
intraparenchimatöse Ansammlung	colecções intraparenquimatosas
Probenentnahme	coleta
Blasenhals	colo da bexiga
Reizdarm	colon irritável
Halswirbelsäule	coluna cervical
in grösserem Ausmass	com maiores dimensões
Einklemmung des Nervenstranges	compromisso do conteúdo nervoso
Zusammenfassende Beurteilung	conclusão
klinische Versorgung	conduta clinica
Subacromial-Syndrom	conflito subacromial
geistige Verwirrtheit	confusão mental
postiktale Verwirrtheit	confusão pós-ictal
kogenital	congenito
Bruchheilung	consolidação
Arztkonsultation	consulta
Verbrauchsmaterial	consumíveis
Darstellung	conteúdo
Kontinuität der Haut	continuidade da pele
segmentale Kontraktilität	contractilidade segmentar
Durchflusskontrolle	controlo de debito
Quetschung	contusão
Vorderhörner (Cornu temporale)	cornos temporais
Wirbel C2	corpo C 2
Ziliarkörper	corpo ciliar
Klinisches Team	corpo clínico
Ketonoe	corpos cetonicos
Rückenwirbel	corpos vertebrais dorsais
axiales Schnittbild	corte axial
tomografische axiale Schnittbilder	cortes toográficos axiais
Kortikoidtherapie	corticoterapia
COX-2-Hemmer	COX 2
Kapsel	cp
frontotemporale Kraniotomie	craniotomia fronto-temporal
pterionale Kraniotomie	craniotomia pterional
Kreatinin	creatinina
Kreatinin	creatinina
Creatinphosphokinase	creatinofosfoquinase
Herzorhoferweiterung, vergrösserung	crescimento  atriais
Koniotomie	cricotireoidostomia
kardiorenales Syndrom	CRS
Unterschenkel	crural
Einwegunterhose	cueca descartável
grenzüberschreitende Gesundheitsversorgung	cuidados de saúdo transfronteiriços
Intensivpflege	cuidados intensivos
Intensivpflege	cuidados intensivos
ärztliche Soforthilfe	cuidados médicos urgentes
Kurs über grundlegende lebensrettende Sofortmassnahmen	curso de suporte básico de vida
lordotische Verkrümmungen der Lendenwirbelsäule	curvaturas lordóticas lombares
topisch	cutâneo
D-Dimere	D-dimeros
automatischer externer Defilibrator	DAE
ästhetischer Schaden	dano estetico
Aufnahmedatum	data de admissão
Entlassungsdatum	data de alta
Entlassdatum	data de alta
Datum der Entlassung mit anschl. Betreuung	data de alta social
aufnahmedatum	data de entrada
Störung	défice
ärztliche Erklärung/Bescheinigung	declaração médica
zervikale Funktionsstörung	deficit funcional cervical
anguläre Fehlbildung	deformidade angular
Haltungsschäden, Körperfehlhaltungen	deformidades posturais
Osteodensitometrie	densiometria ossea
Ablagerungen auf der Haptik	depósitos hápticos
topisch	dermico
Gelenkerguss	derrame articular
Verschiebung	desalinhamento
psycho-emotionale Entwicklung	desenvolvimento psicoafectivo
Lactat-Dehydrogenase	desidrogenase lactica
Verschiebung	deslizamento
Hüftkopflösung	deslizamento do núcleo da cabeça femoral
Netzhautablösung	deslocamento da retina
vorzeitige Plazentalösung	deslocamento prematuro da placenta
Blendung	deslumbramento
Screening-Befund	despiste
Schädel-Becken-Missverhältnis	desproporção céfalo pélvica
Händigkeit	destreza manual
Beeinträchtigung	desvalorização
wesentliche Verschiebung	desvio apreciável
Detailansicht des Knochens	detalhe osseo
fortschreitende Schädigung der Organsysteme	deterioração progressiva dos sistemas orgânicos
Deuteranomalie	deuteranomalia
Deuteranopie	Deuteranopia
Zwerchfell	diafragma
Diclofenac	diclofenaco
diensthabender Leiter	director de serviço
Disarthie	disartria
uterine Dyskenisie	discinesia uterina
Dyskorie	discoria
intersomatische Bandscheiben	discos intersomáticos cervicais
leichte Leucoariose	discreta leucoariose
dezente zirkumferentieller Bandscheibenüberhang	discreto bombeamento discal circunferencial
diskreter Knochenkallus	discreto calo ósseo
Unterscheidung, Aufschlüsselung	discriminação
Parachromatopsie	discromatopsia
Parachromatopsie	discromatopsia
Parachromatopsie	discromatopsia
Zerrung	distensão
chirurgische Fertigkeit	distreza cirúrgica
intra-uterines Pessar	DIU
Diabetis Mellitus	DM
nicht revaskularisierte koronare Erkrankung	doença coronária não revascularizável
Parasitenkrankheit	doença parasitária
Erkrankungen der Mediastinum	doenças mediastinais
Analerkrankungen	doenças orificiais anais
gerontopsychiatrischer Patient	doente gerontopsiquiátrico
Doppler-Ultraschall	dopplerfluxometria
invalidisierender Schmerz	dor incapacitante
Rückenschmerzen	dor lombar
diffuse Bauchschmerzen	dores abdominais difusas
Dopplersonographie	DTC
estudo histológico	E. H.
histologische Untersuchung	E. H.
EKG   =   Elektrokardiogramm	ECG  =   electrocardiograma
Ruhe-EKG	ECG (em repouso)
Echokardiogramm	ecocardiograma
transösophageale Echokardiographie	ecografia transesofágica
Ektasie	ectasia
Ödem	edema
Makulaödem	edema macular
Makulaödem	edema macular
transependymales Ödem	edema transependimário
Ejektionsfraktion  (EF)	EF   =   fracção de ejecção
Arbeiten regelmässig verrichten	efectuar trabalhos de forma regular
Ephedrin	efedrina
Carotisachse	eixo carotideo
einfaches Elektrokardiogramm, Ableitung mit 12 Kanälen	electrocardiograma simples de 12 derivações
Elektrogenese an der Kopfoberfläche	electrogenese basilar
dysrhytmische und abfallende Elektrogenese ohne Feststellung pathologischer Vorfälle	electrogenese disritmica e deprimida sem definier acidentes patológicos
selbsthaftende Einweg-EKG-Elektrode	eletrodo ECG auto-adesivo descartável
Saugelektrode	eletrodo ventosa
in Ruhe	em repouso
in langfristiger stationärer Pflege	em serviço de estadia prolongada
medizinische Notfallversorgung	emergênicas médicas
sequentielle Enzephalomalazie	encefalomalácia sequelar
ist auf Hilfe angewiesen	encontra-se dependente
Endopthalmitis	endoftalmite
Endokarditis	endomiocardiopatia
Aufprallenergie	energia de impacto
ischämischer Infarkt	enfarte isquémico
lakunärer Infarkt	enfarte lacunar
Kleinhirninfarkt	enfarte sequelar cerebeloso
Krankenpflege in der Erstversorgung	enfermagem pré-hospitalar
Notfallkrankenpfleger	enfermeiro de urgência
Rückmutationstext unter Verwendung von Bakterien	ensaio de mutação reversa bacteriana
Enterobakterien	enterobactérias
Krankheitbild	entidade morbida
offizielle Aufsichtsbehörde	entidade oficial superintendente
Halszerrung	entorse cervical
Gelenkzwischenraum am Obeschenkelknochen	entrelinhas articulares coxo-emorais
psychologisches Interview/Gespräch	entrevista psicologica
endotracheale Intubation	entubação traqueal
Objektive Untersuchung	EO
Eosinophile	eosinofilos
rekonstruierte menschliche Epidermis	epiderme humana reconstruída
Epiphysiolyse	epifisiólise
Notaufnahmebehandlung/protokoll	episódio de urgência
Episkleritis	episclerite
elektromedizinische Geräte	equipamentos electromédicos
Erythogramm	eritograma
Parietallappen	escama parietal
Abklärung	esclarecimento
chirurgische Bürste mit Chlorhexidin	escova cirurgica c/clorohexidi
Blasenschliessmuskel	esfincter urinário
akkomodative Kraft	esforço acomodativo
Ösophagopathie	esofagopatia
Esophorie	esoforia
Subakromialraum	espaço subacromial
perimedullärer Subarachnoidalraum	espaço subaracnoideu peri-medular
zisternale Bereiche	espaços cisternais
Einweg-Spekulum	espéculo descartável
energiedispersive Spektroskopie	espectroscopia com energia dispersiva
Schultergräte des Schulterblattes	espinha da omoplata
seronegative Spondylathropathie	espondiloartopatia seronegativa
autoimmune Spondyloarthropathie	espondiloartropatia auto-imune
Spondylolyse	espondilolise
Spondylolysthesis	espondilolistesis
Ernährungszustand	estado de nutrição
Allgemeinzustand	estado geral
seelische und emotionale Verfassung	estado mental e emocional
seelische und emotionale Verfassung	estado mental e emocional
vegetatives Stadium	estado vegetativo
Staphylokokken	estaflococcias
intermittierende Lichtstimulation	estimulação iluminosa intermitente
Reiz	estimulo
Einwärtsschielen	estrabismo convergente
latentes und deutlliches Schielen	estrabismos latentes e manifestos
Streptokokken	estreptococias
Dehnungsstreifen	estrias
Östrogen	estrogènio
Persönlichkeitsaufbau	estrutura de personalidade
herunterhängende Struktur	estrutura suspensa
Herklappenstruktur	estrutura valvular
Untersuchung	estudo
Profilbild	estudo de perfil
histologische Untersuchung	estudo histologico
Schilddrüsenuntersuchung	estudo tiroideu
bildgebende Verfahren	estudos imagiológicos
eupnoisch	eupneico
Krankheitsverlauf	evolução da doença
3-tägiger Verlauf	evolução de 3 dias
Krankheitsverlauf	evolução dos dados
mikroskopisch in-vivo-Untersuchung	exame a fresco
Befund	exame clinico
neurologischer Befund	exame neurologico
erwerbstätig sein	excercer uma actividade remunerada
Exophorie	exoforia
intraoperative Prüfung	exploração intra-operatória
extra-axial	extra-axial
Blutfrequenz	FA
atriale Fibrilation	FA   =    fibrilação atrial
Dorsalfläche	face dorsal
mykardisches Versagen	falência miocardica
Einweganzug	fato descartavel
hypodense Fimbrien	fímbrias hipodensas
isodense Fimbrien	fímbrias isodensas
Herzfrequenz	FC
supraspinaler Strang	feixe do supra-espinhoso
Zystische Fibrose	fibrose cística
periduktale Fibrose	fibrose periductal
Patientenblatt	ficha médica
Filiarose	filiarose
Kirschner-Draht	fio de Kirchner
Nähfaden	fio de sutura
Carotis-Sinus-cavernosus-Fistel	fistula carótida-cavernosa
Urinfluss	fluxo de urina
Muskelkraft	FM (força muscular)
Foramen occipitale	foramen occipital
Muskelkrat und Tonus	força muscular e tonus
Phorie	foria
Denkform oder Denkinhalt	forma ou conteúdo de pensamento
Bildung von Knötchen	formação nodular
Leukozytenformel	formula leucocitaria
leukozytische Formel	formula leucocitária
Knorpelpfanne	fossa glenoide
fossa posterior	fossa posterior
Avulsionsfraktur	fractura avulsão
Fraktur von zwei Knöcheln	fractura bimaleolar
Trümmerfraktur	fractura cominutiva
Radialfraktur	fractura da estiloide radial
diaphysäre Fraktur	fractura diafisária
Kalkaneusfraktur	fractura do calcâneo
längs- und transversale Fraktur	fractura longitudinal e transversa
Orbitafraktur	fractura orbitária
Knochenfragment	fragmento ósseo
Puls	frequência cardíaca
frontoinsular	fronto-insular
frontotemporal-parietal	fronto-temporo-parietal
Linksventrikuläre Funktion	função ventricular esquerda
G.G.T.	G.G.T. (gama glutamil transpeptidase/transferase)
Klassifikation Garden III	Garden III
Gastrostomie	gastostomia
perkutane Gastrostomie	gastrostomia percutânea
Sentinel-Lymphknoten, Wächterlymphknoten	gânglio sentinela
periaortale Ganglien	gânglios peri-aórticos
übertragene Schwangerschaft	gestação prolongada
Krankenpflegemanagement	gestão de cuidados de enfermagem
Einmal-Rasierklinge	gilete descartável
Glykämie	glicemia
Nüchternglukose	glucose em jejum
Ausmass und Stadium	graduação e estadiamento
pathologische Graphoelemente	grafo-elementos patológicos
ganze Extraktion	grande extracção
BGA (Blutgasanalyse)	GSA
Hämoglobin	H.B.
MCH	H.G. media (hemoglobina globular médio)
HCO3 Hydrogencarbonat	HCO3
Darm-Helminthen	helmintos intestinais
Hämaturie	hematúria
Hämatologie	hematologia
intrakranielles Hämatom	hematoma intracraniano
gewebespezifisches Hämatom	hematoma parenquimatosa
subakutes/chronisches Subduralhämatom	hematoma subdural subagudo / cronico
hemikranisch	hemicranio
Hemiparese	hemiparésia
Hirnhemisphäre	hemisfério cerebral
Hämodynamik	hemodinamica
hämodynamisch	hemodinamico
Hämogramm	hemograma
Hämomediastinum	hemomediastino
Hämoperitoneum	hemoperitoneu
Subarachnoidalblutung	hemorragia sub-aracnoideia
Glaskörperblutung	hemorragia vitria
hämorrhagisch	hemorrágico
Hämotympanon	hemotimpano
Hämotorax	hemotorax
Hepatomegalie	hepatomegalia
Heterogenität	heterogeneidade
Asteroid Hyalosis	hialosis asteróide
hydratisiert	hidratado
Hydrozephalie	hidrocefalia
Hyphaema	hifema
Hygrom	higroma
Hymenopterismus	himenopterismo
Hypercholesterinämie	hipercolesterolémia
Hyperphorie	hiperforia
interkranielle Hypertension	hipertensão endocraniana
Hypoalbuminämie	hipoalbuminémia
Hyponatriämie	hiponatrémia
hypoplastisch	hipoplásico
Hyposphagma	hiposfagma
Hormonologie	hormonologia
arterielle Hypertonie	HTA (hipertensão arterial)
Linksherzhypertrophie	HVE  =  hiptertrofia ventricular esquerda
Aorteninsuffizienz	IAo   =  insuficiência aértica
Ichthysmus	ictismo
Infraspinatus	IE
Mitralinsuffizienz	IM   =  isuficiência mitral
axiale, koronale und sagittale Aufnahmen	imagens axiais, coronais e sagitais
bildgebende Verfahren	imagiologia
Ruhigstellung	imobilização
Immunhämatologie	imuno-hematologia
Immunoglobine	imunoglobinas
Inhalationstherapie	inaloterapia
erwerbsunfähig	incapacidade para o trabalho
erwerbsunfähig	incapacidade para o trabalho
Unfähigkeit zu Kraftanstrengungen	incapacidade para os esforços
permanente/dauernde Behinderung/Erwerbsunfähigkeit	incapacidade permanente
Dauerinvalidität	incapacidade permanente
Aufnahmen aus schräg seitlicher Richtung und senkrecht von oben	incidências médio-laterais e crânio-caudais
beginnende degenerative Veränderungen	incipientes alterações degenerativas
Inkontinenz der Schliessmuskel	incontinência de esfíncteres
anorektale Inkontinenz	incontinência de esficteres
Belastungsinkontinenz	incontinência urinária de esforço
Mischinkontinenz	incontinência urinária mista
Dranginkontinenz	incontinência urinária por impulso
Überlaufinkontinenz	incontinência urinária provocada por excesso de fluxo
Stressinkontinenz	incontinência urinária provocada por stress
komplette Inkontinenz	incontinência urinária total
chirurgische Indikation	indicação cirurgica
erkennbar sein, sich abzeichnen	individualizar-se
Koordinierungsstelle für den Rettungsdienst	INEM
computergestützt	informatizado
unter- oder oberhalb des Tentoriums	infra ou supra-tentorial
kleiner als ein Zentimeter	infracentrimétrico
Instrumentenschwester/pfleger	instrumentista
Atmungsinsuffiizienz	insuficiência respiratória
Aufnahme von Informationen	integração de informação
stationärer Aufenthalt	internamento
Einweisung, Krankenhausaufenthalt, Aufnahme	internamento
Praktische Ausbildung in der Notvallversorgung	internato em emergência
Auswertung	interpretação
Intima	intima
intra- oder extraaxial	intra- ou extra-axial
endotracheale Intubation	intubação traqueal
multidimensionales Persönlichkeitsinventar	inventário multidimensional da personalidade
Krankenpflegeforschung	investigação em enfermagem
Povidon-Jod	iodopovidona
Ionogramm des Harns	ionograma urinário
Widerstandsindex	IR    =   indice de resistividade
Iridozyklitis	iridociclite
ausgebreitet/dehnt auf den Parietalknochen	irradiado ao osso parietal
Fensterausschnitt	janela
Chirurgie-Set	kit de cirurgia
Bandscheibe L4	L4
medizinische Labordiagnostik	laboratório de análises clínicas
Risswunde	laceração
Skalpell	lamina bisturi
Rasierklinge	lamina trictotomia
Probelaparotomie	laparotomia exploradora
Lamina terminalis	lámina terminalis
Skalpellklinge	lâmina de bisturi
Ihihara Tafeln	lâminas de ishiara
Krankenbett	leito
Vorderkammerlinse mit Haptik der Iris	lente de câmara anterior de suporte iridiano
explantierte Linse	lente explantada
Intraokularlinse	lente intraocular
faltbare Linsen	lentes dobráveis
fokale Läsion	lesão focal
osteoartikuläre Verletzung	lesão osteoarticular
paroxistische Läsion	lesão paroxístico
Karzinomläsionen	lesões de carcinoma
intrakranielle Verletzungen	lesões endocranianas
Mitraklklappenschaden	lesões orovalvares mitrais
Läsionen des Peritendineums	lesões peritendineas
Trikuspidalklappenschaden	lesões tricuspídes
aktue Gefässverletzungen	lesões vasculares agudas
Leukozyten	leucocitos
Leukozyten	leucocitos
Leukokorie	leucocoria
ischämische Leukenzephalopathie	leucoencefalopatia isquémica
Hochschulabschluss in Krankenpflege	licenciatura em enfermagem
Mullbinde	ligadura algodão
elastische Binde	ligadura elástica
gelbes Band	ligamento amarelo (ligamentum flovum)
leichte Verformung des angrenzenden Hirnparenchyms	ligeira moldagem do parêquima encefalico adjecente
Lymphknotenschwellung	linfadenopatia
Lymphknotenschwellung	linfadenopatia
Legen von zentralen Venenzugängen	locação de acessos venosos centrais
Unfall-/Einsatzort	local de ocorrência
zervikale Lordose	lordose cervical
LPB	LPB
Luxation	luxação
vertebrale Luxationen	luxações vertebrais
Makrophage	macrófago
Mamografie-Screening	mamografia de rastreio
Jersey-Schlauch	manga de jersey
allgemein gutes Niveau hinsichtlich Pflege und Wohlbefinden aufrecht erhalten	manter bom nivel de cuidados gerais e de conforto
Gang	marcha
Implantatmaterial	material de implante
psychologische Reife	maturidade psicológica
begleitender Arzt	médico assistente
behandelnder Arzt	médico assistente
ärztlicher Bericht angefertigt von Dr. med.	médico que efectuou o exame
Neutral-Null-Methode	medição de mobilidade articular activa
Medikation	medicação
harntreibende Medikamente	medicamentos diuréticos
präshospitale Notfallmedizin	medicina de emergência pre-hosptilar
Laboratoriumsmedizin	medicina laboratorial
Arzt, der den Bericht anfertigt	medico relator
anfordernder Arzt	medico requisitante
Häufigkeitsmass	medida de frequência
Erste-Hilfe-Massnahmen	medidas de primeiros socorros
Mark	medula
Nervenmark der peripheren Nerven	medulares dos nervos periféricos
Medulloblastom	meduloblastoma
Erinnerungsvermögen, Gedächtnis	memoria
Reha- und Physiotherapie	MFR
untere Gliedmasse	MI
Harnentleerung	micção
optische Mirkroskopie	microscópia óptica
Rasterelektronenmikroskopie	microscópia electrónica de varrimento
spektroskopische Mikoskopie	microscópia espectroscópica
Myoklonie	mioclonia
schilddrüsenbedingte Myopathie	miopatia tereoídea
Myorelaxantien	miorelaxante
Gelenkmobilisation	mobilização articular
extrinsische Verformung	moldagem etrínseca
Thekalsack wird leicht eingedrückt	moldando ligeiramente a vertente anterior do saco tecal
monokular	monocular
funktionale Anatomie	morphofisiologia
Feinmotorik	motrocidade fina
Bewegungen (Kraft und Tonus)	movimento (força muscular e tónus)
tonische Bewegungen	movimentos tónicos
obere Gliedmasse	MS
Schleimhaut	mucosa de revestimento
Schleimhäute	mucosas
bilaterales vesikuläres Atemgeräusch ohne Nebengeräusche	murmúrio vesicular mantido bilateralmente sem ruídos adventicios
Keimzellmutagenität	mutagenicidade em células germinativas
Aufnahmenummer	número de entrada
Patientennummer	número do utente
Harndrang	necessidade de urinar
Neprologie	nefrologia
neoadjuvant	neoadjuvante
gestationsbedingte trophoblastische Neoplasie	neplasia trofblástica gestacional
Radialnerv	nervo radial
ischämische Optikusneuropathie	neuropatia óptica isquêmica
Kausalzusammenhang	nexo de causalidade
intersomatische Ebenen	niveis intersomáticos
Entlassungsschein für gültig erklärt durch	nota de alta validada por
T-Werte	notas-T
fortlaufende Konsultationsnummer	NSC (número de serviço de consulta)
Ist eine Nachuntersuchung erforderlich?	o interessado deve ser examinado novamente
rechtes Auge	O. D.
linkes Auge	O. E.
Obstruktion	obstrução
okulomotorisch	oculomotora
rechtes Auge	OD
Opazifikation	opacificação
Kammer der Krankenpfleger	ordem dos enfermeiros
koronale und sagittale Ausrichtung	orientação coronal e sagital
auto- und allopsychisch orientiert	orientado auto e alopsiquicamente
Herzklappenplastik	orovalvuloplastia
Osteosynthese	osteossintese
Osteosynthese mit 5-Schrauben-Platte am äusseren Knöchel	OTS com placa de 5 parafusos no M externo
Patientenprozess Nr.	P. U.
Arteriendruck	PA
Erkennungsmuster	padrão de sinal
bilaterales Muster mit Mikroknötchen	padrão micronodular bilateral
Papillenödem	papiledema
Blicklähmung	paralisia ocular
Darmparasitose	parasitose intetestinal
Schadensparameter	parâmetro de dano
Lungenparenchym	parênquim pulmonar
Parenchym	parênquima
Gutachten beruht auf Befundberichten	parecer baseado no relatório médico
Parästhesie der Weichteile	parestesia de partes moles
Geburt bei Beckenendlage	parto pélvico
Pediculus	pedículos
Kunsthaut	pele plástica
Katheterverband	penso de cateter
perzeptiv-kognitiv	perceptivo-cognitivo
periartikulär	peri-articular
herzbeutel	pericárdio
Funktionsenschränkungen	perturbações funcionais
Funktionseinschränkungen	perturbações funcionais
psychovegetative Symptomatik	perturbações neurovegetativas
Anatomische Pinzette	pinça de dissecção
pyogen	piogenico
Placenta praevia	placenta prévia
Knochenstruktur	plano ósseo
orbitomeatale Ebene	plano orbito-meatal
Nachtschichten	plantões nocturnos
Blutplättchen	plaquetas
Thrombozyten	plaquetas
chirurgischer Nahttrainer	plataforma de cirurgia
Wirbelplatte	plataforma vertebral
Pneumomediastinum	pneumomediastino
Pneumoperitoneum	pneumoperitoneu
Pneumothorax	pneumotórax
orale Einnahme	po
er kann die folgenden Arten von Arbeiten noch regelmässig verrichten	pode efectuar de forma regular os seguintes tipos de actividade
Polyelektrolyte	polielectrolictico
aufgrund einer schnell eintretenden	por quadro de instalação súbita
Nadelhalter	porta agulha
Eintrittspforte	porta de entrada
dauerhaft arbeitsunfähig	portadora de incapacidade
Ruhezustand	posição estática
starre Haltung	posição rígida
Posologie	posologia
PQ Intervall	PQ
vor Einlieferung ins Krankenhaus	pré-hospitalar
Prednisolon	prednisolona
Beeinträchtigung der Lebensfreude	prejuizo de afirmação pessoal
sexuelle Beeinträchtigung	prejuizo sexual
ektopische Schwangerschaft	prenhez ectópica
Bauchinnendruck	pressão abdominal
selektive Belastung	pressão selectiva
Krankenpflege	prestação de cuidados de enfermagem
erste ärztliche Hilfe	primeiros socorros
Kalzifizierungsprozess	processo de calcificação
umspannender Bandscheibenprolaps	procidências discais circunferenciais
viskoelastisches Produkt	produto visco-elástico
In-Vitro Diagnostikum	produtos para diagnóstico de Uso In vitro
Gesundheitsfachkraft	profissional de saúde
Verlängerung der Seitenventrikel	prolongamento temporal dos ventrículos laterais
Propädeutik	propedeutica
Prtoanomalie	Protanomalia
Protanopie	protanopia
Proteinurie	protenúria
Protozoen	protozoarios
Protozoeninfektion im Darm	protozoose intestinal
Bandscheibenprotusion	protusão discal
Test der Arm-Hand-Motorik	prova de segurança gestual de mão-braço
Funktionsprüfungen und sonstige fachmedizinische Untersuchungen	provas funcionais e outros estudos
Verkehrspsychologie	psicologia de tráfego
palpebrale Ptosis	ptose palpebral
Handwurzel	punho
QRS-Intervall	QRS
oberer äusserer Quadrant	quadrante supero-externo
Quadranten der Mamma	quadrantes mamários
Praxispersonal	quadro clínico
vermehrter Schweissausbruch	quadro de hipersudorese
depressives Krankheitsbild	quadro depressivo
neurologisches Krankheitsbild	quadro neurológico
psychischer Gesundheitszustand	quadro psiquico
unfallbedingter Sturz durch äussere Einwirkung	queda de causa extrinsa e acidental
vorrangige Beschwerden	queixas principais
subjektive Beschwerden	queixas subjectivas
Quetiapin	quetiapina
Chetiapin	quetiapina
antimikrobielle Chemotherapeutika	quimioterápicos antimicrobianos
klinischer Ansatz, klinisches Ermessen	raciocínio clínico
Radikulopathie	radiculopatia
Interventionsradiologie	radiologia de intervenção
digitale Radiologie	radiologia digital
Nervenwurzeln	raizes nervosas
Sitzbein	ramo ísqueopúbico
Halswirbelsäule	ráquis cervical
Fremdkörperreaktion	reacção de corpo estranho
eine angepasste Arbeit verrichten	realizar um trabalho adaptado
berufliche Beeinträchtigung	rebate profissional
Östrogenrezeptor	receptor de estrogéneo
Progesteronrezeptor	receptor de progesterona
sporadische Rezidive	recidivas esporádicas
Retkosigmoiditis, Rektokolitis	rectocolite
Aufwachraum	recuperação anestésica
Abrufung aufgenommener Information	recuperação da informação adquirida
Wiedererlangung der Funktionen	recuperação funcional
Aufwacheinheit	recuperação pós-anestésica
Wiederherstellung/Verbesserung der motorischen Koordination	recuperação práxica
operative Reposition	redução cruenta
Folgeerscheingungen mindern	reduzir sequelas
gastroösophagoaler Reflux	refluxo gastro-esofageano
frontobasaler Bereich	região fronto-basal
Schläfenbereich	região parietal
parietaler Bereich	região parietal
innerer periareolärer Bereich	região periareolar interna
Schläfenbereich	região temporal
Aufzeichnung im Wachzustand	registo em vigilia
Regelmässigkeit des paravertrebralen Gewebes	regularidade dos tecidos perivertebrais
Klinikbericht	relatório clinico
Muskelrelaxantien	relaxantes musculares
Schutzunterlage	resguardo
Schutzunterlage	resgurado
Facharztausbildung	residência médica
Arzt in der Facharztausbildung, Assistenzarzt	residente médico
Harnröhrenwiderstand	resistência ao fluxo da urina através da uretra
Gefäss- und Lungenwiderstand	resistência vascular pulmonar
Kernspintomographie	resonância magnética nuclear
Reaktion von Augen,  Händen und Füssen	resposta óculo-manual-pedal
kontrollierte Reaktion der Herzkammer	resposta ventricular controlada
Magnetresonanztomographie	ressonância magnética
Einsatzbeschränkungen	restrições
Auswirkung	resultado
Hautplastik und Hauttransplantation	retalhos e enxertos
Netzhaut	retina
Retinographie	retinografia
Retraktion	retração
Nackensteife	rigidez de nuca
Rivastigmin als transdermales Pflaster	rivastigmina sistema transdérmico
Kernspintomographie	RMN
NMR	RMN
magnetische Kernresonanz	RMN
Knochen	rochedo
Temporalknochen	rochedo temporal
Zuleitungsverschluss	rolha
Ruptur des Supraspinatus	rotura do supraespinhoso
Aufwacheinheit	RPA
SR Sinusrhythmus	RS
Ruptur	ruptura
Gefäss- und Lungenwiderstand	RVP
Vollsgesundheit	saúde comunitária
Gesundheitsbehandlung der Bevölkerung	saúde comunitário
mentale Gesundheit	saúde mental
Gesundheit des Harnsystems	saúde urinária
Duralsack	saco dural
Operationssaal	sala cirúrgica
subdurales Blut	sangue subdural
O2 Sättigung	Sat02
Atemnotsyndrom (ANS)	SDR
Supraspinatus	SE
Begleitung	seguimento
Keilbeinhöhle	seio esfenoidal
Kiefernhöhle	seio maxilar
Nasennebenhöhlen	seios peri-nasais
unauffällig	sem alteração
unauffällig	sem alterações
unauffällig	sem evidência
one sonstige Befunde, die im Zusammenhang mit diesem Krankheitsbidl zu beurteilen sind.	sem outros achados valorizáveis no presente contexto clínico
hier liegt keine pathologische Diagnose/Befund vor	sem patologia diagnosticada a este nível
beschwerdefrei	sem queixas
ohne KOmplikationen	sem sinais de conflito
ohne Anzeichen einer tramatisch akuten Pathologie	sem sinais de patologia traumática aguda
deutlich symmetrisch	sensivelmente simetrico
Einteilung und Bearbeitung der Proben	separação e execução de ensaios
interatriales Septum	septo interatrial
T1 gewichtete Sequenz	sequência de ponderação T1
Folgeerscheinungen	sequelas
physische Folgen	sequelas físicas
Folgeerscheinungen	sequelas residuais
ständige stationäre Pflege	serviço de estadia permanente
bildgebende Verfahren	serviço de imagiologia
interatriales Septum	SIA
Karotissiphon	sifão carotideo
UGH-Uveitis-Glaucoma-Hyphema Syndrom	sindroma UGH-Uveite-Glaucoma-Hifema
Zervikalsyndrom	sindrome de pontada cervical
reaktiv-depressives Syndrom	sindrome depressivo reactivo
nephrotisches Syndrom	sindrome nefrótico
nephrotisches Syndrom	sindrome nefrótico
akute Symptome	sintomas agudas
verzögert auftretende Symptome	sintomas retardados
Infusionssystem	sistema administração de soro
einheitliches Gesundheitssystem	sistema único de saúde
Wiener Testsystem	sistema de testes de Viena
Stelle zur Überprüfung der Invalidität	sistema de verificação de incapacidade permanente
endokrnes System	sistema endocrino
ventrikuläres System	sistema ventricular
supratentorielles Ventrikelsystem	sistema ventricular supra-tentorial
visuelles System	sistema visual
im Rahmen der Gesundheitsüberwachung	sob regime de vigilância sanitária
er ist in der Gebrauchsfähigkeit seiner Sinnesorgane eingeschränkt	sofre de restrição na utilização dos seus órgão dos sentidos
fetale Hypoxie	sofrimento fetal
Lösung zur Mundspülung	sol. lav. boca
systolisches herzgeräusch	sopro sistolico
systolisches Herzgeräusch	sopro sistolico
Serologie	sorologia
periphere Sauerstoffsättigung	SpO2
Notfallstation	SU  =  Serviço de urgência
Subcapularissehne	subescapular
Subluxation	subluxação
Sufentanil	sufentanilo
hindeuten auf, Anzeichen für	sugestivo de
Sulcus Sinus sigmoidei	sulco do seio sigmóide
kortikale Furchen	sulcos corticais
cerebrale corticale Sulci	sulcos corticais cerebrais
bronchopulmonale Eiterungen	suporações broncopulmonares
Nebennierenrinden	supra-renais
magnetisch sichtbar	susceptibilidade magnética
Schichtnaht, Etagennaht	sutura por planos
Sutur mit Safil	SUTURA SAFIL
Stelle zur Überprüfung der Invalidität	SVIP
Selbstmordgedanken/absicht	T. S.
Blutdruck	TA
cereberales CT	TAC cerebrale
CT der Lendenwirbelsäule	TAC coluna lombar
Gipsschiene	tala gessada
Silikontamponade	tamponado com silicone
Fusswurzel(knochen)	tarsica
Servicegebühr	taxa de serviço
(Praxis)gebühr	taxa moderadora
Serumspiegel	taxa sérica
CT des Bauchraums	TC abdominal
kraniale CT	TC CE
zerebrales CT	TC cerebral
CT der Wirbelsäule	TC coluna vertrebral
CT des Becken(raums)	TC pélvico
CT des Torax	TC torácico
SHT	TCE (traumatismo cranioencefálico)
Augengewebe	tecido ocular
Weichgewebe	tecidos moles
Teleradiologie	teleradiologia
Prothrombinzeit	tempo de petrombina
in Vollzeit	tempo inteiro
Supraspinatussehne	tendão do supra-espinhoso
subskapuläre Sehne	tendão suescapular
Tendinitis	tendinite
Tendinopathie	tendinopatia
Sehnenentzündung, Tendinose	tendinose
Blutdruck (in Ruhe)	tensão arterial (em repouso)
normal weit und ausgebildet	ter amplitude e configuração normal
derzeitige Behandlung	terapêutica em curso
angepasste Behandlung/Therapie	terapeutica orientadora
Teratogenität	teratogenicidade
distales Drittel des Unterarmes	terço distal do antebraço
Ohrthermometer	termómetro auricular
Bläschentest	teste bolhas
Test der progressiven Matrizen	teste das matrizes progressivas
bimanueller Koordinationstest	teste de coordenação bimanual
Labyrinthtest	teste de labirinto
multipler und komplexer Reaktionstest	teste de reacções complexas e multiplas
einfacher Reaktions- und Wahltest	teste de reacçõs simples e de escolha
Verkehrsauffassungstest	teste de trafego de taquistoscópio
Sreening	teste de triagem
chromatischer Sehtest	teste de visão cromática
Sprunggelenk	tibia-társica
Tibia, Schienbein	tibio
Thyreoidektomie	tireóidectomia
Chirurgie in der Tokologie	tocurgia
problemlos vertragen	tolerar
axiale craniale Computertomographie	tomografia axial computorizada crânio-encefálica
Bruchfläche	topo da fractura
digitales, laterales Topogramm	topograma digital lateral
Brustkorbschmerzen	toracalgia
Thorakostomie	toracostomia
Dreiweghahn	torneira de 3 vias
maternale Toxizität	toxicidade materna
Entwicklungstoxizität	toxicidade para o desenvolvimento
Aufzeichnungslinie / -kurve	traçado
Frakturlinie	traço de fractura
negativ polarisierte Züge	traço polarizado negativamente
Arbeiten mit wechselnder Körperhaltung	trabalhos com variação de postura
Arbeiten ohne besonderen Zeitdruck	trabalhos sem imposição de prazos apertados
Quetschungen aufweisen	traduzir contusões
Bewegungsablauf	trajectoria de movimentos
Verlegung	transferência
Tracheostomie	traqueostomia
Tracheotomie	traqueostomia
Kontusion	trauma contuso
Perforation	trauma perfurante
Gehirnerschütterung	traumatismo craneano
stumpfes Abdominaltrauma	traumatismo de barriga fechada
Speiseröhrenverletzungen	traumatismo do esôfago
Brustkorbverletzung	traumatismo torácico
Triglyceride	trigliceridos
Tritanomalie	Tritanomalia
Tritanopie	tritanopia
Trophizität	troficidade
Thromboembolie	tromboembolismo
Sinusthrombose	tromboflebites do seio cavernoso
Hirnstamm	tronco cerebral
Troponin	Trop
Tumorektomie	tumorectomia
medizinische Grundversorgung	unidade básica de saúde
Heim/Station für integrierte Langzeitpflege	unidade de cuidados continuados e integrados
polyvalente Intensivstation	unidade de cuidados intensivos polivalente
Familiengesundheitszentrum	unidade de saúde familiar
örtliches Gesundheitszentrum	unidade local de saúde
Urinalyse	urinálise
Sehhilfe verwenden	uso de correcção óptica
Uveitis	Uveite
MCV	V.C. medio
Sylvische Furche (Fissura Sylvii)	vala silvica
Bestätigung	validação
Mindestnatriumwert	valor mínimo de natrémia
Testvariablen	variáveis do teste
retikuläre Krampfadern	varizes reticulares
Ultraschall-Scannbild	varrimento ecográfico
Vasospasmus	vasoespasmo
peripheres Gefässystem	vasos periféricos
verschiedene Schmerzpunkte, schmerzende Stellen	vários pontos dolorosos
Wendung	versão
Kanäle der Gehirn-Rückenmarksflüssigkeit	vias de LCR (líquido cefalorraquidiono
wach	vigil
Sehvermögen	visão
Sehvermögen	visão
Farbwahrnehmung	visão cromática
stereoskopisches Sehen	visão estereoscopica
Seitenventrikel	VL (ventrículas laterais)
enddiastolisches Blutvolumen´im Herzventrikel	volume diastlico ventricular
optischer Teil	zona óptica
Abszess	abcesso
Abdomen	abdómen
abdominal	abdominal
Abspreizen	abdução
Chromosomenaberration	aberração cromossómica
Mund; Öffnung; Eingang	abertura
Ablatio	ablação
Extinktion; Auslöschung	abolição
abtreiben; Schwangerschaft abbrechen;	abortar
Spontanfehlgeburt; Spontanabort	aborto espontâneo (AE)
Dezeleration	abrandamento
Abrasio; Abrasion	abrasão
plötzlich	abrupto
Absorption; Schlucken; Aufnahme	absorção
absorbieren; aufnehmen	absorver
abstinent	abstémio
periodische Abstinenz; Abstinenz für einen	abstinéncia periódica
Abstinenz	abstinência
Abulie	abulia
Missbrauch	abuso
Missbrauch schädlicher Stoffe	abuso de subtsâncias nocivas
Achalasie	acalásia
bettlägerig	acamado
Akanthom	acantoma
Akathisie	acatísia
beschleunigt	acelerado
Betonung; Verschärfung	acentuação
ausgeprägt	acentuado
venöser Zugang	acesso venoso
Gelenkpfanne	acetábulo
klinischer Befund	achado
azyanotisch	acianótico
azidophil	acidófilo
Berufsunfall	acidente do trabalho
anämischer / ischämischer Infarkt	acidente isquémico
transitorische ischämische Attacke (TIA)	acidente isquémico transitório (AIT)
Hirndurchblutungsstörung; Apoplexie	acidente vascular cerebral (AVC)
Apoplexia cerebri; zerebrale Durchblutungsstörung; Schlaganfall	acidente vascular cerebral (AVC)
Azidose (metabolische / respiratorische)	acidose (metabólica / respiratória)
bewegungsarm; bewegungslos; akinetisch	acinético
Akne	acne
Unterbringung; Unterkunft	acomodação
Begleitperson	acompanhante
genetische Beratung	aconselhamento genético
raten; beraten	aconselhar
aufwachen	acordado
Aufwachen (beim Aufwachen); Erwachen	acordar (ao acordar)
Höhenangst	acrofobia
Akromegalie	acromeglia
Sport; Bewegung; Leibesübungen; sportliche Betätigung	actividade física
Geschlechtsverkehr	acto sexual
aktivieren	actuar
Tinnitus (aurium); Ohrensauesn; Ohregeräusche	acufeno
Sehschärfe	acuidade visual
Akupunktur	acupunctura
anpassen; anwenden; auflegen; verabreichen	adaptar
adenoid	adenóide
Adenitis	adenite
Adenokarzinom	adenocarcinoma
Adenom(a)	adenoma
Hypophysenadenom	adenoma da hipófise
Epiphysenadenom	adenoma pituitário
angemessen; angepaßt	adequado
Synechie; Adhäsion; Verklebung	aderência
adhäsiv; adhärent	aderente
Adhäsion; Verklebung	adesão
adhärent; adhäsiv	adesivo
dem Alter angemessen	adeuqado à idade
Adiadochokinese	adiadocinésia
Abhängigkeit	adição
verabreichen	administer
orale Verabreichung; orale Administration	administração oral
Âufnahme; Einweisung	admissão
erkranken; krank werden	adoecer
Adoleszenz; Jugendzeit; Pubertät	adolescência
Jugendliche(r)	adolescente
einschlafen	adormecer
Einschlafen; Odormitio	adormecimento
erworben	adquirido
erwerben	adquirir
Adrenalin; Epinephrin	adrenalina; epinefrina
Adstringenzien	adstringente
Adduktion	adução
Erwachsen(r)	adulto
Aerosol	aerossol
Aphasie	afasia
aphonisch	afónico
negativ beeinflussen	afectar negativamente
Affektivität	afectividade
affektiv	afectivo
Affekt	afecto
zuführend; afferent	aferente
scharf; spitz	afiado
Affinität	afinidade
versichern; behaupten; sichern; gewährleisten	afirmar
Aphonie	afonia
Aphthen	afta
Substanz	agente
Agitation; Agitiertheit; Agitatio; Erregung; Ruhelosigkeit; Unruhe	agitação
agitiert	agitado
Agnosie	agnosia
Agonie	agonia
krank; übel; Übelkeit	agoniado
Agonist	agonista
Agoraphobie; Platzangst	agorafobia
Agraphie	agrafia
Agrammatismus	agramatismo
Agranulozytose	agranulocitose
Verschlechterung; Verschlimmerung	agravamento
sich verschlechtern	agravar-se
Thrombozytenaggregation	agregação plaquetária
wässerig; flüssig	aguadilho
abwarten	aguardar
akut	agudo
stützen; lagern; tragen	aguentar
Nadel	agulha
kniend	ajoelhado
Dosierung anpassen	ajuste da dose
Vergrößerung; Erweiterung	alargamento
allergisch (gegen)	alérgico (a...)
Albumin	albumina
Alkalose (metabolische / respiratorische)	alcalose (metabólica / respiratória)
Messbereich	alcança de medição
Blutalkoholkonzentration	alcoolémia
Alkoholismus; Alkoholsucht; Alkoholabhängigkeit	alcoolismo
Aldosteron	aldosterona
Mutilation; Verstümmelung	aleijão
Stillperiode	aleitamento
Allergen	alergéno
Allergie (gegen)	alergia (a...)
Alexie	alexia
Katheterisierung; Katheterismus (der Blase)	algaliação
Blasenkatheter	algália
Wattestäbchen	algodão
Ernährung	alimentação
Erleichterung	aliviar
verlängern	alongar-se
Alopecia; Alopezie; Haarausfall; Kahlheit	alopécia
hochansteckend	altamente contagioso / a
Veränderung; Wandel	alteração
Hörstörung, Hörfehler	alteração da audição
Wesensänderung; Persönlichkeitsveränderung	alteração da personalidade
Sensibilitätsstörung	alteração da sensibilidade
Sehfehler	alteração da visão
Schlafstörung	alteração do sono
verändert	alterado
(ab)wechselnd	alternado
Größe; Höhe	altura
Halluzination	alucinação
Alveolus; Alveole	alvéolo
Alveolitis	alveolite
stillen	amamentar
bitter	amargo
Amaurose; Blindheit	amaurose
Amalgam	amálgama
Tonsilla; Tonsille	amígdala
Amylase	amílase
Amblyop(s)ie; Schwachsichtigkeit; Sehschwäche	ambliopia
ambulant	ambulante
Ambulanz	ambulância
Amöbe	ameba
Amöbiasis	amebiase
Amenorrhö	amenorreia
nett	amigável
Tonsillektomie	amigdalectomia
Tonsillitis	amigdalite
Amyloid	amilóide
transiente globale Amnesie	amnésia global transitória
amnestisch	amnésico
Amniozentese	amniocentese
weich; aufweichen	amolecer
monatliche Anwendung	amplicação mensal
Amplitude	amplitude
Ampulle; Ampulla	ampola
Amputation	amputação
anaerob	anaeróbio
anaphylaktisch	anafiláctico
Analgetikum; Schmerzmittel	analgésico
Analgesie; Analgie	analgesia
Anamnese	anamnese
Anastomose	anastomose
anatomisch	anatómico
Anatomie	anatomia
Analyse	análise
Blutprobe	análise de sangue
anämisch	anémico
abnorm	anómalo
Anurie	anúria
Ankylose; Gelenksteife	ancilose
Androgen	androgénio
Androgenresistsenz	androgenicidade
Anhedonie	anedonia
lymphatischer Rachenring	anel amigdalino
Beckenring	anel da bacia
Kayser-Fleischer Ring	anel Kayser-Fleisher
Vaginalring; Verhütungsring	anel vaginal; anel contraceptivo
rund; rundlich	anelar
Anämie	anemia
Amyelhämie	anemia aplástica
Sichelzellenanämie	anemia de células falciformes
aplastische Anämie	anemia hemolítica
makrozytärre Anämie	anemia macrocítica
megaloblastische Anämie¸ Megaloblastenanämie	anemia megaloblástica
mikrozytäre Anämie	anemia microcítica
Perniziosa	anemia perniciosa
Anenze-phalie	anencefalia
Anästhetikum	anestésico
Anästhesie	anestesia
Sattelblockanästhesie, Reithosenanästhesie	anestesia em sela
Allgemeinnarkose; Vollnarkose	anestesia geral
Lokalanästhesie	anestesia local
betäuben	anestesiar
Anästhesie; Anästhesie-Abteilung	anestesiologia
Anästhesist	anestesista
Aneurysma	aneurisma
Adnexitis	anexite
Amphetamine	anfetamina
Angst	angústia
Angi(i)tis	angeíte
Angiektasie	angiectasia
Angina	angina
Angina pectoris	angina de peito
Prinzmetal-Angina	angina de Prinzmetal
Angioblastom	angioblastoma
angioneurotisches Ödem	angioedema
Angiographie	angiografia
Subtraktionsangiographie	angiografia de subtracção
Angiom(a)	angioma
kavernöses Angiom	angioma cavernoso
Angiopathia; Angiopathie; Gefäßkrankheit	angiopatia
Angor	angor
Anhidrose	anidrose
Anisozytose	anisocitose
Anisokorie	anisocoria
Anomalie; Fehlbildung	anomalia
chromosomale Anomalien	anomalia cromossómica
Uterusanomalie	anomalia uterina
anorektisch	anoréctico
Anorexia; Anorexie	anorexia
Anosmie	anosmia
Anosognosie	anosognosia
notieren; Notizen machen	anotar
anovulatorisch	anovulotário
Ankylose; Gelenksteife	anquilose
Angst	ansiedade
ängstlich	ansioso
Antagonist	antagonista
Antidot; Gegengift, Gegenmittel	antídoto
Anteversio	anteversão
Antikoagulantien; blutgerinnungshemmende Mittel	anti-coagulantes
Antihypertensivum; Antihypertonikum	anti-hipertensor
Antihistaminika	anti-histamínicos
Antiseptikum	anti-séptico
Aggregationshemmer	antiagregação
Antibiotikum	antibiótico
Antibiogramm	antibiograma
Antibiotikatherapie	antibioterapia
Anticholinergikum	anticolinérgico
Kontrazeption, Antikonzeption; Empfängnisverhütung	anticoncepção
empfängnisverhütend	anticoncepcional
Antikonvulsivum	anticonvulsivo
Antikörper	anticorpo
Antidepressivum	antidepressivo
Antiemetikum	antiemético
Antigen	antigénio
antimykotisch	antimicótico
Antiparkinsonica; Antiparkinsonika; Anti-Parkinson-Mittel	antiparkinsónico
Antipyretikum; fiebersenkend	antipirético
Antrektomie	antrectomia
Antrum	antro
vor dem Schlafengehen	ao deitar
abtasten	apalpar
Hörapparat, Hörgerät	aparelho acústico
Zahnspange	aparelho de dentes
Apathie; Teilnahmslosigkeit	apatia
apallisch	apálico
apathisch; teilnahmslos	apático
Appendix vermiformis; Caecum; Zäkum	apêndice
Apophyse	apófise
Appendikostomie	apendicectomia
Appendizitis	apendicite
pressen; drücken	apertar
Appetit	apetite
afebril; apyretisch	apirético
Aplasie	aplasia
aplastisch	aplástico
applizieren; verarbreichen	aplicar
Apnoe	apneia
Hilfe; Unterstützung	apoio
Aponeurose	aponevrose; aponeurose
Oxygen-Versorgung (des Organismus); Sauerstoff-Versorgung	aporte de oxigénio (ao organismo)
Apraxie	apraxia
Sprechapraxie	apraxia da fala
Gangapraxie	apraxia da marcha
Arachnoidea	aracnóide
Arachnoiditis; Arachnitis	aracnoidite
Rippenbogen	arco costal
Fußrücken	arco dorsal do pé
brennend	ardente
Brennen	ardor
Brennen der Augen	ardor oculares
Zahnstumpf	arnela
Kratzer	arranhão
Areflexie	arrefléxia
rund; rundlich	arrendodado
Schüttelfrost	arrepio
Arrhytmia; Arrhythmie	arritmia
Arterie	artéria
Arteriole	arteríola
arteriell	arterial
Koronararterien	arterias coronárias
Arteriopathie	arteriopatia
Arteriosklerose	arteriosclerose
Arteriitis (temporale)	arterite (temporal)
Riesenzellarteriitis	arterite de células gigantes
Gelenk; Artikulation; Articulatio	articulação
Hüftgelenk	articulação coxo-femural
Carpus; Handwurzel	articulação do punho
Grundgelenk	articulação metacarpofalângica
Sprunggelenk	articulação tibiotársica
Artikulation	articulação verbal
Arthritis; Gelenkentzündung	artrite
rheumatoide Arthritis (RA)	artrite reumatóide
Arthropathia, Arthropathie	artropatia
Arthroskopie	artroscopia
Arthrose; Arthrosis	artrose
Nasenflügel	asa do nariz
Ascaris lumbricoides	ascáride
aufsteigend	ascendente
Aszites	ascite
Asthma	asma
Bronchialasthma	asma brônquica
Asthmatiker	asmático
Einatmen (von...); Aspiration; Ansaugen; Verschlucken	aspiração (de...)
aseptisch; keimfrei; steril	asséptico
asymmetrisch; unsymmetrisch	assimétrico
Asymmetrie; Schiefe; Ungleichmäßigkeit	assimetria
unterzeichnen; unterschreiben	assinar
asymptomatisch	assintomático
pfeifen	assobiar
in Verbindung (mit...)	associado (a...)
Asthenia	astenia
Astigmatismus	astigmatismo
Astrozyt	astrócito
Astrozytom	astrocitoma
befallen	atacar
Binde; Verband	atadura
Attacke	ataque
Asthmaattacke	ataque de asma
Herzanfall	ataques cardíacos
Ataxia; Ataxie	ataxia
zerebrellare Ataxie	ataxia cerebrelar
ataktischer Gang	ataxia da marcha
Stammataxie, Rumpfataxie	ataxia do tronco
Heredoataxie	ataxia hereditária
sensorische Ataxie	ataxia sensorial
atypisch	atípico
Atelektase	atelectasia
Atherom	ateroma
Atherosklerose	aterosclerose
Todesbescheinigung	atestado de óbito
Attest	atestado médico
Athetose	atetose
Atypie	atipia
Haltung; Habitus	atitude
Atmosphäre	atmosfera relacional
Atonie	atonia
Darmatonie	atonia intestinal
Wachstumshemmung, Wachstumsverzögerung	atraso de crescimento
Atresie	atrésia
Pulmonalatresie	atrésia pulmonar
rheumatische Athritis	atrite reumatóide
Atrophie	atrofia
vaginale Atrophie; Vaginalatrophie	atrofia vaginal
Anhörung	audição
Audiogramm; Hörkurve	audiograma
vermehrt (durch...)	aumentado (por...)
Zunahme; Anstieg (von)	aumento (de...)
vermehrter Appetit; erhöhter Appetit	aumento de apetite
(Gewicht) zunehmen	aumento de peso
Fehlen (von...)	ausência (de...)
Abhören; Auskultation	auscultação
Herzauskultation; das Herz abhören	auscultação cardíaca (AC)
Lunge abhören	auscultação pulmonar (AP)
abhören	auscultar
fehlend	ausente
Autopsie; Leichenschau; Obduktion	autópsia
Selbsthilfe	auto-ajuda
Autoimmun-	autoimune
Autopsie durchführen	autopsiar
autosomal	autosómico
Hilfe; um Hilfe bitten	auxílio; pedir auxílio
Beurteilung; Einschätzung; Untersuchung	avaliação
Fortschritt	avanço
Axilla	axila
Sodbrennen	azia
Azoospermie	azoospermia
Azotämie	azotemia
Harnsäure	ácido úrico
DNS (Desoxyribonucleinsäure)	ácido desoxiribonucléico (DNA)
Folsäure	ácido fólico
Magensäure	ácido gástrico
Ribonucelinsäure (RNS)	ácido ribonucléico (RNA)
Acetylsalicylsäure	ácido salicílico
Alkohol	álcool
schmerzhaft; wund	álgico
rau	áspero
Kleinhirnbrückenwinkel	ângulo ponto cerebeloso
After; Anus	ânus
Milz; Splen; Lien	baço
Bacillus, Pl. Bacilli, Bac.	bacilo
Bakterien	bactérias
schädliche Bakterien	bactérias nocivas
Bakteriurie	bacterúria
Bakteriämie	bacteriemia
Bakteriologie	bacteriologia
Markscheide; Myelinscheide	bainha de mielina
Blutdrucksenkung	baixa tensional
senken; verringern	baixar
Flüssigkeitshaushalt	balanço hídrico
Balanitis	balanite
undeutlich reden	balbuciar
Ballismus; ballistisches Syndrom	balismo
Blutbank	banco de sangue
oligoklonale Bande	bandas oligoclonais
Sitzbadewanne; Sitzwanne; Sitzbad	banho sentado
Barbiturat; Schlafmittel	barbitúrico
Blut-Hirn-Schranke (BHS)	barreira hematoencefálica
Plazentarschranke	barreira placentar; barreira placentária
Bauch	barriga
Wade	barriga da perna
Basaliom; Basalioma; Basalzellenkrebs; Basalzellkarzinom	basalioma
Schädelbasis	base do crâneo
Bacterium; Pl. Bacteria	batéria
(Puls; Herz-) Schlag; Puls	bater
Herzschlag	batimento
Balsam	bálsamo
betäubt; betrunken; berauscht	bêbedo
Galle	bílis
Kropf; Struma	bócio
Unterlippe	beiço; lábio inferior
Nutzen (therapeutischer)	benefício (terapêutico)
benigne; gutartig	benigno
Neugeborenenabteilung	berçário
Beriberi	beribéri
Harnblase	bexiga
Reizblase	bexiga irritável
Blasenautomatie; Reflexblase	bexiga reflexa
Hautbiopsie	biópsia cutânea
Temporalisbiopsie	biópsia temporal
Bizeps	bicípite
Bifurkation	bifurcação
doppelseitig; bilateral	bilateral
biliär; biliaris	biliar
Biochemie	bioquímica
Blastom	blastoma
Blepharitis; Lidrandentzündung	blefarite
Blepharospasmus; Lidkrampf	blefarospasmo
Blisterpackung	blister
Operationssaal; Operationsraum	bloco operatório
Beta-Blocker	bloqueador-
Blockierung, Blockade; Verstopfung	bloqueio
AV-Block	bloqueiro aurículo-ventricular
Mund	boca
gähnen	bocejar
Wange	bochecha
ausspülen	bochechar
Arztbericht	boletim médico
Blase	bolha
Fruchtblase	bolsa amniótica
Perfusor	bomba de injecção
Lymphdrainage	bombagem linfática
Fleck; Pickel; Finne; Pustel, Pustula	borbulha
Buckel; Höcker	bossa
Botulismus	botulismo
Arm	braço
Bradykardie	bradicárdia
Bradykinesie	bradicinésia
bradykinetisch	bradicinético
Bronchiolitis	bronchiolite
Bronchiektasie; Bronchiektase	bronciectasia / bronquiectasia
Bronchokonstriktion	broncoconstrição
Bronchodilatator	broncodilatador
Bronchopneumonie	broncopneumonia
Bronchoskopie	broncoscopia
Bronchospasmus	broncospasmo
Bronchitis	bronquite
chronische Bronchitis	bronquite crónica
plötzlich	brusco
bukkal; buccalis	bucal
Bulbus; Knolle	bulbo
Loch; Öffnung; Eröffnung	buraco
Foramen occipitale magnum	buraco occipital
Wirbelkanal	buraco vertebral
Bursitis	bursite
Bypass	by-pass
Untersuchungstisch; Behandlungstisch	maca
aufweichen	macerar
massiv; massig	maciço
Makrophage	macrófago
makrozytär	macrocítico
makroskopisch	macroscópico
Großwuchs; Makrosomie	macrossomia
makulopapulös	maculo-papular
Magnesium (Mg)	magnésio
Höhenkoller, Höhenkrankheit; Bergkoller, Bergkollerkrankheit	mal das alturas
Unwohlsein	mal estar
Malabsorption	malabsorção
Erweichung; Malazie	malacia
Malaria	malária
Fußknöchel; Malleolus	maléolo
Schaden	malefício
Fehlbildung; Malformation	malformação
Gefäßfehlbildung	malformação vascular (MAV)
bösartig; maligne	maligno
Maltose; Malzzucker	maltase
Brust; Mamma	mama
Brustwarze; Mammilla; Mamille	mamilo
Mammographie	mamografia
manisch	Maníaco
manisch-depressiv	Maníaco-depressiva
Mandibula; Unterkiefer	mandíbula
Manie	mania
Verfolgungswahn; Verfolgungsangst	mania de perseguição
Manifestation; Erscheinungsform	manifestação
bleiben; bewahren	manter-se
Marasmus	marasmo
begrenzt; gekennzeichnet; abgegrenzt	marcado
Marker	marcador
Tumormarker	marcador tumoral
Gang; Gangart; Gehen; Gangmuster	marcha
ataktischer Gang	marcha atáxica
spastischer Gang	marcha espástica
paraparetischer Gang	marcha paraparética
Hammer	martelo
männlich	masculino
Massage	massagem
Herzmassage	massagem cardíaca
Mastalgie	mastalgia
Mastektomie; Mammaamputation; Ablatio mammae	mastectomia
Kauen	mastigação
Mastitis	mastite
Mastalgie; Mastodynie	mastodinia
(Zahn-)Füllung	material de obturação
Reife; Maturitas	maturidade
Mandibula; Unterkiefer	maxilar inferior
Oberkiefer; Maxilla	maxilar superior
Fehlernährung; Mangelernährung; Malnutrition; schlechte Ernährung	má nutrição
Macula	mácula
Hand	mão
Klauenhand; Krallenhand	mão em garra
Fallhand	mão pendente
Kassenarzt	médico da caixa
Hausarzt	médico de família
Mediziner; Arzt; Doktor	médico/a
Notarzt	médico/a de urgência
Methode; System	método
Verhütungsmethode	método anticoncepcional
Mimik	mímica
Kurzsichtigkeit; Myopie	míope
pathologisch	mórbido
Muskel	músculo
mechanisch	mecânico
Mekonium	mecónio
medial; medialis	medial
Mediastinitis	mediastinite
Mediastinum	mediastino
Messung	medição
Medizin; Medikament	medicamento
medikamentös	medicamentoso
Schulmedizin	medicina convencional
physikalische Therapie; Physiotherapie; Krankengymnastik	medicina física
Gerichtsmedizin; Rechtsmedizin	medicina forense
Naturheilkunde	medicina naturalista
Präventivmedizin	medicina preventiva
Medulla; Mark	medula
Knochenmark; Medulla	medula óssea
Rückenmark	medula espinal
Medulloblastom	meduloblastoma
Megakaryozyt; Knochenmarkriesenzelle	megacariócito
Megakolon	megacólon
Megalomanie; Größenwahn; expansiver Wahn	megalómania
Kompressionsstrumpf, Gummistrumpf	meia elástica
Hilfsmittel	meio auxiliar
Kontrastmittel	meio de contraste
Brustkorb	meio-corpo
Melancholie	melancolia
Melanin	melanina
Melanoblastom	melanoblastoma
Melanom	melanoma
Melaena	melena
Gute Besserung!	melhor; Os melhores!
besser werden; sich verbessern	melhorar-se
Verbesserung	melhoria
Gedächtnis; Erinnerung	memória
Kurzzeitgedächtnis	memória recente
Langzeitgedächtnis	memória remota
Membran; Membrana	membrana
Extremität; Glied	membro
Menarche	menarca
Meninx; Hirnhaut	meninge
Meningiom; Meningioma; Meningeom	meningioma
Meningitis; Hirnhautentzündung	meningite
Meningokokkenmeningitis	meningite meningocócia
Pneumokokkenmeningitis	meningite pneumocócia
Meningoenzephalitis	meningoencefalite
Kindheit; Säuglingsalter, Kleinkindalter	meninice
Meniscus; Meniskus	menisco
Menopause	menopausa
Menstruation; Periode	menstruação
mental; mentalis; geistig	mental
Kinn	mento
Bernhardt Syndrom; Meralgia paresthetica	meralgia parestética
Quecksilber; Hydrargyrum (Hg)	mercúrio
Mesenchym; Mesenchyma	mesênquima
Mesencephalon	mesencéfalo
Mesenterium	mesentério
Mesometrium	mesométrio
Mesothel	mesotélio
metabolisch	metabólico
Metabolismus; Stoffwechsel	metabolismo
Metacarpus; Mittelhand	metacarpo
metastatisch	metastático
Metastasierung; Metastase	metastização
Metatarsalgie	metatarsalgia
Metatarsus	metatarso
Metaphyse, Metaphysis	metáfise
Metastase; Metastasierung	metástase
Hämiglobin; Ferrihämoglobin	metemoglobina
Mesencephalon	metencéfalo
Meteorismus	meteorismo
Metralgie	metrodinia
Metrorrhagie	metrorragia
Myalgie; Myodynie	mialgia
Myasthenie; Myasthenia; Muskelschwäche	miastenia
Mioticum, Miotikum	miótico
Blasenentleerung; Harnausscheidung, Harnabgang; Miktion; Wasserlassen	micção
mykotisch	micótico
Myzetom	micetoma
Mykose; Mycosis; Pilzinfektion	micose
mikrozytär	microcítico
Mikrozephalie	microcefalia
Mikroorganismus	microorganismo
Mikroskop	microscópio
Mydriasis	midríase
Myelin	mielina
zentrale pontine Myelinolyse	mielinólise centro-pôntica
Myelitis; Rückenmarkentzündung; Medullitis	mielite
Myelozele	mielocele
Myelofibrose; Knochenmarkfibrose	mielofibrose
Myelographie; Medullographie	mielografia
Myelogramm	mielograma
Myelom	mieloma
Myelomeningozele	mielomeningocelo
Migräne	migraine
Myokardiopathie	miocardiopatia
Myokarditis; Herzmuskelentzündung	miocardite
Myokard	miocárdio
Myoclonia; Myoklonie	mioclonia
Myoklonus	mioclono
myogen	miogéneo
Myoglobinurie	mioglobinúria
Myom; Myoma	mioma
Myopathia, Myopathie; Muskelerkrankung	miopatia
Myopie; Kurzsichtigkeit	miopia
Miosis; Stenokorie	miose
Myositis; Muskelentzündung	miosite
Myotonia, Myotonie	miotonia
Myringitis; Trommelfellentzündung; Tympanitis	miringite
mitigiert	mitigar
Mitose	mitose
Myxödem, Myxoedema	mixedema
Myxom; Myxoma	mixoma
Flexibilität; Flexibilitas; Beweglichkeit; Mobilität	mobilidade
aktive Beweglichkeit	mobilidade activa
passive Beweglichkeit	mobilidade passiva
Einsetzen der Symptome	modo de instalação
Zahn; Molar; molar	molar
Gipsschiene	molde de gesso
weich; soft	mole
Makrophage; Monozyt	monócito
Kohlenmonoxid	monóxido de carbono
mongoloid	mongolóide
kontrollieren; überwachen	monitorizar
Pfeiffer`s Drüsenfieber;	mononucleose infecciosa
Monoparese, Monoparalyse	monoparésia
Morbidität; Erkrankungshäufigkeit	morbilidade
morbilliform; masernähnlich	morbiliforme
Biß	mordedura
Zungenbiß	mordedura da língua
Schlangenbiß	mordedura de serpente
beißen	morder
morphologisch	morfológico
Morphologie	morfologia
moribund	moribundo
lauwarm	morno
Mortalität; Sterblichkeit	mortalidade
Kindersterblichkeit, Säuglingssterblichkeit	mortalidade infantil
perinatale Mortalität	mortalidade perinatal
früher Tod; frühzeitiger Tod	morte prematura
verstorben; tot	morto
Beweglichkeit; Motilität	motilidade
Grund (für)	motivo (de)
motor; motorisch	motor
Bewegung	movimento
unfreiwillige Bewegung	movimento involuntário
Schleim; Mucus; Phlegma	muco
Mukozele; Schleimzyste	mucocele
Mukosa; Schleimhaut	mucosa
Mucoviscidosis; Mukoviszidose	mucoviscidose
stumm	mudo
Krücke	muleta
Mehrgebärende; Multipara	multípara
multifokal	multifocal
Vesikuläratmen; Bläschenatmen	mumúrio vesicular (MV)
muskulär	musculado
muskulär; fleischig	muscular
Muskulatur	musculatura
Mutation	mutação
Mutilation	mutilação
Selbstverstümmelung	mutilação voluntária
Mutismus; Stummheit	mutismo
MRT = Magnetresonanztomographie	RMN = Espectroscopia de Ressonância Magnética Nuclear
(Chlor)Methylisothiazolon	(cloro)metilisotiazolinona
1,2-Benzisothiazolin-3-on	1,2- benzotiazolin-3-ona
1,3-Diphenylguanidin	1,3-difenilguanidina
1,4-Butandioldiglycidylether	1,4-butanodioldiglicidil éter
1-(3-Chlorallyl)-3,5,7-triaza-1-azoniaadamantanchlorid	cloreto de 1-(3-cloroalil)-3,5,7-triazo-1-azoniadamantano
2-Ethylhexyl-4- methoxycinnamat	4-metoxicinamato de 2-etilhexilo
2-Ethylhexyl-4-dimethyl- aminobenzoat	4-dimetil-aminobenzoato de 2-etilhexilo
3-Aminophenol	3-aminofenol
4,4´-Diaminodiphenylmethan	4,4'-diaminodifenilmetano
4,4-Dihydroxybiphenyl	4,4-dihidroxibifenil
4-Aminoazobenzol	4-aminoazobenzeno
4-Aminobenzoesäure	ácido 4-aminobenzóico
4-tert.-Butyl-4-methoxydibenzoylmethan	4-ter-butil-4-metoxidibenzoilmetano
4-tert.-Butylcatechin	4-ter-butilcatecol
4-tert.-Butylphenol	4-ter-Butilfenol
4-tert.-Butylphenol-Formaldehydharz	resina de formaldeído e 4-ter-butilfenol
4-Toluylendiamin	4-toluenodiamina
5-Brom-4-chlorsalicylanilid	5-bromo-4-cloro-salicilanilida
7-Ethylbicyclooxazolidin	7-etilbiciclo-oxazolidina
Abietinsäure	ácido abiético
Acid Yellow 36	ácido amarelo 36
adeps lanae	lanolina
alpha-Amylzimtaldehyd	aldeído alfa-amilcinâmico
alpha-Hexylzimtaldehyd	aldeído alfa-hexilcinâmico
amalgam	amálgama
AmalgamLegierungsmetalle	liga metálica da amálgama
Amcinonid	amcinonida
Ammoniumpersulfat	persulfato de amónio
Ammoniumtetrachloroplatinat	tetracloroplatinato de amónio
Amylzimtalkohol	álcool amilcinâmico
Anisylalkohol	álcool anísico
Art und Inhalt des Behältnisses	Natureza e conteúdo do recipiente
Arzneimittel	medicamento
Arzneimittel für Kinder unzugänglich aufbewahren!	Manter os medicamentos fora do alcance das crianças!
Atropinsulfat	sulfato de atropina
Bacitracin	bacitracina
Baummoos	musgo de árvore
Benzaldehyd	benzaldeído
Benzalkoniumchlorid	cloreto de benzalcónio
Benzisothiazolin-3-on	benzotiazolin-3-ona
Benzocain	benzocaína
Benzophenon-4	benzofenona-4
Benzotriazol	benzotriazol
Benzoylperoxid	peróxido de benzoíla
Benzylalkohol	álcool benzílico
Benzylbenzoat	benzoato de benzilo
Benzylcinnamat	cinamato de benzilo
Benzylhemiformal	benzil-hemiformal
Benzylsalicylat	salicilato de benzilo
Besondere Vorsichtsmaßnahmen für die Aufbewahrung	Precauções especiais de conservação
Besondere Vorsichtsmaßnahmen für die Beseitigung	Precauções especiais de eliminação
Betamethason-17-valerat	betametasona-17-valerato
Bezeichnung	designação
BIS-GMA	Bis-GMA
Bismark Brown R	Bismark Brown R
Bithionol	bitionol
Bronopol	bronopol
Budesonid	budesonido
Bufexamac	bufexamac
Butyl-4-hydroxybenzoat	4-hidroxibenzoato de butilo
Butylglycidylether	éter butil glicidílico
Butylhydroxyanisol	butil-hidroxianisol
Butylhydroxytoluol	butilhidroxitolueno
Butylhydroxytoluol	butilhidroxitolueno
Cetalkoniumchlorid	cloreto de cetalconio
Cetylpyridiniumchlorid	cloreto de cetilpiridínio
Cetylstearylalkohol	álcool cetilestearílico
Chinidinsulfat	sulfato de quinidina
Chloracetamid	cloroacetamida
Chloramphenicol	cloranfenicol
Chlorcresol	clorocresol
Chlorhexidindigluconat	digluconato de clorexidina
Chlorquinaldol	cloroquinaldol
Chlorxylenol	cloroxilenol
Cinchocainhydrochlorid	cloridrato de cinchocaína
Citral	citral
Citronellol	citronelol
Clioquinol	clioquinol
Clobetasol-17-propionat	17-propionato de clobetasol
Clotrimazol	clotrimazol
Cocamidopropylbetain	cocamidopropilbetaína
Cresylglycidylether	cresilglicidil éter
Cumarin	cumarina
Cyclohexylthiophthalimid	ciclohexiltioftalimida
Dauer der Haltbarkeit	Prazo de validade
Dünnflüssiges Paraffin	parafina líquida
Dexpanthenol	dexpantenol
Di-2-Ethylhexylphthalat	di-2-etil-hexil-ftalato
Diazolidinylharnstoff	diazolidinil ureia
Dibenzothiazyldisulfid	dibenzotiazol dissulfito
Dibromdicyanobutan	dibromo dicianobutano
Dibutylphthalat	ftalato de dibutilo
Dibutylthioharnstoff	dibutiltioureia
Dichlorophen	diclorofenol
Diethanolamin	dietanolamina
Diglycolamin	diglicolamina
Dimethylphthalat	ftalato de dimetilo
Dinatriumsalz	sal dissódico
Dipentamethylenthiuramdisulfid	dissulfureto de dipentametilenetiurama
Dipenten	dipenteno
Diphenylthioharnstoff	difeniltioureia
Dipropylenglycol	dipropilenoglicol
Dispersionsblau	azul disperso
Dispersionsgelb	amarelo disperso
Dispersionsorange	laranja disperso
Dispersionsrot	vermelho disperso
Diurethandimethacrylat	diuretano dimetacrilato
dl-Limonen	dl-limoneno
Dodecylgallat	galato de dodecilo
Duftstoff-Mix	mistura de perfumes
Edetinsäure	ácido edético
Edetinsäure Dinatriumsalz	ácido edético sal dissódico
Eichenmoos	musgo de pinheiro
enthalten im	existente em
Epicutantest-Hermal	Epicutantest-Hermal
Epoxidharz	resina epóxida
Erythromycin	eritromicina
Ethanol	etanol
Ethylbicyclooxazolidin	etilbiciclo-oxazolidina
Ethylendiamindihydrochlorid	dihidrocloreto de etilenodiamina
Ethylenglycoldimethacrylat	dimetacrilato de etilenoglicol
Eugenol	eugenol
Fachinformation	informação técnica
Farnesol	farnesol
Formaldehydharz	resina de formaldeído
Gamma-Methylionon	metil ionona gama
Gebrauchsinformation	informações de utilização
Geraniol	geraniol
gereinigtes Wasser	água purificada
Glutaraldehyd	glutaraldeído
Glycerylmonothioglycolat	gliceril monotioglicolato
Hartparaffin	parafina dura
Hexylresorcin	hexilresorcinol
Hydantoin	hidantoína
Hydrochlorid	cloridrato
Hydroxycitronellal	hidroxicitronelal
Hydroxymethylpentylcyclohexencarboxaldehyd	hidroximetilpentil-ciclo-hexeno-carboxaldeído
Iodpropinylbutylcarbamat	Iodopropinil butilcarbamato
Isoeugenol	isoeugenol
Isomerengemisch	mistura de isómeros
Isopropylmyristat	isopropil miristato
Kokosnußdiethanolamid	dietanolamida de coco
Kolophonium	colofónia
Lösungen	soluções
Lemongrasöl	essência de capim-limão
Lilial	lilial
Limonen	limoneno
Linalool	linalol
Mercapto-Mix	mistura mercapto
Methylheptincarbonat	carbonato de metil-heptino
Methylmethacrylat	metacrilato de metilo
Monobenzon	monobenzona
Monoethanolamin	monoetanolamina
N,N-Dimethyl-4-toluidin	N,N-dimetil-4-toluidino
N-Cyclohexylbenzothiazyl- sulfenamid	N-Ciclohexil-benzotiazol-sulfonamida
Natriumbenzoat	benzoato de sódio
Natriumsalz	sal de sódio
N-Diphenyl-4-phenylendiamin	N-difenil-4-fenilenodiamina
Nicht zutreffend	não aplicável
Octylgallat	galato de octilo
Octylisothiazolinon	octilisotiazolinona
Octylisothiazolon	octilisotiazolinona
Orangenöl	essência de laranja
Paraben Mix	mistura de parabenos
Pfefferminzöl	essência de hortelã-pimenta
Phenoxyethanol	fenoxietanol
phenylendiamin	fenilenodiamina
Phenylephrin	fenilefrina
Phenylephrin-Hydrochlorid	cloridrato de fenilefrina
Pomeranzenblütenöl	essência de flor de laranjeira
Primin	primina
Propylenglycol	propilenglicol
Pyrogallol	pirogalhol
Salben	pomadas
Salicylaldehyd	salicilaldeído
Sorbinsäure	ácido sórbico
Sorbitansesquioleat	sesquioleato de sorbitano
Sulisobenzon	sulisobenzona
tert.-Butylhydrochinon	terc-butil-hidroquinona
Testspritze	seringas de teste
Toluolsulfonamid	toluenosulfonamida
Triamcinolonacetonid	acetonido de triancinolona
Triclosan	triclosano
Tricresylphosphat	tricresilfosfato
Triethylenglycol-dimethacrylat	dimetacrilato de etilenoglicol
Triethylentetramin	trietilenotetramina
Trolamin	trolamina
Wasser	água
Wollwachsalkohole	alcoóis de lã
Zimtaldehyd	aldeído cinâmico
Zimtalkohol	álcool cinâmico
Zink-dibenzyldithiocarbamat	dibenzil ditiocarbamato de zinco
Zitronenöl	essência de limão
Zul.Nr.	N.º de homologação
Zulassungsinhaber	detentor da homologação
atriale Fibrillation	Fibrilação atrial
Pedikelschraube	Parafuso pedicular
Plasmaspiegeln	Nível/Volume plasmático
prandiale Insulinsubstitution	Substituição de Insulina prandial
Restriktionsenzymschnittstellen	locais/pontos (específicos) de corte de enzimas ou endonucleases de restrição
Rheumatischer Formenkreis	artrite reumatóide
Röderschlinge	Nó de Röder
Schmelzperlen	Pérolas de esmalte (Enameloma)
serologie	Serologia
serologie	Serologia
Steildrehung der linken Tube Hämoperitoneum	Torção abrupta da trompa esquerda no hemoperitoneu
stimulationsbedingtem Sprachausfall	Perda vocal condicionada por estimulação
Stressinkontinenz	Incontinência urinaria de/devido ao/provocada por stress
Titer	Titulante
titrierte Prickteste	Teste prick titulado
titrierte Prickteste	Teste prick titulado
trecho *leicht von mesial und sehr steil von oben*	A radiografia mostra uma projecção errada, em que se pode ver que o feixe central, incídiu sobre os molares levemente pela medi
Trend	Tendências
unter Verwendung von 125J-Antihuman-IgE	...sob utilização do Anticorpo IgE marcado com Iodo 125 e extracto de maçã e pólen de bétula (ou vidoeiro) ligados em discos de
Verum	Substância quimica autêntica
Vorschrift des IgE-RIA	Procedimento a seguir para a IgE (RIA)
zuzuordnendes pathophysiologisches Korrelat	Embora não exista uma correlação patofisiológica associada a um primeiro estádio (ou estádio primário) desta redução de oligoele
