3-fach ACVB	BAC con innesto venoso
Abdomen	addome
Abdomensonographie	sonografia addominale
abgesetzen	svezzare
AC-Gelenkarthrose	articolazione acromioclavicolare
Adenokarzinom	adenocarcinoma
After	ano
allgemeinchirurgische Abteilung	reparto di chirurgia generale
Analoperation	operazione rettale
Anamnese	anamnesi
Ansatz	inserto
Anteil (schizoider Anteil)	tratto (tratto schizoide)
Antiklumpmittel	agente antiagglomerante
Aortenaneurysma	aneurisma aortico
apikal	apicale
Aplasie	aplasia
arterielle Hypertonie	ipertonia arteriosa
Arzt	medico
Arzt in Fachausbildung	medico specializzando
Attest	certificato medico
Aufbrauch	usura
Augenklima	ambiente oculare
Auskultation	auscultazione
Auswurf	espettorazione/sputo
AZ-Minderung	peggioramento/scadimento delle condizioni generali di salute
ärztlicher Entlassungsbericht	relazione medica di dimissione
Ösophago-Gastro-Duodenoskopie	esofago-gastro-duodenoscopia (EGDS)
Ösophagus	esofago
bakteriell replizierbares Konstrukt	costrutto replicabile in batteri
bakterielle Restsequenzen	sequenze batteriche residue
Bandscheibe	disco intervertebrale
Bandscheibenprolaps	prolasso discale
Bandscheibenprotunsion	protunsione discale
Bauchnabel	ombelico
Beckeneingangskippung nach ventral-cranial	inclinazione in senso ventro-craniale dello stretto pelvico superiore
Beckengeradstand	assenza di obliquità pelvica
Befall	interessamento
Begleitvaskulitis	vasculite concomitante
Behandler	terapeuta
Behandlungsprotokoll	protocollo terapeutico
Beschwerdebild	sintomatologia/quadro sintomatologico
Biokompatibilitätsprüfung	verifica di biocompatibilità
Blase	vescica
Blasen-und Mastdarmlähmung	paralisi retto-vescicale
Blockwirbelbildung	blocco vertebrale
Blutdruck	pressione sanguigna/tensione arteriosa
Blutdruckerhöhung	aumento della pressione sanguigna
Bluthochdruck	ipertensione arteriosa
Blutzucker	glicemia
Blutzuckerstoffwechsel	metabolismo glicemico
Bronchialsystem	sistema bronchiale
Bronchoskopie	broncoscopia
Brustbein	sterno
Brustkorb	cassa toracica
Brustwirbelkörper-Fraktur/BWK-Fraktur	frattura del canale vertebrale toracico
Brustwirbelsäule	parete toracica della colonna vertebrale
Chemoterapie	chemioterapia
chronisces lumbo-spondylogenes Syndrom	sindrome lombo-spondilogena cronica
chronische obstruktive Atemwegserkrankung	ostruzione respiratoria cronica
chronische venöse Insuffizienz	insufficienza venosa cronica
chronisches cervicospondylogenes Syndrom	sindrome cervicale spondilogena cronica
chronisches Dekubitalulcus	ulcera da decubito di tipo cronico
Coecumregion	regione dell'intestino cieco
Colonschleimhaut	mucosa colonica
Coloskopie	colonscopia
coronal	coronale
CT-Untersuchung	esame radiografico/radiografia
CTS-OP (Operation)	intervento del tunnel carpale/liberazione del tunnel carpale
CUP-Syndrom	sintomi/sindrome da neoplasia occulta
Darm	intestino
Darmverschluss	blocco intestinale
Dentin	dentina
Desinfektion	disinfezione
Desinfektionsmittel	disinfettante
desquamatives Erythem	eritema desquamativo
DH Sitzung	seduta di igiene orale
diabetische Nephropathie	nefropatia diabetica
diabetische Polyneuropathie	neuropatia diabetica
Diagnose	diagnosi
Diastole	diastole
digital-rektale Untersuchung	esame digito-rettale
Diodenlaser	laser diodico
DNA-Fragmente	frammenti di DNA
DNA-Polymerase der Bakteriophagen	DNA polimerasi dei batteriofagi
Doppelstrang	doppio filamento
doppelsträngiges DNA-Molekül	molecola di DNA lineare a doppia elica
Drüsenzelle	cellula ghiandolare
Ductus Wirsunglanus	dotto pancreatico (di Wirsung)
Duralsack	sacco durale
Ekzem	eczema
elektro-chirurgisch	elettrochirurgico
elektro-chirurgischen Geräten	apparecchi elettrochirurgici
Endodontologie	endodontologia
endoskopische retrograde Cholangio-Pankreaticographie (ERCP)	colangiopancreatografia retrograda endoscopica
Entzündungshemmer	antinfiammatorio
Enzaphalomyelitis Disseminata (ED)	sclerosi multipla
Erkennungssequenz	sequenza di riconoscimento
Ernährungs- und Bewegungsverhalten	comportamento nutrizionale e motorio
Facettenarthrose	artrosi delle faccette articolari
Farbdopplerechokardiographie	ecocardiografia doppler a colori
Fersensporn	sperone calcaneare
Fibromyalgiesyndrom	sindrome fibromialgica
Fingerbodenabstand	distanza dita-suolo
Fistelgang	tragitto fistoloso
Fistelgangepithel	epitelio del tragitto fistoloso
Fußfehlform	malformazione del piede
Funktionsdefizit	deficit funzionale
gastrale Metaplasie	metaplasia gastrica
Gedanken (von Kraftlosigkeit)	sensazione (di debolezza)
Gefäßbereich	regione glutea
Gefühlsstörung	turba emozionale/emotiva
Gelenkschmerz	artralgia
gemischte Bindegewebserkrankung	malattia mista al tessuto connettivo
generalisiertes weichteilrheumatisches Syndrom	sindrome reumatica generalizzata dei tessuti molli
genetische Vakzinierung	vaccinazione genetica
Gentherapie	terapia genica
Gewebe	tessuto
Gingivektomie	gengivectomia
Gonarthritis	gonartrite
Haaransatz	attaccatura dei capelli
Harnverhaltung	ritenzione urinaria
Hausarzt	medico condotto
Hämoglobin	emoglobina
Hämorragie/Blutung	emorragia
Hämorrhoiden	emorroidi
Hüftverschleiß	coxartrosi
Hepatitis	epatite
Hernie	ernia
Herzinfarkt	infarto cardiaco
Herztöne	toni cardiaci
Hinterhauptbein	osso occipitale
Hinterwandmyocardinfarkt	infarto miocardico della parete posteriore
Histologie	istologia
Husten	tosse
HWS (Halswirbelsäule)	colonna vertebrale cervicale
HWS-Syndrom	sindrome cervicale
hydrolysierte Nukleotide	nucleotidi idrolizzati
Hyperlipidämie	iperlipidemia
IDP negativ	assenza di protrusione del disco intervertebrale
Iliosakralgelenke (ISG)	articolazioni sacroiliache
Implantatfreilegung	scopertura dell'impianto
Induktionschemoterapie	chemioterapia d'induzione
Infrarot- und UV-Licht	luce infrarossi e UV
Intensivabteilung	reparto di terapia intensiva
intravaskulare Farbstoffe	coloranti antivascolari
intravaskulär	intravascolare
Isopropylalkohol	alcol isopropile
Karyotyp	cariotipo
Kehlkopfresektion	laringectomia
Kleinhirninfarkt	infarto cerebellare
klinische Vergleichstests	testi clinici comparativi
Kniegelenk	articolazione del ginocchio
Knieverschleiß	gonartrosi
Kontrastmittel	mezzo di contrasto
koronare Herzkrankheit (KHK)	cardiopatia coronarica
koronares Stenting	stenting coronarico
Krampfader	vena varicosa
Krankheitsbild	quadro clinico
kreislaufstabiler Zustand	condizione circolatoria stabile
Langzeitüberwachung	controllo prolungato
Latexprotein	proteina di lattice
Leberblindpunktion	biopsia epatica eseguita alla cieca
Leberparenchym	parencima polmonare
Lebertransplantation	trapianto di fegato
Lendenwirbel	vertebra lombare
Lendenwirbelkörper (LWK )	corpo vertebrale lombare
Lendenwirbelsäule	colonna lombare
Lendenwirbelsyndrom	sindrome lombare
Leukozyt	leucocite
Ligase	ligasi
Lippenhalter	divaricatore per labbra
Liquoruntersuchung	analisi del liquor
Luftnot/Dyspnoe	dispnea
lumbale Wirbelsäule (LWS)	colonna (vertebrale) lombare
Lumboischialgie	lombosciatalgia
lumbospondylogenes Schmerzsyndrom	sidrome algica da spondilosi lombare
lumbovertebrales Schmerzsyndrom	sindrome lombovertebrale
LWS (Lumbarwirbelsäule)	colonna vertebrale lombare
LWS-Syndrom	sindrome lombare
Lymphknoten	linfonodo
Lymphknotendissektion	dissezione linfonodale
Lymphknotenextipation	asportazione linfonodale
Lymphknotenmetastasierung	metastasi linfonodale
Lymphknotenpaket	pacchetto linfonodale
Magenunverträglichkeit	intolleranza gastrica
mediastinaler Lymphknoten	linfonodo mediastinale
medizinische Method	metodo medico
medizinische Praxis	pratica medica
Melanin-Produktions-Prozess	ciclo di melanogenesi
Meningiomoperation	rimozione chirurgica/asportazione/exeresi di meningioma
Metastasierung	metastasi
molekulare Medizin	medicina molecolare
myeloische Leukämie	leucemia mieloide
Myocardinfarkt	infarto miocardico
Myokardinfarkt	infarto miocardico
Nabelbruch	ernia ombelicale
Nasenscheidewand	setto nasale
Nasenwurzel	radice del naso
Nash-Moe-Rotation	indice di Nash e Moe
nüchtern	a digiuno
Nebengeräusch	rumore concomitante
Nebenwirkung	controindicazione
Neiddruck	pressione da invidia
Nephrektomie	nefrectomia
Nervenarzt	neurologo
Niere	rene
Normalstation	reparto di degenza ordinaria
NPL	neoplasia
Nukleus Pulposus Hernie	ernia del disco intervertebrale
Oberbauchbeschwerden	disturbi alla parte superiore del ventre
Oberlappen	lobo superiore (del polmone)
Oberlappenektomie	ectomia al lobo superiore del polmone
Ohrläppchen	lobo dell'orecchio
Oligodesoxynukleotide	oligodesossinucleotidi
Omarthrose	omoartrosi
Operationsnarbe	cicatrice da operazione
Pankreasregion	regione pancreatica
Pankreatitis	pancreatite
Parodontologie	parodontologia
Patient	paziente
PE (Probe Exzinsion)	prelievo bioptico
PE obere Carina rechts	lobectomia della carena superiore destra
Perikarderguß	versamento pericardico
Perikardkarzinose	carcinosi pericardica
Perkutane Transluminale Coronare Angioplastie (PTCA)	angioplastica coronarica transluminale percutania
Pflaster	cerotto
photopolymerisierendes Wachs	cera fotopolimerizzante
Plasmid	plasmide
Polymerase-Kettenreaktion	reazione a catena della polimerasi
posttraumatisches CTS	sindrome del tunnel carpale post-traumatico
Prädilektionsstelle	sede/sito di predilezione
Prävention von Erkrankungen	prevenzione delle patologie
Primärtumor	tumore primario
Primärverdauung	digestione primaria
Prostata	prostata
pulmonale Aspergillose	aspergillosi polmonare
Pumpdruck	pressione
punkturieren	siringare
qualitative Einschränkungen des Leistungsvermögens (LV)	restrizioni/limitazioni/riduzioni qualitative della capacità produttiva
Querschnittssyndrom	sindrome amiparaplegica
Radiochemotherapie	radiochemiotrapia
Raynaud-Symptomatik	sintomatologia di tipo di Rynaud
Rückenleiden	affezione dorsale
Rückenmark	midollo spinale
Rückenschmerzen	disturbi dorsali
rechter Trochanter	trocantere maggiore
Reiz	stimolo
reizabschirmendes Medikament	farmaco che riduce l'impatto della stimolazione esterna
Restriktionsenzym	enzima di restrizione
Retinablutung	sanguinamento retinico
Rohgemisch aus DNA-Molekülen	miscela intermedia di molecole di DNA
rundherdartige Verdichtungen	addensamenti (parenchimali) a focolaio
Sauerstoffsättigung	saturazione di ossigeno
Schambein	osso pubico
Schädelbasis	base cranica
Schlafapnoesyndrom	sindrome da apnea del sonno
Schlüsselbein	clavicola
Schleimhaut	mucosa
Schleimhauterythem	eritema mucoso
Schmerzstörung	disturbo somatoforme
Schneiddruck	compulsione ad infliggersi tagli/automutilazione
Schraubenosteosynthese	osteosintesi con vite
Schulter-Arm-Syndrom	sindrome spalla-braccio
Schulterteilsteife	periartrite omero-scapolare
Schwellung	gonfiore
Schwerpunktklinikum	clinica specialistica
Sekundärverdauung	digestione secondaria
Sinninhalten	contenuti semantici
Sjögren-Syndrom	sindrome di Sjögren
Spannungsabfuhr	scarico di tensione
spastische Querschnittlähmung	paraplegia spastica
Specillum / Sonde	specillo / sonda
Spinalkanalstenose	stenosi canalare spinale
Spondylosisthese	spondilosistesi
stationär	ospedaliero, in ospedale
stationäre Behandlung	regime di ricovero
stenosierend	stenosante
Stoffwechsel	metabolismo
Strahlbeinlähme	navicolite
Systole	sistole
Taschengewebe	tasca parodontale
Terminatorsequenz	terminatore di sequenza
Therapie	trattamento
Thorax	torace
Thrombozytopenie	trombocitopenia
Thymusdrüse	timo
tierisches Hämoglobin	emoglobina animale
Trapeziusränder	margini del muscolo trapezio
Trennmittel	agente distaccante
Triggerpunkt	punti dinnesco
UK Front (Unterkiefer)	mascellare inferiore
unauffällig	nei limiti della norma
unauffällige Haut und Schleimhautverhältnisse	cute e mucose nei limiti della norma
Unterlippe	labbro inferiore
Verbandskit	kit di pronto soccorso
Verdauung	digestione
Vesikuläratmen	respirazione vescicolare
veterinärmedizinisch	veterinario
veterinärmedizinischer Einsatz	uso veterinario
Vollnarkose	anestesia totale
Vorderabschnitte	strutture (oculari) anteriori
Wirbelbogenwurzel	penduncolo vertebrale
Wirbelsäule	colonna vertebrale
Wirbelsäulensyndrom	sindrome vertebrale
Zahnfleisch	gengiva
Zahnhals	colletto dentale
Zahnhalsüberempfindlichkeit	ipersensibilità al colletto dentale
Zeigfinger	dito indice
Zentralnervensystem	sistema nervoso centrale
Zielgewebe	tessuto bersaglio
Zuckerkrankheit	diabete
Zungenhalter	pinza tiralingua
Zustand	esiti da / pregresso
tibiotarsales Gelenk	articolazione tibio-tarsica
Kofferdamm (Zahnarzt)	diga di gomina
Zwillingsmuskeln	gemelli
Modellguss	protesi scheletrata
Flachkopf-Syndrom	sindrome da testa piatta
Gewöhnung	abitudine
Abulie	abulia
abulisch	abulico
Abusus	abuso
Acidose	acidosi
Unterleib	addome
Aphrodisiakum	afrodisiaco
Agonist	agonista
Alkaloid	alcaloide
Phenantrenderivat	alcaloide a struttura fenantrenica
Isochinolin-Derivat	alcaloide a struttura isochinolina
wirksames Alkaloid	alcaloide attivo
Opiumalkaloid	alcaloide dell´oppio
mildern	alleviare
Halluzination	allucinazione
akustische Halluzination	allucinazione acustica
taktile Halluzination	allucinazione tattile
optische Halluzination	allucinazione visiva
Chromosomenabweichung	alterazione cromosomica
Veränderung der Affektivität	alterazione dell´affettività
physische Störung	alterazione fisica
psychische Störung	alterazione psichica
synthetische Analoga	analoghi sintetici
Lokalanästhetikum	anestetico locale
Oberflächenanästhetikum am Auge	anestetico oculare
Leistungsanästhetikum	anestetico tronculare
Aneurysma	aneurisma
Amphetamin	anfetamina
Angst	ansia
Antagonist	antagonista
Apathie	apatia
Harmin	armina
psychomotorische Störung	arresto psicomotorico
schnupfen	aspirare
soziale Isolation	associalità
Gewöhnung	assuefazione
oral einnehmen	assumere per via orale
User	assuntore di droga
Psychoaktivität	attività psichica
Durchblutung	attività vasomotoria
Gedankengang	attività ideativa
Selbstmedikation	autosomministrazione
bewußtseinsverändernde Wirkung	azione sconvolgente
therapeutische Wirkung	azione terapeutica
Barbiturat	barbiturico
Blut-Hirn-Schranke	barriera emato-encefalica
Benzodiazepin	benzodiazepine
Betelnuß	betel
nervenstimulierendes Getränk	bevanda nervinica
Bronchitis	bronchite
Bufotenin	bufotenina
Kachexie	cachessia
Hitzewallung	caldana
Cannabis	canapa (indiana)
Karies	carie dentaria
Katatonie	catatonia
Katecholamine	catecolamine
Chandoo	chandoo
den Drachen jagen	chasing the dragon
Chinin	chinino
Kokain	cocaina
Kokain-Hydrochlorid	cocaina cloridrato
Kokainist	cocainomane
Kodein	codeina
Koma	coma
Zustand der Gelassenheit	condizione di serenità
psychische Verfassung	condizione psichica
Sinneswahrnehmungen	condizioni sensoriali
zusammenfließen	confluire
geistige Verwirrung	confusione mentale
gewohnheitsmäßiger Konsument	consumatore abituale
Dauerkonsument	consumatore pesante
Gelegenheitskonsument	consumatore saltuario
gelegentlicher Konsum	consumo intermittente
Probier- und Neugierkonsum	consumo sperimentale
Protest	contestazione
Kontraktion der Eingeweide	contrazione intestinale
Konvulsion	convulsione
Antidiarrhoikum	costipante
Crack	crack
Muskelkrämpfe	crampi muscolari
Krampf	crampo
Anfall	crisi
Cor pulmonare acutum	cuore polmonare acuto
kicking the habit	dare un calcio all´abitudine
Aufgüsse	decotti
Immundefizienz	deficit immunitario
Delirium	delirio
Erschöpfung der Reserven	depauperamento delle riserve
Atemlähmung	depressione del respiro
Stimmungstief	depressione del tono dell´umore
Durchblutungsstörung	depressione dell´attività vasomotoria
Verstimmungszustand	depressione dell´umore
Derealisation	derealizzazione
inverse Toleranz	detolleranza
Diacetylmorphin	diacetilmorfina
physische Abhängigkeit	dipendenza fisica
psychische Abhängigkeit	dipendenza psichica
Dehydratation	disidratazione
Wahrnehmungsstörung	dispercezione
Wahrnehmungsstörung	distacco dalla realtà circostante
Herzbeschwerden	disturbo cardiaco
Magenbeschwerden	disturbo gastrico
Dopamin	dopamina
nach mehreren Kochvorgängen	dopo numerose bolliture
tödliche Dosis	dose letale
giftige Dosis	dose tossica
Suchtmittel	droga di abuso
illegale Droge	droga illecita
legale Droge	droga lecita
leichte Droge	droga leggera
harte Droge	droga maggiore
weiche Droge	droga minore
schwere Droge	droga pesante
Psychostimulantium	droga psicostimolante
sedierende und euphorisierende Droge	droga sedativo-euforizzante
Drogensüchtiger	drogato
Aufputschmittel	eccitante
Lungenödem	edema polmonare
befriedigende Wirkung	effetto gratificante
schädliche, zerstörerische Folgen	effetto lesivo
anregende Wirkung	effetto stimolante
teratogener Effekt	effetto teratogeno
Subarachnoidalblutung	emorragia subaracnoidea
Emotivität	emotività
Virushepatitis	epatite virale
Hepatomegalie	epatomegalia
Leberschaden	epatopatia
Gras	erba
Eritroxilin	eritroxilina
Down-Gefühl	esperienza al momento del down
isoliert	estratto
Blütenspitze	estremità fiorita
Flucht vor der Realität	evasione dalla realtà
Excitantia	excitantia
Schweißausbrüche bei geringen Anstrengungen	facile sudorazione
arzneimittelabhängig	farmaco-dipendente
Pharmakokinetik	farmacocinetica
Pharmakopöe	farmacopea
amtliches italienisches Arzneibuch	Farmacopea Ufficiale Italiana
Phenylcyclidin	fenilciclidina
Fentanyl	fentanyl
Kammerflimmern	fibrillazione ventricolare
Flash	flash
Flashback	flash back
Verfolgungswahn	fobia a carattere persecutorio
Brüchigkeit der Nägel	fragilità ungueale
Pulsfrequenz	frequenza del polso
Verstandestätigkeit	funzione intellettiva
Austreten	fuoriuscita
Gynekomastie	ginecomastia
Acetylgruppe	gruppo acetilico
Gegenkultur	gruppo socio-culturale alternativo
Haschisch	hashish
Ibogain	ibogaina
Wahnidee	idea delirante
Wahnvorstellung	ideazione delirante
Selbstmordgedanken und -absichten	idee e pulsioni suicide
nachahmend	imitativo
Drang	impulso
inhalieren	inalare
Appetitlosigkeit	inappetenza
anritzen	incisione sottile superficiale
Inkretion	increzione
Teilnahmslosigkeit	indifferenza ideativa ed emotiva
zur Einstiegsdroge greifen	iniziare a drogarsi
Schlaflosigkeit	insonnia
Rechtsherzinsuffizienz	insufficienza cardiaca destra
Wechselwirkung	interazione
suizidale Vergiftung	intossicazione a scopo suicida
akzidentelle Vergiftung	intossicazione accidentale
invers	inverso
Übererregung	ipereccitazione
Hyperästhesie	iperestesia
emotionale Hypersensibilität	ipersensibilità emotiva
Hypothermie	ipotermia
Unruhe	irrequietezza
Reizbarkeit	irritabilità
Ischemie des Herzmuskels	ischemia miocardica
starkes Tränen der Augen	lacrimazione
Mohntränen	lacrime di papavero
Laudanum	laudano
Letalität	letalità
Freisetzung	liberazione
Libido	libido
Soldatenkrankheit	malattia del soldato
Nierenkrankheit	malattia renale
Marihuana	marijuana
Mekonium	meconio
Meprobamate	meprobamati
Meskalin	mescalina
Methadon	metadone
Mydriasis	midriasi
Miosis	miosi
Myristicin	miristicina
charakterliche Veränderung	modificazione caratteriale
Glückshormon	molecola del piacere
Überträgersubstanz	molecola mediatrice
Monoacetylmorphin	monoacetilmorfina
Morphin	morfina
Muscimol	muscimol
Naloxon	naloxone
Nepenthes	nepente
Neuroadaptation	neuroadattamento
Neurotransmitter	neurotrasmettitore
Schnee	neve
Nystagmus	nistagmo
Noradrenalin	noradrenalina
Noscapin	noscapina
Haschisch-Öl	olio di hashish
Ololiuqui	ololiuqui
Opiate	oppiacei
Rohopium	oppio grezzo
adrenocorticotropes Hormon	ormone adrenocorticotropo
Wachstumshormon	ormone della crescita
Sexualhormon	ormone sessuale
hypophysäres Sexualhormon	ormone sessuale ipofisare
peripheres Sexualhormon	ormone sessuale periferico
Papaverin	papaverina
Schlafmohn	papavero sonnifero
Bulbärparalyse	paralisi dei centri bulbari
Darmlähmung, Intestinallähmung	paralisi intestinale
Furcht	paura
Pentachlorophenol (PCP)	pentaclorofenolo (PCP)
Pentazozin	pentazocina
Übertragung des Schmerzreizes	percezione del dolore
Zeitgefühl	percezione temporale
Haschischplatte	piastra di hashish
Pyrolyse	pirolisi
Raucheremphysem	pneumomediastino da fumo
Cracklunge	polmone da crack
Opiumpulver	polvere d´oppio
illegal hergestellt	preparato clandestinamente
Blutdruck	pressione arteriosa
kontinuierlicher Gewichtsverlust	progressivo dimagrimento
bewußtseinsverändernd	psicoalterante
Sedativum, Hypnotikum	psicofarmaco sedativo
psychotrop	psicotropo
Psylocibin	psilocibina
unbezwingbares Verlangen	pulsione psichica
depressive Stimmung	quadro depressivo
psychopathologisches Erscheinungsbild	quadro psicopatologico
abschaben	raccogliere
gerinnen	rapprendersi
Endorphinrezeptor	recettore specifico endorfinico
Harz	resina
Echoeffekt	reviviscenza psicotossica
Wiederaufnahme, Resorption	riassorbimento
Stärkungsmittel	ricostituente
Verringerung des Gedächtnisses	riduzione della capacità intellettiva
Verminderung der Diurese	riduzione della diuresi
Verringerung der Merkfähigkeit	riduzione della memoria
sich auf sich selbst zurückziehen	rinchiudersi in se stesso
Rhinorrhö	rinorrea
Stoff	roba
Kokain-Rush	rush cocainico
Safrol	safrol
Hustensedativum	sedativo della tosse
Wohlbefinden	sensazione di benessere
Unlustgefühl	sensazione spiacevole
Sinneswahrnehmung	senso-percezione
Serotonin	serotonina
amotivationales Syndrom	sindrome amotivazionale
Entzugssyndrom	sindrome di astinenza
Entzugssyndrom	sindrome di privazione
psychotisches Syndrom	sindrome psicotica
symptomatisch wirkendes Mittel	sintomatico
Symptomenkomplex	sintomatologia
limbisches System	sistema limbico
Stimmungslage	situazione emotiva
Problemlöser	soluzione di tutti i problemi
Schnüffelstoff	solvente volatile
sniefen	somministrazione per sniffo
Somnolenz	sonnolenza
Wirkstoff	sostanza attiva
Zusatzstoff	sostanza da taglio
psychoaktive Substanz	sostanza psicoattiva
Ersatzdroge	sostitutivo
Rezeptpflicht, wiederholte Abgabe verboten	sottoposto a ricettazione non ripetibile
Überdosierung	sovradosaggio
Dealer	spacciatore
Handel	spaccio
spasmolytisch	spasmolitico
Interzellularraum	spazio intercellulare
Joint	spinello
unkontrollierbarer Drang	spinta incontrollabile
Avitaminose	stato avitaminosico
Verwirrtheitszustand	stato confusionale
Gemütszustand	stato d´animo
anfängliche Stimmungslage	stato d´animo iniziale
biologisches System	stato psichico e fisico
akute Intoxikation	stato tossico acuto
anregend	stimolante
Stimulans	stimolante
Stimulierung des Gehirns	stimolazione cerebrale
Strychnin	stricnina
Schwitzen	sudorazione
Cold Turkey	tacchino freddo
Tachykardie	tachicardia
strecken	tagliare
Verschnitt	taglio
Thalamus	talamo
Thebain	tebaina
Suizidneigung	tendenza al suicidio
Wohngemeinschaft unter psychologischer Aufsicht	terapia psichico-residenziale
Reanimation	terapia reanimativa
Beatmung	terapia respiratoria
Opiumtinktur	tintura di oppio
Einnahmeart	tipo di assunzione
averse Toleranz	tolleranza inversa
metabolischeToleranzentwicklung	tolleranza metabolica
Hochstimmung	tono dell´umore esaltato
Drogenabhängiger mit kontrolliertem Suchtverhalten	tossicofilo
suchterzeugende Wirkung	tossicogenicità
Drogenabhängiger	tossicomane
Rauschgift- und Drogensüchtiger	tossicomania
suchterzeugend	tossicomanigeno
Drogenhändler	trafficante di droga
Delta-9-Tetrahydrocannabinol	trans-delta-9-tetraidrocannabinolo
feinschlägiger Tremor	tremori a fini scosse
unkontrolliertes Zittern	tremori diffusi
Stengelstückchen	trinciato di rami
Venenentzündung	tromboflebiti
Ulzeration der Nasenscheidewand bis zur Septumperforation	ulcerazione del setto fino alla perforazione
zwanghafter Konsum	uso compulsivo
gemeinsamer Nadelgebrauch	uso della stessa siringa
zur Hervorrufung rauschartiger Zustände	uso drogastico
Dauerkonsum	uso regolare
zur Hervorrufung lustbetonter Empfindungen	uso ricreazionale
zum Genuß	uso voluttuario
10-Jahres-Grundrisiko	a 10 anni
a-tonikal	a-tonicale
AAe, AÄ = Assistenzärztin	medico assistente, f.
Abbruch einer Nachresektion	interruzione di una postresezione
Absorptionswäscher	assorbimento o lavaggio chimico
acetyliert	acetilato
Aerosolschaumprodukt	prodotto aerosol in schiuma / prodotto aerosol (schiuma)
AKST = Antikörpersuchtest (indirekter Coombstest)	test per rilevare la presenza di anticorpi liberi nel siero (test di Coombs indiretto)
akuten suizidalen Handlung	pericolo elevato di suicidio
Akzeleranz	accelerazione
akzentuierte Persönlichkeit	personalità istrionica
anamm. KHK	anamnesi (familiare) / (storia familiare di) cardiopatia coronarica
anatomischer Bezug des Tumors zur Arteria carotis interna	estensione anatomica del tumore all'arteria carotide interna
Anlage einer 6F Schleuse	impianto di un catetere guida 6F
Anschlusssegment-Arthrose	degenerazione artrosica dei segmenti (scheletrici) adiacenti
Antrieb	impulso / stimolo
Apatitrheumatismus	reumatismo artritico
hypnische (Schlaf)architektur	architettura ipnica
Assistenzarzt	medico assistente (ospedaliero)
Konzentrations-Zeit-Kurve (area under the curve – AUC)	AUC
auf dem Dampfbad zur Trockne	far evaporare su un bagno di vapore
aufbauen	modellare/modellare
aufgehobene Mindestmobilität	mantenimento della mobilità minima
Auflagematratze	matterasso di appoggio
Aufnahme- und Bindungsfähigkeit	potere assorbente e legante
Aufschaltwert	valore di inserzione (El), valore di assorbenza (Ch)
Ausfallerscheinung	alterazione/i delle facoltà psicofisiche / nelle funzioni psichiche e sensoriali (del conducente)
Ausprägung einer Ophthalmica-Kollaterale links	estensione nel ramo collaterale dell'arteria oftalmica sinistra
Ausweichbewegungen	movimenti / atteggiamenti / comportamenti (difensivi) di evitamento
AZ (Allgemeinzustand)	condizioni generali (di salute)
überlappende Antikoagulation	anticoagulazione concomitante
Überdachungsdefizit	deficit di copertura
Ballonierung	rigonfiamento a palla
beginne ich zu verfallen	comincio a deperire (lentamente)
begrünbare Lärmschutzwände	barriere vegetali antirumore / barriere vegetali  fonoassorbenti / barriere fonoassorbenti di materiale naturale
bei einem auffälligen Ersttrimester-Test	in caso di anomalie nel test (nello screening diagnostico) del primo trimestre (di gravidanza)
belüftete Pauken	cavità timpaniche ventilate
Beleuchtungskasten	terrario con illuminazione
Bereichsgas	gas di taratura
Beurteilung, ausser bei der T-Zelldifferenzierung	valutazione, esclusa la differenziazione delle cellule T
bildmorphologisch	mediante ecografia morfologica
Bildrauschen	rumore di fondo (smooting) delle immagini
Biologie	struttura / composizione / funzione biologica
bluten lassen (die Wunde)	far sanguinare (la ferita)
Bodendruck: max. 3,5 kg/cm², Berlin: 1,5 kg/m²)	pressione sul suolo: max. 3,5 kg/cm², (a) Berlino: 1,5 kg/m²
bodenunabhängigen  Verfahren	procedure indipendenti da terreno
Sanitätskoffer	borse mediche
Bridging des Herniendefektes	bridging del difetto erniario
Buchenlaub	fogliame di faggio
bump-resection	resezione dell'escrescenza ossea (bump)
ergänzenden und kompensatorische Fähigkeiten (und Fertigkeiten)	capacità supplettive-compensatorie
(Flug)aschen aus Kohlekraftwerken	ceneri da centrali elettriche a carbone
Citronensäure Bismut-Kalium-Salz	sale di potassio del bismutato citrato
Zahnübereinstimmung	collimatura dentaria
beidseitige Kordonerziehung [Rebstöcken]	cordone bilaterale
beidseitige Kordonerziehung [Rebstöcken]	cordone bilaterale
CPDA- und Heparinblut [CPDA = CitratPhosphatDextroseAdenin]	campione ematico con eparina e soluzione CPDA [CPDA = Citrato-Fosfato-Destrosio-Adenina]
CTG (Kardiotokographie), Viertgravida, Erstpara	CTG (cardiotografia), quarta gravidanza, primipara / primo parto
Medizinische Leitung einer Krankenhauseinrichtung	D.M.P.O. = Direzione Medica di Presidio Ospedaliero
DE, PF = Dorsalextension (DE), Plantarflexion (PF)	estensione dorsale, flessione plantare
Deklaration	dichiarazione di purezza microbiologica
den bestehenden Durchfallverhältnissen anpassen	adatta / adegua alle condizioni di diarrea esistenti
Designeröle = MCT-Ölen = [MCT, Medium Chain Triglycerides, mittelkettige Triglyceride]	oli designer/ oli (speciali) MCT  [Medium Chain Triglycerides, trigliceridi a catena media, ad uso medicinale e farmaceutico)
Dialogansicht	finestra di dialogo
Diese Mimik,  die  man ganz allgemein als Drohen zu bezeichnen pflegt, kommt überhaupt nur dann zustande, wenn die Tendenz ...	Questa mimica, che in generale chiamiamo minacciare, nasce solo se la tendenza ...
diffusionsverankert	ancorato mediante diffusione
disc bulge	rigonfiamento del disco
Parenchymdistorsion	distorsione parenchimale
Donor von dem die Nadel, Skalpell oder die Verletzung stammt	donatore da cui si origina il contatto con l'ago, il bisturi o la ferita (eventualmente infetti)
Drohreflex	riflesso di minaccia
E-Flüssigkeit	liquidi per sigarette elettroniche
einpolymerisiert	polimerizzato
einseitige	unilaterale / parziale
Ellenbogen-Bedienung	azionabile con il gomito (mediante leva)
erlebbarer Umweltschutz	iniziative di tutela ambientale / tutela ambientale nella pratica
Ernte der Holzbestände	raccolta del legno / legname
Erscheinungsbild	apparenza / apparenza visiva / immagine (potenzialmente) fittizia
Ery-Streubreite	diffusiione degli eritrociti / globuli rossi
Laboruntersuchung durchführen (lassen)	eseguire un labor
evaluierten Überblick	panoramica specialistica
klinische Vorfälle	eventi clinici
Exocollagen	exo-collagene / EXO-collagene
explosionsartig zerfallen	avere effetti analoghi a quelli di un'esplosione
Extrusionspellets	pellet estrusi / pellet di/da estrusione
Fa. XXXXX	azienda / ditta XXXXX
Fallzahladjustierung	aggiustamento del numero dei casi
Fangis (CH) = Fangen, Nachlauf (D)	acchiappino, acchiapparella, ce l'hai
farbcodiert	codice colore (tabella codificata per colore)
Faserbegleitstoffe	sostanze complementari a fibre / filamento
auslösende Faktoren	fattori scatenanti
Feinstaub im lungengängigen Bereich	polveri fini inalabili (dai polmoni) / particolato (ultra)fine / PM10
Fingergelenkverband	cerotto per (medicazione dell) articolazione delle dita
Folienpäckchen	impacco con strisce di carta stagnola / cartine
Formenkenntnis	conoscenza forme / conoscenza delle forme
FP / fusion point (FP)	PF (punto di fusione) / coalescenza
frei abgeblüht	nato spontaneamente
Fremdkörperzange	pinza / pinzetta - per corpi estranei / per la rimozione di corpi estranei
frontal links	frontali sx
Galeannähte	suture galeali
galvanische Lokalelemente (Bildung galvanischer Lokalelemente)	celle / elementi locali galvanici/che (formazione di...)
gebundene Feuchtigkeit	umidità presente / combinata
gebundenem Silikon	resina siliconica / silicone legante
gebundenes Silikon	resina siliconica / silicone legante
Gefäßoperation	intervento (di chirurgia) vascolare
Gegendruckplatte - Gegendrucksystem	piastra / placca di controspinta -- sistema di controspinta
Geschehen	quadro clinico
Gesundheitswissenschaftler	studioso di scienze della salute
Gingivaverlauf	linea / architettura gengivale
Glutatazidurie Typ I	aciduria glutarica tipo I
haltsuchend	in cerca di sostegno
Harnleiterschiene	catetere ureterale (interno) (Stent)
Hautwiderstandsmessung	misurazione della resistenza cutanea
Häkchen	uncinetti / gancetti
Höhe Grundgelenk	all'altezza dell'articolazione basale
Hüftgelenk	articolazione dell'anca (o coxo-femorale)
Herrsche-Zeichen	segni di dominanza (d. cerebrale: destralità vs. sinistralità)
Herzangst	cardiofobia
Hinterkammerlinse	lente da camera posteriore
Hirnstoffwechsel	metabolismo cerebrale
hochrein	ad elevata purezza / ad elevato grado di purezza
biblische Textauslegung	I sensi biblici
i.A. = im Allgemeinen	generalmente
Ganzkörperabbildung bzw. Ganzkörperdarstellung	immagine a figura intera
Immunstatus gross	risposta immunitaria complessiva
bestehend	in atto
in CMYK aufzubauen	riproducibili in CMYK (Cyan, Magenta, Yellow, Key black) o quadricromia
In-Vivo-Herz-Defibrillator	defibrillatore cardiaco impiantabile
Zahnimplantat-Berater	informatore dentale
INR (International Normalized Ratio)	INR
Integrierte Widerstandsmessung mit 20 Hz Sinus	misurazione integrata di resistenza con onde / oscillazioni sinusoidali di 20 Hz
intramuraler bzw. extramuraler Bereich	cosiddetto ambito intramurario o extramurario (prestazioni erogate all'interno/esterno dell'ospedale
Einführung in das Medizinstudium	Introduzione Studio Medicina
erhöhte Blutdichte	iperdensità ematica
IPS-Austritt = Intensivpflegestation-Austritt	dimissioni dalla stazione di cure intense (CH) / dimissioni dal reparto di terapia intensiva (I)
J-förmig	curva esponenziale o  curva J
je nach Trainingsbelastung	a seconda dell'intensità dell'allenamento
Jodpropinyl-Butylcarbamat	iodopropinilbutilcarbammato
Kapsolyse	lisi della capsula (articolare)
kassenzulässig	farmaco rimborsabile (dalle casse malati)
Körnungsabstufung	differenziazione granulometrica
Kettendemontage	rimozione della catena ossiculare
Klimakiller	killer del clima / killer climatico
knoechernd Durchbauung	osteoformazione, formazione / costruzione ossea / di nuova sostanza ossea
Kohlenstoffgehalt (C) kleiner als 2 Gew.-% C	contenuto in carbonio (C) inferiore a 2% m/m ( percentuale in peso): C (< 0.02%)
kombinierte Bewegungen des Unterschenkels	movimento combinato della gamba
Kompressen	compresse (di garza idrofila sterilizzata)
kreisrunder Haarausfall	alopecia areata
Kugelsterilisator	sterilizzatore a sfere / apparecchio sterilizzatore a sfere
Kupferschlacke	scoria di rame
optimaler Wert, empfohlener Wert (Grenzwert)	L.O. L.C. - limite ottimale (L.O.) e limite consigliato (L.C.)
Labor Ausnahmeziffer	codice delle prestazioni di laboratorio con esenzione ticket
LAD  (left anterior descending)	ramus interventricularis anterior (RIVA) / ramo interventricolare anteriore
Laufprobe	prova di movimento / prova di passaggio (walk test)
Lärmemissionswerte	valori  di emissione acustica
Lebhafter MSR	vivo riflesso della tensione monosinaptica
Leistungsprüfung (Tierzucht)	verifica delle prestazioni produttive / riproduttive (allevamento)
Lichtschutzmittel	fotoprotettivo / protezione fotoprotettiva
linear mit der geleisteten Arbeit ansteigen	aumentare in modo lineare con lavoro svolto
listengerecht	secondo l'elenco
Literaturrecherche	ricerca di letteratura o documentazione (medica)
lnfiltration der intrapankreatìschen Fettgewebssepten	segni di infiltrazione dei setti adiposi intrapancreatici
Lungengerüstzeichnung	rinforzo della trama polmonare (di tipo bronchitico)
M1- als auch die M2- und M3-Äste	rami M1 e M2 e M3  (segmenti prossimali dellarteria cerebrale media)
Maßstabseinheit	scala // unità di misura
Mammographie-Filme	pellicola radiografica per mammografia
Marbagelan-Schwamm	tampone emostatico di gelatina riassorbibile Marbagelan®
Mariendistelkraut	cardo mariano
med. pract.	med. prat.
MEDAS = Medizinische Abklärungsstelle(n)	MEDAS (Medizinische Abklärungsstelle(n), medicina del lavoro)
mehrschichtige gegossene PVC-Folie	pellicola PVC fusa multistrato
Messkristall	cristallo misuratore
methanolarm	(a) basso tenore di metanolo
Milchzusätze	supplementi (nutrizionali) nel latte
Minderbelastung	debolezza / indebolimento
Minusgraden	temperature polari / freddo polare
mit FS abgeleitet (Fotostimulation)	con fotostimolazione
Modulatortest [NK-Zell (Natural-Killer-Zellen)]	test di modulazione (della risposta immunitaria) [delle cellule o linfociti NK (Natural Killer)]
Molkenlässigkeit	sineresi e spurgo
Morbus embolicus	malattia tromboembolica
multilokuläres Schmerzsyndrom	sindrome dolorosa multioculare / diffusa
Multipelste fleckige hämorrhagische DAI	danno assonale diffuso (DAD) multiplo maculato emorragico (diffuse axonal injury - DAI)
periphere Atemgeräusch (Vesikuläratmen, vesikuläres Atemgeräusch, vesikuläres AG)	MV = murmure vescicolare
Nachpassung	adattamento
Nahüberhöhung	rigonfiamento (ravvicinato, a breve raggio)
Nahrungsergänzungspräparate	integratori alimentari
Natrium-Silikatglas	vetro (a base) di silicato di sodio / silicato sodico
NBKS vs. DD = Nierenbeckenkelchsystem vs. Differenzialdiagnose	sistema calico-pielico (dei calici renali) vs. diagnosi differenziale
NNH = Nasennebenhöhlen (NNH)	cavità nasali secondarie o accessorie / seni paranasali
no-call Rate	percentuale di campioni non genotipizzati (no call rate)
normale hyperintense Darstellung des Pankreas in T1	formazione normale iperintensa del pancreas in T1
Oberflächen­-Lufthärte	durezza superficiale (e resistenza agli agenti atmosferici)
OD	Oberflächendosis - dose superficiale
Ohrproppen	cuffie antirumore
olfaktorische Kerngebiete	centri olfattivi
operkulär	opercolare
Organen des vegetativen Nervensystems	organi della vita vegetativa
Organmanifestationen	organi coinvolti
OS-Orthese = Oberschenkel-Orthese	ortesi femorale
Patellaverkantungsschmerz	dolore (al ginocchio) flettendo in senso laterale la rotula (test dell'apprensione)
hypotympanische Perkussion in rechter Darmbeingrube	percussione ipotimpanica in FID (fossa iliaca destra)
Pflegeziele	obbiettivi sanitari
pflegt und stylt	cura / nutre e modella
plantare Spreizfuss-Pelotte	plantare con pelotta per piede traverso piano (valgo)
Planungs- und Strukturierungsfähigkeit (qui)	capacità progettuale e strutturale
polyantibiotikaresistent	poliantibiotico resistente
PEG-Palmitostearat (Polyethylenglycol-Palmitostearat)	polietilenglicole palmito stearato
Polyhydroxysäure	Poliidrossiacido
Populationszüchtung	coltivazione / allevamento di popolazioni / razze-popolazioni
Prisma Basis	base prismatica / (lente prismatica)
Probenstrahlengang	traiettoria del raggio (di rilevazione / sul campione)
Probenstrahlengang	traiettoria del raggio (di rilevazione / sul campione)
Promille-Brille	occhiali Alcovista
Pulverlösestation	stazione di dissoluzione polveri
Purpursonnenhutkraut	Echinacea purpurea (herba)
Quartierschild	cartello esplicativo
Querverweis	riferimento incrociato
Halswirbelsäule	r.c. = rachide cervicale (anat.)
Ansammlung von Flüssigkeit (Hygrom)	raccolta igromatosa
Radikalfängern	antiossidanti (che catturano i radicali liberi) / cattura radicali
randbildend (Tumorausläufer)	formano / creano / costruiscono  un margine / bordo (propaggini del tumore)
Ratte (Styrol)	ratto (stirene)
Rückkoppelung	retroreazione
Rückzügigkeit	tendenza all'isolamento
reagiert zu unlöslichem, hochschmelzendem Polyharnstoff	reagisce trasformandosi in poliurea insolubile ad alto punto di fusione
realistische Biomarker	biomarcatori realistici
reflexionsarmes Umfeld	ambiente poco riflettente (l'irraggiamento del suono)
reiner Pflanzenzellen	cellule vegetali (pure)
Repositionsspondylodese	spondilodesi/intervento di riposizionamento
Residualbefund	massa residuale / massa (tumorale) residuale
medizinische Verantwortung	responsabilità medica
Resthörigkeit	udito residuo
Rettungssitz	imbragatura
Revierbesitzer	territorialista/i
rezeptfähig	rimborsabile su presentazione di ricetta medica
exegetische Forschung	ricerca esegetica
alttestamentarische Bezüge	Riferimenti veterotestamentari
Reflex-Creme	Riflessante
S T Hypästhesie (Hypästhesie in Bezug auf Schmerzempfinden und Temperaturempfinden)	ipoestesia termodolorifica
Sachohr	orecchio oggettivo / ricezione oggettiva di una notizia / ascolto oggettivo
Sanitätshaus	negozio di articoli sanitari e parasanitari
Sauerstoff wird offenbar im Gesamtsystem knapp	l'ossigenno scarseggia evidentemente / probabilmente nell'intero sistema
Sättigungsmittel	integratore (alimentare) saziante
Säurebearbeitung	(impiego di) acidi per l'edilizia
Scheibenleuchte	lampada di emergenza (a forma di plafoniera)
Scheidenstumpf	moncone vaginale
schleichender fütterungsbedingter Vitaminmangel	lieve carenza di vitamine causata dall'alimentazione
Schleimbelagerung	accumulo di muco (nella cavità polmonare)
Schocktod	morte per shock ipoglicemico
Sectio-OP = Sectio-OP-Saal	sala cesareo = sala operatoria per il parto cesareo
Sehstärke	valori diottrici / diottrie (necessarie) / correzione (necessaria)
TSE, IR, DWI-Sequenzen (Turbo Spin Echo, Inversion Recovery, Diffusion Weighted Images)	Sequenza d acquisizione TSE, IR, DWI
Silierkette	catena di insilamento / catena dell'insilato
Silikatverbindungen	silicati / composti silicati / gel silicati
Infektionsquelle	sito d'infezione
weiße Hirnsubstanz	sostanza bianca
subdurale Blutung	sottodurale
soviel Luft muss ich immer haben	ho / devo sempre avere tanto / abbastanza fiato
Spitalleitung	consiglio direttivo dell'ospedale
Spontanträger	utilizzatori occasionali di lenti a contatto
Spritzbrühe	miscela  da erogare
Sprunggelenksgabel	pinza malleolare
Stärke	dosaggio (fisso) / composizione quantitativa
Steinsalz	salgemma  cloruro di sodio / sale da cucina
Steinsalz	salgemma / cloruro di sodio / sale da cucina
Steinzelle	cellula petrosa
Steri	zona / locali di sterilizzazione
Sterylglycoside	glucoside (in soluzione) sterile
Strahlenvereinigung	convergenza / conversione dei raggi luminosi (focalizzazione)
Streichbewegungen / mit leichten Streichbewegungen	con leggeri massaggi / con delicati movimenti
Stromprobe	elettrogramma / misura dei parametri elettrici
Strumpfbandnattern	serpenti giarrettiera
Summenstudien (Summationsbild 20-40)	studi analitici (immagine di sommazione 20-40)
t/a Maissilage (35 % TS, 95 % OTS)	t/a / ton/anno insilato di mais (35% sostanza secca, 95% sostanza secca organica)
Tagesturnus	posologia giornaliera
Tönservice	servizio colore / servizio tintometrico
Türkisvogel /  Rotfußhonigsauger / (Cyanerpes cyaneus)	cianerpe zamperosse / nettarina blu / nettarina zampe rosse / (nome latino: cyanerpes cyaneus)
Fernröntgen des Schädels	teleradiografia del cranio
temperaturkompensierter Messwert	valore misurato (in condizioni di) compensazione di temperatura
Theoriegeladenheit	eccessivo zelo teorico
Thrombo-Streubreit	diffusione dei trombociti / (delle) piastrine
Titancage	cage (gabbia) in titanio
Torsade de pointes (TdP), Torsade-de-pointes-Tachykardie, Torsade-Tachykardie, Spitzenumkehrtachykardie, Schraubentachykardie	torsione di punta (= aritmia, anomalia del ritmo cardiaco)
Torsade de pointes (TdP), Torsade-de-pointes-Tachykardie, Torsade-Tachykardie, Spitzenumkehrtachykardie, Schraubentachykardie	torsione di punta (= aritmia, anomalia del ritmo cardiaco)
Tracht (Bienen)	raccolto (api)
trinkwasserrein	acqua classificata di livello potabile
Tubergelenkwinkel	angolo dell'articolazione calcaneo-cuboidea (tuberosità del calcagno)
UATR-Technik	tecnica UATR (da Universal Attenuated Total Reflectance, riflettanza totale attenuata universale)
Umschlagszone	zona di transizione
Umwelttechnik	tecnologia ambientale
Unfallsache (mediz. Gutachten)	caso di incidente (perizia medica)
unter Beistellen	con appoggi(o)
unter Beistellen	con appoggi(o)
Unterbegabung	disabilità intellettiva
UP-Harze = ungesättigte Polyesterharze	resina poliestere insatura
Vakuum	vacuumterapia
Tetanusschutzimpfung / Tetanus-Auffrischungsimpfung	VAT = vaccino antitetanico / VAT di richiamo = vaccino antitetanico di richiamo
Vektorsprung	salto vettore
verantwortungsvoll ökologisch sinnvoll nutzen	utilizzare ecologicamente in modo responsabile e appropriato (nel rispetto dellambiente)
verantwortungsvoll ökologisch sinnvoll nutzen	utilizzare ecologicamente in modo responsabile e appropriato (nel rispetto dellambiente)
Verband Deutscher Mutterhauser vom Roter Kreuz	Associazione delle case-madri tedesche della Croce Rossa
Vereinigten Klinischen Anstalten Freiburg	istituti clinici (universitari) riuniti di Friburgo (ted. Vereinigte Klinische Anstalten Freiburg)
Verfolgsprobe	test per (rilevamento di) patogeni
verkipptes Einsetzen	inserimento storto / traballante
Verlaufsprotokollierung	protocollo del decorso
Verrauchung des Fluchtweges	via di fuga invasa / bloccata dal fumo
Verrichtung der Notdurft (der Hunde)	espletamento delle necessità fisiologiche (dei cani)
Versorgungsoptimierung	ottimizzazione dell'assistenza (ai pazienti)
Vinasse	vinaccia / vinacce
Video-Okulographie (VOG)	VOG = video-oculo-grafia (video-oculography, VOG)
Vestibulookulärer Reflex (VOR)	VOR = riflesso vestibolo-oculo-motore (vestibulo-oculomotor testing, VOR)
Vorwässerung	prelavaggio
SVV-Test (Subjectiv-Visual-Vertical-Test)	VVS = test VVS (verticale visuale soggettiva) = (S.V.V. test = Subjective Visual Vertical Test)
Wirbelgas	gas vorticoso
Wurzelkanalkonditionierer	condizionatore del canale radicolare
Zahn-/Zahnfleischübergang	spazio tra gengiva e dente / spazio tra ponte e gengiva
zahnärztlichen Antibiotikachip	chip antisettico odontoiatrico
Zahnseidenmuffel	i (più) restii all'interdentale / al filo interdentale / all'uso del filo interdentale
Züchtungsvorstellung	politica eugenetica // visione di allevamento selettivo (della razza nordica)
zellspezifisches Oberflächenantigen	antigene superficiale specifico della cellula
Gewebeaufbau	proliferazione dei tessuti/formazione e rigenerazione dei tessuti
blasendach	cupola vescicale
physische Einschränkung	contenzione fisica
Fehlbelegung	mancato impianto/insediamento embrionale
ggt	GGT/Gamma-GT (Transferasi gamma del glutamil /Gamma Glutamil Transferasi)
konsumierende Erkrankungen	malattie consuntive
luxierte Diskushernie	ernia discale espulsa
polydisziplinär abklären	condurre un' analisi multidisciplinare
polydisziplinär abklären	condurre un' analisi multidisciplinare
stupor cordarum	stupore cordalico
Tiefenwachstum	migrazione in profondità (riferito all'epitelio)
Wirbelkörperfrakturen	fratture del corpo vertebrale
Beistoffe	coformulanti
Futtermittelzusatzstoff	additivo per mangimi
Trägerkatalysator	Catalizzatore di supporto
