Halskragen	halskrage
der Halsrücken	halsrygg
AC Gelenk	akromioklavikularled
Auffrischimpfung	omvaccinering; revaccinering
Cave	Varning
Frühsommermeningo-Enzephalitis (Zeckenschutzimpfung)	fästingburen meningoencefalit (TBE-vaccinering)
Heilbehandlung	kurativ behandling
K&B Komposit	Super-Bond C&B; C&B-Metabond
kohlensaurer Algenkalk	kolsyrad algkalk
Nervenhörner	nervhorn
Regeltempoanomalien	menstruella anomalier; menstruella störningar
Schublade	draglåda
staphylokokken-enterokolitis	stafylokockenterokolit
Streifenlichtprojektion	projektion av strukturerat ljus
synthesebedingt	beroende på syntesförfarande; syntesberoende
Sauerstoffmangel	syrebrist
Entwicklungsstörungen	utvecklingsstörningar
Verschattung	skugga
Zwischenwirbelraum	utrymmet mellan kotorna; spatium intervertebrale
Abasie	abasi
Abbau	nedbrytning
Abbindung	stelningstid
Abdruckmasse	avtrycksmaterial
Abdusenzlähmung	abdusenspares
aberrierend	aberrant
abführende Wirkung	laxerande verkan
Abführmittel	laxeringsmedel
Abgang	missfall
abhängig	beroende
Ablassrate	deflationshastighet
Abnabelung	avnavling
abnorm	abnorm
absondern	utsöndra
Absonderung	utsöndring
absorbierend	absorberande
Abstinenz	helnykterhet
Abstinenzerscheinung	abstinenssymptom
Abstinenzler	helnykterist
abstoßen	avstöta
Abstoßreaktionen	avstötningsreaktioner
Abstoßung	avstötning
abszedieren	abscedera
Abszess	varböld
Abwehrkräfte	immunförsvar
Accelerin	accelerin
Achillessehne	akillessenan, hälsenan
Achillessehnenruptur	akillesseneruptur
Achillodynie	akillodyni
Achselhöhle	armhåla
Acorea	akoré
Adamsapfel	adamsäpple
Adaptation	adaptering
adduzieren	adducera
Adenektomie	adenektomi
Aderlass	åderlåtning
ADI	accepterat dagligt intag
adrenal	som avser binjurarna
Agoraphobie	torgskräck
Agraffe	agraff
Agraffe	sårklämma
Aichmophobie	sjuklig rädsla för att skada sig själv eller andra med skärande eller spetsiga föremål
Ailurophobie	sjuklig rädsla för katter
akinetisch	akinetisk
akquirieren	ackvirera
Akromegalie	akromegali
Akupressur	akupressur
Akureyri-Krankheit	akureyrisjukan
Alalie	alali
Albumen	albumen
Alfentanil	alfentanil
Alginsäure	alginsyra
Algophobie	algofobi
Algurie	alguri
Alkoholiker	alkoholist
Allergie	allergi
Allgemeinmedizin	allmänmedicin
Allgemeinmediziner	allmänläkare
Allgemeinzustand	allmäntillstånd, AT
Alligatorzange	alligatortång
Allopezie	alopeci, håravfall
Alraune	alruna
Alternativmedizin	alternativmedicin
altersschwach	skröplig, ålderssvag
alveolär	alveolär
Alveole	blåsa, urholkning
Alzheimers Krankheit	Alzheimers sjukdom
Amalgam	amalgam
Amalgamabscheider	amalgamseparator
Amalgamtätowierung	amalgamtatuering
Amastie	amasti
amaurotisch	amaurotisk
Ambidexter	ambidexter
Ambidextrie	ambidextri
Ambisexualität	bisexualitet
Amboss	städ
ambulant	ambulant, ej sängliggande
Ambulanz	akutmottagning
Ameisensäure	myrsyra
amelanotisch	amelanotisk
Amelie	ameli
Amenorrhoea, Amenorrhö	amenorré
AMG, Arzneimittelgesetz	läkemedelslagen
Amidase	amidas
Aminosäuren	aminosyror
AML, akute myeloblastische Leukämie	AML, akut myeloisk leukemi
Amme	amma
Ammonshorn	ammonshornet
Amnesie	amnesi
amnestisches Syndrom	amnestiskt syndrom
Amnionflüssigkeit	amnionvätska
Amnionhöhle	amnionhålan
Amotio	amotio
Ampullenflasche	ampullflaska
Amputat	amputat
Amputation	amputation
amputieren	amputera
Amtsarzt	distriktsläkare
Anamnese	anamnes, sjukdomshistoria
anaphylaktischer Schock	anafylaktisk chock
Anaphylaxie	anafylaxi
Anatomie	anatomi
Anämie	anemi
Anästhesie	anestesi
Anästhetist	narkosläkare
Anfallsleiden	epilepsi
Angiologie	angiologi
Angst-Glück-Psychose	cykloid psykos
Anormalität	abnormalitet
Anosmie	avsaknad av luktsinne
Antidepressivum	antidepressivt medel
Antikörper	antikroppar
Antikörper	immunoglobuliner
Antikoagulation	antikoagulation
Antioxidanten	antioxidanter
Aortabogen	aortabågen
Aortenklappe	aortaklaff
Apex	apex
Apex-Lokator	apexlokalisator
Apherese	aferes
Apotheke	apotek
apothekenpflichtig	som endast säljs på apotek
Apparatemedizin	högteknologisk sjukvård
Appendicitis	blindtarmsinflammation
Appendix	appendix
Arbeitsmedizin	arbetsmedicin
Arbeitsunfall	olycksfall i arbetet
Arm	arm
Arm-Hals-Schlagader	arm-huvudstammen
Armbeuger	överarmsmuskel
Arnika	slåtterfibbla
arrythmie	arytmi
Arterie	artär
arterielles Blut	arteriellt blod
Arthritis	artrit, ledgångsinflammation
Arthrose	artros
Arzneibuch	farmakopé
Arzneiform	läkemedelsform
Arzneimittel	läkemedel
arzneimittelabhängig	läkemedelsberoende
Arzneimittelabhängigkeit	läkemedelsberoende
arzneimittelähnliche Produkte	läkemedelsliknande produkter
Arzt für Allgemeinmedizin	allmänläkare
Arzthelferin	mottagningssköterska
Arztpraxis	läkarpraktik
Asbestose	asbestos
aseptisk	steril
Asthma	astma
Asthmatiker	astmatiker
Atembeschwerden	andningsstörningar
Atemnot	andnöd
Atemorgane	andningsorgan
Atemstörungen	andningsstörningar
Atemstillstand	andningsstillestånd
Atemwege	luftvägar
Atemwegskrankheit	luftvägssjukdom
Atlas	atlaskota
Atmung	andning
Atmungsorgane	andningsorgan
auf nüchternen Magen	på fastande mage
aufgedunsen	uppsvälld
Aufklärungsformular	informationsformulär
Aufpumpzeit	inflationstid
Aufputschmittel	stimulansmedel
aufsteigende Aorta	uppåtstigande aorta
Augapfel	ögonglob
Auge	öga
Augenarzt	ögonläkare
Augenbinde	ögonbindel, lapp för ögat
Augenbraue	ögonbryn
Augenbrennen	ögonsveda
Augendeckel	ögonlock
Augendruck	ögontryck
Augenentzündung	ögoninflammation
Augenfarbe	färg på ögonen
Augenfältchen	rynkor kring ögonen
Augenfehler	synfel
Augenhöhle	ögonhåla
Augenheilkunde	oftalmologi, oftalmiatrik
Augenklappe	lapp för ögat
Augenklinik	ögonklinik
Augenkrankheit	ögonsjukdom
Augenkrankheit	ögonsjukdom
Augenlicht	syn
Augenlid	ögonlock
Augenlid	ögonlock
Augenmuskel	ögonmuskel
Augenmuskel	ögonmuskel
Augennerv	synnerv
Augenrötung	rodnande ögon
Augenringmuskel	ögats ringmuskel
Augensand	ögongrus
Augentropfen	ögondroppar
Augenwimpern	ögonfransar
Augenwimpern	ögonfransar
Augenzahn	hörntand, ögontand
ausatmen	andas ut
Ausbreitung	spridning, utbredning
ausdünsten	utsöndra
ausheilen	bota fullständigt
Ausschabung	skrapning
ausschwitzen	svetta ut, avsöndra
ausspülen	spola ur
Autismus	autism
autoklavieren	autoklavera
Autophobie	autofobi
Avitaminose	avitaminos
Avocadoöl	avokadoolja
äußere Drosselvene	yttre halsven
örtliche Betäubung	lokalbedövning
ösophageal	esofageal
übergewichtig	överviktig
übernächtigt	utvakad
Übelkeit	illamående
Überfunktion	hyperfunktion
Übergewicht	övervikt
Überversorgung	överdrivet näringsintag
Ärztekammer	läkarsällskap
Babynahrung	barnmat
Babyspeck	babyhull
Backenzahn	kindtand
Bakterie	bakterie
Bakterienherd	bakteriehärd
Bakteriologe	bakteriolog
bakteriologisch	bakteriologisk
Balanitis	balanit
Balken	hjärnbalk
Band	ledband
Bandinsuffizienz	bandinsufficiens
Bandscheibe	disk
Bandscheibenvorfall	diskbråck
Bandscheibenvorwölbung	diskprotrusion
Bange	oro, rädsla
Barodontalgie	barodontalgi
Bauch	buk, mage
Bauchfellentzündung	bukhinneinflammation
Bauchhöhle	bukhåla
Bauchhöhlenschwangerschaft	utomkvedshavandeskap
Bauchkneifen	magknip
Bauchkrämpfe	magkramp
Bauchmuskel	bukmuskel
Bauchnabel	navel
Bauchpelotte	abdominalpelott
Bauchschmerzen	magsmärtor, gastralgi
Bauchspeicheldrüse	bukspottkörtel
Bauschmuskel	skulderbladshöjare
Bazillenfurcht	bacillskräck
Bazillenträger	smittbärare
Bazillus	bacill
Bazillus	bacill
Bäckerekzem	bagareksem
Bänderriss	ledbandsruptur
Bänderzerrung	ledbandsskada
BCG-Schutzimpfung	calmettevaccination
Beatmungsgerät	respirator
Becken	bäcken
Beckengurt	bäckenband
Beckenknochen	bäckenben
bedingt arbeitsfähig	partiellt arbetsför
bedrückt	nedstämd
Befund	undersökningsresultat
beginnende Fehlgeburt	begynnande missfall
Begleiterkrankung	följdsjukdom
Begleiterscheinung	följdsymptom
Begleitverletzungen	följdskador
Behandlungszimmer	behandlingsrum
behäbig	korpulent
Beinahe-Todesereignis, ALTE	ALTE
Beinbruch	benbrott
Beipackzettel	bipacksedel
belebend	stimulerande
Bereitschaft haben	ha jourtjänstgöring
Bereitschaftsarzt	jourläkare
Bereitschaftsdienst	jour
beruhigend	lugnande
Beruhigungsmittel	lugnande medel
Beruhigungsspritze	lugnande spruta
beschneiden	omskära
beschnitten	omskuren
Bestrahlung	strålning
Betäubungsmittel	narkotika
Bettnässer	sängvätare
Bewegungsartefakte	rörelseartefakter
bewusstlos	medvetslös
Bewusstlosigkeit	medvetslösenhet
Bewusstsein	medvetande
Bibliomanie	bibliomani
Bindegewebe	bindväv
Bindehaut	bindhinna
Bindehautentzündung	bindhinneinflammation
Bindehautsack	bindhinnepåse
Biochemie	biokemi
Biokompatibilität	biokompatibilitet
Bittermittel	bittermedel
Bizeps	biceps
Blähungen	väderspänning
bleich	blek
Blennophobie	blennofobi
blind	blind
Blinddarm	blindtarm
Blut	blod
Blutandrang	blodkongestion, blodsvall
Blutarmut	anemi, blodbrist
Blutauge	hemoftalmus
Blutausstrich	blodutstryk
Blutbild	blodbild
Blutdruck	blodtryck
Blutdruckabfall	blodtrycksfall
Blutdruckamplitude	blodstrycksamplitud
Blutdruckmessung, BDM	blodtrycksmätning, BTM
Blutdruckmonitor	blodtrycksmonitor
Blutdruckparameter	blodtrycksvärde
Bluteiweißstoffe	plasmaproteiner
Blutentnahme	blodtagning
Bluterbrechen	hematemes, blodkräkning
Bluterguss	hematom, blodutgjutning
Blutersatzlösung	blodersättning
Blutgefäß	blodkärl
Blutgerinnung	koagulation
Blutgerinnungsanomalien	koagulationsavvikelser
Blutgruppe	blodgrupp
Bluthusten	blodhosta
Blutkrebs	leukemi, blodcancer
Blutkreislauf	blodomlopp
Blutkuchen	blodkaka, blodcruor, blodkrusta
Blutprobe	blodprov
Blutschande	incest, blodskam
Blutschädigung	blodskador
Blutserum	blodvatten, blodserum
Blutspender	blodgivare
Blutspender	blodgivare
Blutströmung	blodflöde
Bluttransfusion	blodtransfusion
Blutungen	blödningar
Blutuntersuchung	blodprov
Blutverdünnungsmittel	blodförtunnande läkemedel
Blutvergiftung	blodförgiftning
Blutwäsche	blodtvätt
Bockhartsche Krankheit	Bockharts follikulära impetigo
Bogengang	båggång
Botenstoffe	neurotransmittorer
Brücke	brygga
Brechreiz	kväljningar, illamående
Bronchen	bronker
Bronchospasmus	bronkospasm
Bruch	brock
Brustbein	bröstben
Brustbeklemmung	trånghet i bröstet
Brustenge	trånghet i bröstet
Brustwirbel	bröstkota
Brustwirbelsäule, BWS	bröstryggrad
Bursitis	bursit
cerebrovaskulär	cerebrovaskulär
Chefarzt	överläkare
Chemotherapie	kemoterapi
Chirurg	kirurg
Chirurgie	kirurgi
Cholesterin	kolesterol
Contergankind	neurosedynbarn
Daknomanie	sjuklig böjelse att bita eller döda
Dakryoadenitis	dakryoadenit
Daktylitis	daktylit
Damenbart	skäggväxt på kvinna
Damm	perineum
Dampfdesinfektion	ångdesinfektion
Darm	tarm
Darmbeinkamm	höftbenskam
Darmgrippe	maginfluensa
Darmkrebs	cancer i tarmen
Darmpassage	passagen genom tarmen
Darmpech	barnbeck
Darmverschluss	tarmstopp
Darmzotten	tarmludd
Darreichungsform	läkemedelsform
Dauermüdigkeit	kronisk trötthet, ihållande trötthet
Daumen	tumme
Daumenballen	tummens förlängning in i handflatan
Dämmerattacke	psykomotoriskt anfall
Dünndarm	tunntarm
Debilität	debilitet
Decoctum	dekokt
decrepitus	svag, orkeslös
defibrillationsgeschützt	defibrillationsskyddad
Defloration	deflorering
Deglutition	deglutition
Dehnungsreflex	sträckreflex
Dehydration	dehydrering
Dehydration	dehydrering
Dekontamination	dekontaminering
Deltamuskel	deltamuskel
Dengue-Fieber	denguefeber
Dentalphobie	tandläkarskräck
Dentophobie	dentofobi
Dermatitis	dermatit
Dermatologe	dermatolog
Dermatologie	dermatologi
Diabetes	diabetes
Diabetiker	diabetiker
diabetischer Fuß	diabetesfot
Diabetologie	diabetologi
Dialyse	dialys
Dialysebehandlung	dialysbehandling
Dialysegerät	dialysmaskin
Diaphragma	diafragma
Diastole	diastole
diastolisch	diastolisk
diastolisch	diastolisk
Dickdarm	tjocktarm
Dickdarm	tjocktarm
Diuretikum	diuretikum
Doppelwertigkeit	ambivalens
Dorsalflexion	dorsalflexion
Dosis	dos
Draht	tråd, sutur
Drüse	körtel
Drei-Tage-Fieber	tredagarsfeber
Drillinge	trillingar
drohende Fehlgeburt	hotande missfall
Dromomanie	dromomani
Druckgefühl	tryckande känsla
Druckkanüle	tryckkanyl
durchblutend	blodcirkulerande
Durchblutung	blodcirkulation
Durchblutungsstörung	rubbningar i blodcirkulationen
Durchfall	diarré
durchschnittliche Lebensdauer	medellivslängd
Dyslipoproteinämie	dyslipoproteinemi
Eierstock	äggstock
eineiige Zwillinge	enäggstvillingar
einen Vogel haben	vara knäpp i skallen
eingewachsene Nägel haben	nageltrång
Einlauf	lavemang
Einmalkittel	engångsförkläde
Einnahme	intagning
Eintauchdesinfektion	doppdesinfektion
Einzelstümpfe	enstaka tandstumpar
Einzelstümpfe	enstaka tandstumpar
Eiweiß	äggvita, protein
Ektokardie	hjärtbråck
Ekzem	eksem
Elektrolytverlust	elektrolytförlust
Elektrophorese	elektrofores
Ellbogen	armbåge
Elle	armbågsben
Ellenbogenluxation	armbågsluxation
emulsionsstabilisierend	emulsionsstabiliserande
Endglied	yttre fingerben, distalfalang
Endodontie	endodonti
Endokrinologie	endokrinologi
entbinden	förlösa
Entbindung	förlossning
Entbindung	förlossning
Entbindungsklinik	förlossningsklinik
Entbindungsstation	förlossningsavdelning
Entsättigungsphase	desaturationsperiod
Entspannung	avslappning
Entspannungsübung	avslappningsövning
entzünden	inflammera
entzündlich	inflammatorisk
Entzündung	inflammation
entzündungshemmend	inflammationshämmande
entzündungshemmend	inflammationshämmande
Entziehungskur	avvänjningskur
Entzug	avvänjningskur
Entzugserscheinung	abstinenssymptom
Epidemie	epidemi
Epilepsie	epilepsi
epileptisch	epileptisk
Erbgut	arvsmassa
erbgutverändernd	mutagen
Erbrechen	kräkningar
Ergotherapie	ergoterapi
Erholung	rekreation, vila
erholungsbedürftig	i behov av rekreation
Erholungsheim	konvalescenthem, vilohem
erkältet	förkyld
Erkältung	förkylning
Ernährung	nutrition
Ernährungsberater	nutritionsrådgivare
Ernährungsberatung	nutritionsrådgivning
ernst	allvarligt
Erotomanie	erotomani
Erreger	smittämnen
erwärmend	värmande
Erziehungsberechtigter	målsman
ESRD, End Stage Renal Disease	terminal njursjukdom
Fachklinik	specialistsjukhus
faktitiell	faktitiell
faktitielles Fieber	faktitiell feber
Familienplanung	familjeplanering
Famulatur	famulatur
Fangopackung	lerinpackning
farbenblind	färgblind
Farbenblindheit	färgblindhet
fasten	fasta
Fastenkur	fastekur
Fötus	foster
Fehldiagnose	feldiagnos
Fehlgeburt	missfall
Fehlurteil	felbedömning
Feigwarze	kondylom
Feldlazarett	fältsjukhus
Femurkopf	lårbenshuvud
Fencheltee	fänkålste
Ferse	häl
Fersenbein	hälben
Fersenkeile	hälkilar
Fettgewebe	fettvävnad
Fettstoffwechsel	fettämnesomsättning
Fetus	foster
Feuchtigkeitsregulierung	fuktighetsreglering
feuchtigkeitsspendend	fuktighetsgivande
Feuermal	eldsmärke
fibular	fibulär
Fieber	feber
Fieberanfall	feberanfall
fieberfrei	feberfri
fieberhaft	med feber
Fieberkurve	feberkurva
Fiebermittel	febernedsättande medel
fiebern	vara febrig
fiebersenkend	febersänkande
Fieberthermometer	febertermometer
fiebrig	febrig
filmbildend	filmbildande
Finger	finger
Fingerbeere	fingerblomma
Fingernagel	fingernagel
Fingerspitze	fingertopp
Fischallergie	fiskallergi
Fistel	fistel
Fistelstimme	falsettröst
Flagellomanie	flagellomani
Flaum	fjun
Fleckfieber	fläcktyfus
Fleischvergiftung	förgiftning av kött
Folgeerscheinung	efterverkning
Fontanelle	fontanell
Forensik	forensisk medicin
fortpflanzungsgefährdend	reproduktionstoxisk
Frauenheilkunde	gynekologi
Frauenklinik	kvinnoklinik
Frühchen	för tidigt fött barn
Früherkennung	tidig upptäckt el. diagnos
Frühgeborenenstation	prematuravdelning
Frühgeburt	för tidig födsel
freie Rippe	falskt revben
Fremdkörperzange	alligatortång
Froschaugen	utstående ögon, glosögon
fruchtschädigend	fosterskadande
Fruchtwasser	fostervatten
Fruchtwasserprobe	fostervattensprov
Fußbad	fotbad
Fußgelenk	fotled
Fußgeruch	fotlukt
fußkrank	med dåliga fötter
Fußleiden	ont i fötterna
Fußmykose	fotsvamp
Fußpflege	fotvård
Fußpfleger	fotvårdare
Fußschweiß	fotsvett
Fußsohle	fotsula
Fußsohlenreflex	fotsulereflex
Fußsohlenreflex	plantarreflex
Fußspitze	fotspets
Fußwurzel	fotvrist
Fußwurzelknochen	fotrot
Fungämie	fungemi
Furunkel	furunkel, böld
Fusidinsäure	fusidinsyra
Gallenblase	gallblåsa
Gallenblasenentzündung	inflammation i gallblåsan
Gallensteine	gallsten
Gallert	gelatin
Gamophobie	gamofobi
Gastritis	magkatarr, gastrit
Gastroenteritis	magsjuka
Gastroenteritis	gastroenterit
Gastroenterologie	gastroenterologi
Gaumen	gom
Gaumenzapfen	gomspene
Gaumenzäpfchen	gomspene
Gaze	gasbinda
Gürtelrose	bältros
Geäder	ådernät
geädert	ådrig
gebären	föda
Gebärmutter	livmoder
Gebärmutterkrebs	livmodercancer
Gebärmuttervorfall	livmoderframfall
Geburt	födsel
Geburtenkontroll	födelsekontroll
Geburtenrate	nativitet
Geburtenregelung	födelsekontroll
Geburtshilfe	obstretrik
Gedächtnis	minne
Gedächtnis	minne
Gedächtnislücke	minneslucka
Gedächtnisschwund	minnesförlust
Gedächtnisstörung	minnesstörning
Gefäßchirurgie	vaskulärkirurgi
Gefühl	känsla
gefühllos	okänslig
Gefühllosigkeit	okänslighet, känslolöshet
gefühlsarm	känslokall, kylig
Gefühlsausbruch	känsloutbrott
gefühlsbetont	känslomässig
Gefühlsmensch	känslomänniska
Gefühlsregung	sinnesrörelse
Gegengift	motgift
Gegenleiste	antihelix
Gehör	hörsel, gehör
Gehörfehler	hörselskada
Gehörgang	hörselgång
Gehörknöchelchen	hörselben
gehörlos	döv
Gehörverlust	nedsatt hörsel
Gehirn	hjärna
Gehirnblutung	hjärnblödning
Gehirnerschütterung	hjärnskakning
Gehirnhaut	hjärnhinna
Gehirnhautentzündung	hjärnhinneinflammation
Gehirntumor	hjärntumör
Gehstützen	gåstöd
geistesabwesend	tankspridd
Geistesgegenwart	sinnesnärvaro
geistesgestört	sinnesförvirrad
geisteskrank	sinnessjuk, mentalsjuk
Geistesschwäche	förståndshandikapp
Geistesverwirrung	sinnesförvirring
Geisteszustand	mentalt tillstånd
geistig	mental, själslig
gelähmt	förlamad
Gelähmter	lam person
Gelbsucht	gulsot
Gelenk	led
Gelenkhöcker	ledhuvudsutskott, epikondyl
Gelenkschiene	ledskena
Genesung	konvalescens, tillfriskande
Genesungsheim	konvalescenthem
Genetik	ärftlighetslära, genetik
Genick	nacke
Genickstarre	nackspärr
Gentechnik	genteknik
Gentechnologie	genteknologi
Genusssucht	njutningsbegär
gereizt	irriterad
Gereiztheit	irritation
Geriatrie	geriatrik
Gerichtsmedizin	rättsmedicin
Gerichtsmediziner	rättsläkare
gerichtsmedizinisch	rättsmedicinsk
gerinnen	koagulera, levra sig
Gerinnsel	blodpropp
Gerinnungssystem	koagulationssystem
Gerstenkorn	vagel
Geruch	luktsinne; lukt
geruchlos	luktfri
Geruchssinn	luktsinne
Gesäß	bakdel, ända
Geschlecht	kön
geschlechtlich	sexuell, köns-
geschlechtlicher Verkehr	sexuellt umgänge
Geschlechtlichkeit	sexualitet
geschlechtskrank	som lider av könssjukdom
Geschlechtskrankheit	venerisk sjukdom
Geschlechtsleben	sexualliv
Geschlechtsorgan	könsorgan
geschlechtsreif	könsmogen
geschlechtsspezifisch	könsbunden
Geschlechtsteile	könsdelar
Geschlechtstrieb	sexualdrift
Geschlechtsverkehr	sexuellt umgänge
Geschmack	smak
Geschmackssinn	smaksinne
geschmeidig machend	uppmjukande
Geschwür	bulnad, böld
Geschwulst	svullnad, svulst
Gesicht	ansikte
Gesichtsausdruck	ansiktsuttryck
Gesichtsfarbe	ansiktsfärg
Gesichtsfeld	synfält
Gesichtszüge	anletsdrag, ansiktsdrag
Gestammel	stammande
Gestotter	stammande
Gesundheit	hälsa
gesundheitlich	hälso-, hygienisk, sanitär
gesundheitshalber	av hälsoskäl
Gesundheitspflege	hälsovård
gesundheitsschädlich	hälsovådlig, hälsofarlig
Gesundheitswesen	hälso- och sjukvård
Gesundheitszeugnis	friskintyg
Gesundheitszustand	hälsotillstånd
gesundschreiben	friskskriva
Gesundung	tillfriskande
Gewölbekörper	hjärnvalv
Gewebe	vävnad
Gewebeprobe	vävnadsprov
Gewicht	vikt
Gewichtsprobleme	viktproblem
Gewichtsverlust	viktförlust
Gewissen	samvete
Gewissensbisse	samvetskval
Gewissensgründe	samvetsskäl
Gewissenskonflikt	samvetskonflikt
Gips	gips
Gipsbein	gipsat ben
Gipsverband	gipsbandage, gipsförband
Glasauge	emaljöga
Glatze	flint, kal hjässa
glatzköpfig	flintskallig
glättend	utjämnande
Gleichgewicht	balans
Gleichgewichtsstörungen	balansrubbningar
Gleichmut	jämnmod
Gleitmittel	glidmedel
Glied	led
Gliedmaßen	lemmar
Glotzaugen	utstående ögon
Gonarthrose	knäledsartros
Gonarthrose	gonartros
grassieren	härja, grassera
grau meliert	gråsprängd
grauer Star	grå starr
Größe	kroppslängd
Größenwahn	storhetsvansinne
grüner Star	grön starr
greisenhaft	senil
griesgrämig	vresig, butter
Grippe	influensa
Grippewelle	influensaepidemie
großer Brustmuskel	stor bröstmuskel
großer Gesäßmuskel	stor sätesmuskel
großer Rundmuskel	musculus teres major
Großhirn	stora hjärnan
Grundglied	inre fingerben, proximalfalang
gutartig	godartad
Gynäkologe	gynekolog
Gynäkologie	gynekologi
gynäkologisch	gynekologisk
Haar	hårstrå
Haaransatz	hårfäste
Haaraufrichter	hårresarmuskel
Haarausfall	håravfall
Haarentferner	hårborttagningsmedel
Haarersatz	peruk
haarfärbend	hårfärgande
Haarspitzen	hårtoppar
Haarwuchs	hårväxt
Haftschale	kontaktlins
Hagebuttenkern	nyponfrön
Halbbruder	halvbror
Halbgeschwister	halvsyskon
Halbschwester	halvsyster
Halbwaise	barn som förlorat en förälder
Halluzination	hallucination
halluzinieren	hallucinera
Hals	hals
Hals-Nasen-Ohren-Arzt, HNO-Arzt	öron-näsa-halsläkare
Hals-Nasen-Ohren-Heilkunde	ÖNH
Halsentzündung	halsfluss
Halsentzündung	faryngit
Halskrause	halskrås
Halsschlagader	halspulsåder
Halsschmerzen	halsont
Halswirbel	halskota
Hammer	hammare
Handbeuger der Ellenseite	ulnar handrotsböjare
Handfläche	handflata
Handgelenk	handled
Handknöchel	handknogar
Handrücken	handrygg
Handschiene	handskena
Handwurzelknochen	handrot
harmlos	ej allvarligt
Harn	urin
Harnblase	urinblåsa
Harnstoff	urea
harntreibend	urindrivande
Hasenscharte	läppspalt
Hausarzt	husläkare
Hausärztin	kvinnlig husläkare
Hausbesuch	hembesök
Hauspflege	hemvård
Hauspotheke	medicinskåp (i hemmet)
Haut	hud, skinn
Hautabschürfung	skrubbsår
Hautarzt	hudläkare
Hautausschlag	hudutslag
Hautcreme	hudkräm
Hautkrankheit	hudsjukdom
Hautkrebs	hudcancer
Hautpflege	hudvård
hautpflegende	hudkonditionerande
Hautpilz	hudsvamp
Hautrötung	hudrodnad
Hautrezorption	hudresorption
hautschützende	hudskyddande
Hauttransplantation	hudtransplantation
Hauttyp	hudtyp
Hämatologie	hematologi
Hämatom	blodutgjutning
Hämodialyse	hemodialys
Hämoglobin	hemoglobin, blodfärgämne
Hämorrhoiden	hemorrojder
Hängebacken	påsiga kinder
Hängebauch	hängbuk
Hängebusen	hängbröst
Häutchen	tunn hinna
Hörbehinderter	hörselskadad
Hörfehler	hörfel
Hörgerät	hörapparat
Hörnerv	hörselnerv
Hörprüfung	hörselprov
Hörrohr	stetoskop
Hörschaden	hörselskada
Hörvermögen	hörselförmåga
Hörzellen	hörceller
Hühnerauge	liktorn
hüsteln	hosta lätt
Hebamme	barnmorska
Heilanstalt	sjukhem
Heilkraut	medicinalväxt
Heilmittel	botemedel
Heilpraktiker	naturläkare
Heilung	läkning
Heilungsprozess	läkningsprocess
Heimdialyse	hemdialys
heiser	hes
Heiserkeit	heshet
Heparin	heparin
Heparingabe	heparindos
Hepatitis	hepatit
Herz	hjärta
Herz-Lungen-Maschine	hjärt-lungmaskin
Herzaneurysma	hjärtaneurysm
Herzasthma	hjärtastma
Herzbeschwerden	hjärtbesvär
Herzbeutel	hjärtsäck
Herzbeutel	hjärtsäcken
Herzchirurgie	hjärtkirurgi
Herzerkrankung	hjärtsjukdom
Herzfehler	hjärtfel
Herzflimmern	hjärtflimmer
Herzfrequenz	hjärtfrekvens
Herzinfarkt	hjärtinfarkt
Herzinsuffienz	hjärtinsufficiens
Herzkammer	hjärtkammare
Herzklopfen	hjärtklappning
Herzkrankgefäß	kranskärl
Herzkranzfurche	kransfåra
Herzkreislaufsystem	hjärtcirkulationssystem
Herzmassage	hjärtmassage
Herzrhythmusstörung	hjärtrytmrubbning
Herzschlag	hjärtslag
Herzschrittmacher	pacemaker
Herzschwäche	hjärtsvikt
Herzspitze	hjärtspetsen
Herzstillstand	hjärtstillestånd
Herztransplantation	hjärttransplantation
Herztumor	hjärttumör
Herzversagen	hjärtstillestånd
Herzversagen	hjärtsvikt
Herzvolumen	hjärtvolym
Heuschnupfen	hösnuva
Hexenschuss	ryggskott
Hiatus	hiatus
Hiatusinsuffienz	hiatusinsuffiens
Hidroa	hydroa
Hilfeleistung	hjälp, t ex första hjälpen
Hinterhauptbein	nackben
Hinterhauptmuskel	nackmuskel
Hinterkopf	bakhuvud
Hippopotomonstrosesquippedaliophobie	hippopotomonstrosesquippedaliofobi
Hirnanhangsdrüse	hypofys
Hitzebläschen	värmeutslag
HNO-Klinik	öron-näsa-hals-klinik
Hoden	testikel
Hodenbruch	pungbråck
Hodensack	pung
Hohlkreuz	svankrygg
holosystolisch	holosystolisk
Homöopath	homeopat
Homöopathie	homeopati
homöopathisch	homeopatisk
homophil	homosexuell
hormonal	hormonell
Horngeschwulst	horntumör
Hornhaut	hornhinna
Hornhaut	hornhud
Hornschicht	hornlager
humanpathogen	humanpatogen
Humeruskopf	överarmsbenshuvud
Humeruskopf	ledhuvud
humpeln	linka
Husten	hosta
Hustenanfall	hostattack
Hustenbonbon	halstablett
Hustenreiz	rethosta
Hydrargyrie	hydrargyros
Hydrämie	hydremi
Hydrolyse	hydrolys
Hydrophobie	hydrofobi
Hydrozele	vattenbråck, hydrocele
Hydrozelektomie	hydrocelektomi, borttagning av vattenbråck
hyper	hyper
Hypercholesterinämie	hyperkolesterolemi
Hypergiaphobie	hypergiafobi
Hyperoxie	syrgasförgiftning
Hyperoxie	hyperoxi
Hypnose	hypnos
hypnotisierien	hypnotisera
hypo	hypo
Hypoadrenalismus	binjureinsufficiens
Hypoalimentation	undernäring
Hypochlorämie	hypokloremi
Hypochonder	hypokondriker
hypochondrisch	hypokondrisk
Hypoglykemie	hypoglykemi
Hypokalzämie	hypokalcemi
Hypophyse	hypofys
Hyporeflexie	hyporeflexi
Hypothermie	hypotermi
Hypothermiesystem	hypotermisystem
Hypothonie	hypotoni
Hysterie	hysteri
hysterisch	hysterisk
Idiokrasie	idiosynkrasi
Idiosynkrasie	idiosynkrasi
Ilio-Sakral-Gelenk	sakroiliakaleden
Immobilisation	immobilisering
Immunität	immunitet
Immunsystem	immunsystem
Immunsystem	immunförsvar
Impfausweis	vaccineringskort
impfen	vaccinera
Impfmal	vaccinationsärr
Impfschein	vaccinationsbevis
Impfstoff	vaccin
Impfung	vaccinering
Impfzwang	vaccinationsplikt
Implantat	implantat
Importkrankheit	importsjukdom
impotent	impotent
Impotenz	impotens
In Utero	in utero
In-Vitro-Test	in vitro-test
In-Vivo-Test	in vitro-test
Inappetenz	inappetens
Indikation	indikation
Indolenz	indolens
induzieren	framkalla
Infarkt	infarkt
Infekt	infektion
infektiös	infektiös
Infektion	infektion
Infektionsabwehr	infektionsförsvar
Infektionsgefahr	smittorisk
Infektionsherd	infektionshärd
Infektionskrankheit	infektionssjukdom
Infektionsträger	infektionsbärare
Infektionsträger	smittbärare
infertil	infertil
infizieren	infektera
infizieren	smitta
inflexibel	inflexibel
Influenza	influensa
infraorbital	infraorbital
infrapatellar	infrapatellar
Infusion	infusion
Infusionsbesteck	infusionssats
Infusionsflasche	infusionsflaska
Inhalation	inhalation
inhalieren	inhalera
inhibieren	inhibera
Initialdosis	initialdos
Injektion	injektion
Injektionsnadel	injektionsnål
Injektionsspritze	injektionsspruta
injizieren	injicera
inkomplette Fehlgeburt	ofullständigt missfall
Inkontinenz	inkontinens
Inkubationszeit	inkubationstid
Inkubator	kuvös
inkurabel	inkurabel
Innenohr	inneröra
innere Medizin	invärtesmedicin
inoperabel	inoperabel
Insektenstich	insektsbett
Insuffizienz	insufficiens
Insulin	insulin
Insulinantikörper	insulinantikropp
Insulinkoma	insulinkoma
Insulinschock	insulinchock
Intelligenzquotient, IQ	intelligenskvot, IQ
Intelligenztest	intelligenstest
Intensivpflege	intensivvård
Intensivstation	intensivvårdsavdelning
Intentionstrema	intentionstremor
interalveolär	interalveolär
intercostalis	intercostalis
interdigital	interdigital
Interferon	interferon
Interkuspidation	interkuspidation
intern	invärtes
Internist	internist, invärtesläkare
internistische Untersuchung	invärtes undersökning
Intimbereich	underliv
Intimbereich	privatliv
Intimhygiene	intimhygien
Intimspray	intimspray
Intimverkehr	sexuellt umgänge
intraabdominal	intraabdominell
intradermal	intradermal
intraokulär	intraokulär
intraperitoneal	intraperitoneal
intravenös	intravenös
intrezerebral	intracerebral
Intubierung	intubation
Inulin	inulin
Invalide	invalid
Invalidität	invaliditet
invasiv	invasiv
irre	sinnessjuk
Irrenhaus	dårhus
Irrglaube	vanföreställning
Irrsinn	sinnesrubbning, vansinne
Ischias	ischias
Jähzorn	vrede, ilska
jähzornig	argsint
Jenseits	livet efter döden
Jochbein	okben
Jochbein	kindknota
Juckreiz	klåda, eksem
Juveniler Morbus Scheuermann	Scheuermanns sjukdom
Körperbehaarung	kroppshår
kahl	skallig
Kahlkopf	flint
Kamille	kamomill
Kamillentee	kamomillte
Kammerscheidewand	kammarskiljevägg
Kampfer	kamfer
Kanüle	kanyl
Kapillargefäß	kapillärkärl
Kapuzenmuskel	kappmuskel
Kardiogramm	kardiogram
Kardiologie	kardiologi
kariös	kariös
Karies	karies
karzinogen	karcinogen
Kasse	sjukkassa
Kassenpatient	person som är medlem i allmän sjukkassa
Katarr	katarr
Katheter	kateter
kauen	tugga
Kaufläche	tuggyta
Kaufzwang	köptvång
Kaumuskel	tuggmuskel
Kauwerkzeuge	tuggapparat
Kauwiderstand	tuggmotstånd
Körper	kropp
körperbehindert	handikappad
Körperbeschaffenheit	kroppskonstitution
Körperfülle	korpulens, fetma
Körperflüssigkeiten	kroppsvätskor
Körpergewicht	kroppsvikt
Körpergröße	kroppsstorlek
Körperhaltung	kroppsställning
Körperkraft	kroppsstyrka
körperlich	kroppslig
körperlos	okroppslig
Körpermaße	kroppsmått
Körperpflege	kroppsvård
Körperteil	kroppsdel
Körperverletzung	kroppsskada
Körperwärme	kroppsvärme
kühlend	kylande
künstliche Beatmung	konstgjord andning
Kürette	skrapa
Küvette	kuvette
Kehldeckel	struplock
Kehle	strupe
Kehlkopf	struphuvud
Kehlkopfentzündung	struphuvudsinflammation
Kehlkopfkrebs	strupcancer
Keimdrüse	könskörtel
Keime	baciller
keimfrei	steril
keimtötend	antiseptisk
kerngesund	frisk som en nötkärna
Kerntemperatur	kärntemperatur
Keuchen	flämtande
Keuchhusten	kikhosta
Kieferhöhle	käkhåla
Kindbettfieber	barnsängsfeber
Kinderarzt	barnläkare
Kinderchirurgie	barnkirurgi
Kinderkrankheit	barnsjukdom
Kinderlähmung	barnförlamning
kinderlos	barnlös
Kinderlosigkeit	barnlöshet
Kinderpflege	barnvård
kinderreich	barnrik
kinderreich	barnrik
Kinderschwester	barnsjuksköterska
Kindersterblichkeit	barnadödlighet
Kindesmissbrauch	övergrepp mot barn
Kindesmisshandlung	barnmisshandel
kindgemäß	barnanpassad
Kindheit	barndom
Kinn	haka
Kinnbacke	käkben, käke
Kinnlade	underkäke
Kitzler	clitoris
Klapsmühle	dårhus
Klaustrophobie	klaustrofobi
kleiner Rundmuskel	musculus teres minor
Kleinhirn	lillhjärnan
Kleptomane	kleptoman
Kleptomanie	kleptomani
Klimakterium	klimakterium
Klinik	klinik
klinische Verfassung	kliniskt tillstånd
Klumpfuß	klumpfot
Knie	knä
Knieachse	knäaxel
Kniegelenk	knäled
Kniekehle	knäveck
Kniescheibe	knäskål
Kniestulpe	knämanschett
Knöchel	fotknöl, knä, knoge
Knochen	ben
Knochenbau	benbyggnad
Knochenbildung	benbildning
Knochenbruch	fraktur, benbrott
Knochenfraß	benröta
Knochengerüst	benstomme, skelett
Knochenhaut	benhinna
Knochenkrebs	skelettcancer
Knochenmark	benmärg
Knochensplitter	benflisa
Knorpel	brosk
knorplig	broskartad
Knorrenmuskel	armbågssträckare
Knoten	knuta
koagulieren	koagulera
Kohlenmonoxydvergiftung	koloxidförgiftning
Koitus	samlag
Kolik	kolik
Koma	koma
Komplementsystem	komplementsystem
Komplex	komplex
Komplikation	komplikation
Kompresse	kompress
Koncha	öronmussla
Kondom	kondom
Kondylom	kondylom
kongenital	medfött
Konjunktivitis	bindhinnekatarr
Konstitution	kroppsbyggnad
Kontraindikation	kontraindikation
Kontrastmittel	kontrastmedel
Kopfnicker	stor nickmuskel
Kopfschmerzen	huvudvärk
korpulent	fetlagd
Korpulenz	fetma
kosmetischer Farbstoff	kosmetiskt färgämne
kotzübel	mycket illamående
kotzen	spy
Kräfteverfall	avtagande fysisk förmåga
Krähenfüße	rynkor vid ögonen
Krüppel	invalid
Krampfadern	åderbrock
Krampfanfall	krampanfall
krank schreiben	sjukskriva
Krankenblatt	patientjournal
Krankenpflege	sjukvård
Krankenschein	sjukintyg
Krankheit	sjukdom
Krankheitserreger	sjukdomsalstrare
Krankheitserreger	smittämnen
kräftigend	uppfriskande
Kräftigungsmittel	stärkande medel
Krebs	cancer
krebsartig	cancerös
krebserregend	cancerframkallande, cancerogen
krebserzeugend	cancerframkallande
Krebsforschung	cancerforskning
Krebsfrüherkennung	tidig upptäckt av cancer
Krebsgeschwulst	cancertumör
Krebshilfe	cancerfond
Krebsknoten	cancerknöl
Krebskranker	cancersjuk
Krebszelle	cancercell
Kreißsaal	förlossningsrum
Kreislauf	cirkulation, blodomlopp
Kreislaufschock	cirkulationschock
Kreislaufschwäche	cirkulationsrubbning
Kreislaufstörungen	cirkulationsrubbning
Kreislaufversagen	chock
Kreuz	korsrygg
Kreuzbein	korsben
Kreuzschmerzen	smärtor i korsryggen
Kriegsinvalide	krigsinvalid
Kriegsverletzung	krigsskador
Kriegsversehrter	krigsinvalid
Kubitalvene	armbågsven
Kulminationspunkt	akme
kurzatmig	andfådd
kurzer Hohlhandmuskel	kort handflatemuskel
Kurzschlusshandlung	kortslutningshandling
kurzsichtig	närsynt
Kurzzeitgedächtnis	korttidsminne
Kyphose	kyfos
labil	labil
Labilität	labilitet
Lachgas	lustgas
Landarzt	(allmänpraktiserande) läkare på landsbygden
langer Hohlhandmuskel	handflatans långa muskel
langer Zehenstrecker	lång tåsträckarmuskel
Langzeit-Blutdruckmessung, LZBDM	ambulatorisk blodtrycksmätning, ABTM
Langzeitkranker	långtidssjuk
Langzeitversorgung	långtidsterapi
lateral	lateral
lateral Gonarthrose	lateral gonartros
Lähmung	förlamning
Lösung	lösning
Lebensangst	livsångest
lebensbedrohlich	livshotande
lebenserhaltendes Gerät	livsuppehållande utrustning
Lebenserhaltungsgerät	livsuppehållande utrustning
Lebenserwartung	medellivslängd
lebensmüde	suicidbenägen, trött på livet
Lebensmittelvergiftung	matförgiftning
Leber	lever
Leberatrophie	leveratrofi, leverförtvining
Leberfleck	leverfläck
Leberinsuffizienz	leverinsufficiens
Leberkoma	leverkoma
Leberkrebs	levercancer
Lebervene	leverven
Leberzirrhose	levercirros
Lederhaut	läderhud
Leib	liv, mage
Leibgürtel	maggördel
Leiche	lik
leicht verwundet	lätt sårad
Leistenbeuge	ljumske
Leistenbruch	ljumskbråck
Leistengegend	ljumske
Leistungsschwäche	försämrad prestationsförmåga
Lendenwirbel	korsrygg
Lendenwirbel	ländkota
Lendenwirbelsäule, LWS	ländryggrad
Lesebrille	läsglasögon
Leukozyten	vita blodkroppar
Lichtallergie	ljusallergi
Lichtbehandlung	ljusbehandling
Lichttherapie	ljusterapi
Lichttherapiegerät	ljusterapiapparat
Lidschlussreflex	ögonlocksreflex
lindernd	lugnande
linke gemeinsame Halsschlagader	vänster huvudartär
linke Herzkranzarterie	vänster kransartär
linke Schlüssenbeinschlagader	vänster nyckelbensartär
linke Vorkammer, LV	vänster förmak
linker Kammer	vänster kammare
linker Vorhof	vänster förmak
linkes Herzrohr	vänster hjärtöra
Lipoprotein	lipoprotein
Lipotrophie	lipotrofi
Luftablassgeschwindigkeit	deflationshastighet
Luftröhre	luftrör
Lumbago	ryggskott
Lunge	lunga
Lungenarterie	lungartären
Lungenarterienstamm	lungvenstam
Lungenödem	lungödem
Lungenblähung	lungemfysem
Lungenbläschen	lungblåsor
Lungenbläschen	alveoler
Lungenembolie	lungemboli
Lungenemphysem	lungemfysem
Lungenentzündung	lunginflammation
Lungenerkrankung	lungsjukdom
Lungenkrebs	lungcancer
Lungenkreislauf	lungkretsloppet
Lungenmilzbrand	lungmjältbrand
Lungenmittellappen	mellersta lunglob
Lungenunterlappen	nedre lunglob
Lunula	lunula
Lykantropie	lykantropi
lymphatisches System	lymfatiska systemet
Lymphe	lymfvätska
Lymphe	lymfa
Lymphozyten	lymfocyter
Lymphsystem	lymfsystemet
Lypemanie	lypemani
Magen	mage
Magen	mage
Magen	magsäck
Magen-Bypass	mag-bypass
Magenbeschwerden	magbesvär
Magenblutung	magblödning
Magengeschwür	magsår
magenkrank	ha besvär med magen
Magenkrebs	magcancer
Magensäure	magsyra
Magenschleimhaut	magslemhinna
Magenschleimhautentzündung	magkatarr
Magenschmerzen	magont
Magenverstimmung	matsmältningsbesvär
Magersucht	anorexi
Malaria	malaria
maligne	malign
malignes Melanom	malignt melanom
Mammographie	mammografi
Mandelentzündungen	halsfluss
Mandeloperation	operativ borttagning av halsmandlarna
Mangelerscheinung	bristsymptom
Mangelkrankheit	bristsjukdom
manisch	manisk
manisch-depressiv	manodepressiv
Manschette	manschett
Manschettendruck	manschettryck
Masern	mässling
Masochismus	masochism
Masochist	masochist
masochistisch	masochistisk
Massenpsychose	masspsykos
Männlichkeit	mandom
Müdigkeit	trötthet
mütterlicherseits	på mödernet
medial	medial
medial Gonarthrose	medial gonartros
Medizinprodukt	medicinprodukt
Megalomanie	megalomani
Meningitis	meningit
Meniskektomie	meniskektomi
Meniskus	menisk
Menstruation	menstruation, mens
Menstruationsbeschwerden	menstruationsbesvär
Menthol	mentol
Methämoglobinämie	methemoglobinemi
MIC	minimalinvasiv kirurgi
Mikrobiologie	mikrobiologi
Mikroinstrument	mikroinstrument
Milz	mjälte
minimal-invasive Chirurgie	minimalinvasiv kirurgi
Miosis	pupillförminskning
Miosis	mios
Missbrauch	missbruk
Missgeburt	missfoster
Mittelfußknochen	mellanfot
Mittelglied	mellanfalang
Mittelglied	mellersta fingerben, mellanfalang
Mittelhandknochen	mellanhand
Mobilität	rörlighet
Mongolenfleck	mongolfläck
Monomer	monomer
Morphium	morfin
Mumps	påssjuka
Mund	mun
Mundgeruch	dålig andedräkt
Mundhöhle	munhåla
Mundraum	munhåla
Mundspiegel	munspegel
Mundwasser	munvatten
Mundwinkel	mungipa
Muskel	muskel
Muskelabbau	muskelminskning
Muskelaufbau	muskelökning
Muskelkater	träningsvärk
Muskelkrampf	muskelkramp
Muskelzerrung	muskelsträckning
Muskulatur	muskulatur
muskuläres Ungleichgewicht	muskulär obalans
Mutterkuchen	moderkaka
Mutterleib	moderliv
Muttermal	födelsemärke
Muttermilch	modersmjölk
Muttermund	livmodermun
Mutterschaftsurlaub	mammaledighet
Mykoseprophylaxe	svampprofylax
Nabel	navel
Nabelschnur	navelsträng
Nachbehandlung	eftervård
Nachgeburt	efterbörd
Nachkömmling	sladdbarn
Nachkommenschaft	avkomma
Nachsorge	eftervård
nachtblind	nattblind
nachtwandeln	gå i sömnen
Nachtwandler	sömngångare
Nacken	nacke
Nackenwirbel	halskota
Nagelfalz	nagelfals
Nagelhaut	nagelband
Nagelkörper	hornplatta
Nagelmöndchen	lunula, måne
Nagelpflege	nagelvård
Nagelpilz	nagelsvamp
Nagelwurzel	nagelrot
Nahrung	näring
Nahrungsaufnahme	näringsupptagning
Naht	sutur
Narbe	ärr
narbig	ärrig
Narkose	narkos
Narkosearzt	narkosläkare
Narkoseschwester	narkossköterska
Narkotikum	narkosmedel
narkotische Wirkung	narkotisk effekt
Narzissmus	narcissism
Nase	näsa
Nasenbein	näsben
Nasenbluten	näsblod
Nasenflügel	näsvinge
Nasenhöhle	näshåla
Nasenloch	näsborre
Nasennebenhöhle	bihåla
Nasenrachenraum	nasopharynx
Nasenraum	näshåla
Nasenrücken	näsrygg
Nasenscheidewandknorpel	näsbrosk
Nasenspitze	nästipp
Nasentamponade	nästamponad
Nasenwurzel	näsrot
Naturheilkunde	naturmedicin
Naturheilkundiger	naturläkare
Naturheilkundler	naturläkare
Naturheilmittel	naturmedel
näseln	tala genom näsan
nässen	vätska sig
Nebenhöhlenentzündung	bihåleinflammation
Nebenniere	binjure
Nebenniereninsuffizienz	binjureinsufficiens
Nebenwirkungen	biverkningar
Neigungen	böjelser
Nephritis	njurinflammation
Nephrologie	nefrologi
Nerv	nerv
Nervenarzt	nervläkare
nervenkrank	nervsjuk
Nervenkrankheit	nervsjukdom
Nervenleiden	nervsjukdom
Nervensystem	nervsystem
Nervenzusammenbruch	nervsammanbrott
Nervenzusammenbruch	nervsammanbrott
Nesselfieber	nässelfeber
Netzhaut	näthinna
Netzhautdurchblutungsstörung	rubbningar i blodcirkulationen i näthinnan
Netzhautgefäße	näthinnekärl
Neuralgie	neuralgi
Neurologe	neurolog
neurologische Defizite	neurologiska bortfall
Neurose	neuros
Neurotiker	neurotiker
neutroisch	nevrotisk
nicht-invasiv	icke-invasiv
Niere	njure
Nierenagenesie	njuragenesi
Nierenbeckenentzündung	njurbäckeninflammation
Nierenentzündung	njurinflammation
Nierenexstirpation	nefrektomi
Nierenhyperplasie	njurhyperplasi
Nierenhypoplasie	njurhypoplasi
Niereninsuffizienz	njurinsufficiens
Nierenkrankheit	njursjukdom
Nierenleiden	njursjukdom
Nierenschale	njurskål
Nierenstein	njursten
Nierentransplantation	njurtransplantation
Nikotinvergiftung	nikotinförgiftning
Notarzt	jourläkare
Notarzt	jourläkare
Notaufnahme	akutmottagning
Notfallrettungsdienst	räddningstjänst
Nymphomanie	nymfomani
Nystagmus	nystagmus
Nystagmus	ögondarrning
O-Beine	hjulbent
O-beinig	hjulbent
Obduktion	obduktion
obduzieren	obducera
Oberarm	överarm
Oberarmknochen	överarmsben
Oberarmsspeichenmuskel	arm-strålbensmuskel
Oberbiss	överbett
obere Atemwege	övre luftvägarna
obere Gekröseschlagader	övre tarmkäxartär
obere Hohlvene	övre hålvenen
oberer Atemtrakt	övre luftvägarna
Oberhaut	överhud
Oberkiefer	överkäksben
Oberlied	övre ögonlock
Oberlippe	överläpp
Oberschenkel	lårben
Oberschenkel	lår
Oberschenkelgurt	lårbensband
Oberschenkelknochen	lårben
Odontalgie	odontalgi
Odontologie	odontologi
Odontophobie	odontofobi
ohnmächtig	avsvimmad
Ohr	öra
Ohrenausfluss	öronflytningar
Ohrenentzündung	öroninflammation
Ohrengeräusche	öronsus
Ohrensausen	susningar i öronen
Ohrenschmalz	öronvax
Ohrenschmerzen	ont i öronen
Ohrkrempe	helix
Ohrläppchen	örsnibb
Okklusivverband	ocklusivförband
Olekranon	armbågsutskott
Onkologie	onkologi
Onkologie	onkologi
Operation	operation
operationspflichtig	operationskrävande
Operationssaal	operationssal
Operationsschwester	operationssköterska
Operationstisch	operationsbord
Optiker	optiker
ordinieren	ordinera
Organempfänger	organmottagare
Organspender	organdonator
Organverpflanzung	organtransplantation
Orgasmus	orgasm
Orthese	ortopedisk protes
Orthese	ortos
Orthesentasche	ortopedisk protesficka
Orthonyxie	nagelkorrigering
Orthopädie	ortopedi
Orthopädiemechaniker	ortopedmekaniker
Orthopädietechniker	ortopedtekniker
Osteoporose	osteoporos
Papillarmuskeln	papillarmuskler
Parästhesie	parestesi
parietale Pleura	yttre lungsäcksblad
Patella	knäskål
Pathologie	patologi
Patient	patient
Patienteninformationen	patientinformation
Pädiatrie	pediatrik
Pendelniere	vandrande njure
perakut	perakut
Periode	menstruation
perioral	perioral
Peritonealdialyse PD	peritonealdialys PD
Peritonsillitis	halsböld
Peroxydpulver	peroxidpulver
Petrischale	petriskål
pflanzlich	vegetabilisk, växt-
Pflaster	plåster
Pflegeöl	skötselolja
Pharmakologie	farmakologi
Philtrum	näsfåra
Physiotherapie	fysioterapi
Pigmentmal	leverfläck
Plantarflexion	plantarflexion
plastische Chirurgie	plastikkirurgi
Platzwunde	gapande sår
plötzlicher Kindstod, SIDS	plötslig spädbarnsdöd
Pleurahöhle	pleurahåla
Pneumologie	pneumologi
Pocken	smittkoppor
Pockenimpfung	smittkoppsvaccinering
Pofalte	stjärtveck
Pognophobie	pognofobi
Polimyelitis	barnförlamning
Polio	polio
polymerisieren	polymerisera
polymorphe Lichtdermatose, PLD	soleksem
Potomanie	potomani
Praxisgebühr	praktikavgift
Prävention	prevention
Prellungen	kontusioner
Primärbehältnis	primärbehållare
Prophylaxe	profylax
Propolis	propolis
Prothese	protes
Prothese ausbetten	urbädda protes (ta ur protes)
Prothese einbetten	inbädda protes (lägga in protes)
Psellismus	psellism
Psychose	psykos
Psychotherapie	psykoterapi
Puder	puder
Puerpuralpsychose	amniningspsykos
Pulmonalklappe	pulmonalklaff
Pulsmessung	pulsmätning
Pulswelle	pulsvåg
Pulver	pulver
Pumpball	gummiblåsa
Punktion	punktion, punktering
Pupille	pupill
purulent	varig
Pyromanie	pyromani
Quacksalber	kvacksalvare
Quacksalberei	kvacksalveri
Quecksilbervergiftung	kvicksilverförgiftning
Querschnittslähmung	paraplegi, dubbelsidig förlamning
Quetschungen	klämskador
Quick-Wert	quick-värde
Rachen	svalg
Rachitis	engelska sjukan, rakitis
Raucherhusten	rökhosta
röcheln	rossla
Röteln	röda hund
Rücken	rygg
Rückenmark	ryggmärg
Rückenpelotte	ryggpelott, ryggradspelott
Rückenschiene	ryggskena
Rückenschmerz	ryggvärk
Rückenschmerzen	ryggont
Rückenwirbel	ryggkota
Rückenwirbel	ryggkota
Rückfall	återfall
Rückfall	recidiv
Rückfall	återfall
rückverlagertes Schlafphasensyndrom	försenat sömnfassyndrom
reaktivieren	reaktivera
rechte Herzkranzarterie	höger kransartär
rechte Kammer	höger kammare
rechte Vorkammer, RV	höger förmak
rechter Vorhof	höger förmak
rechtes Herzohr	höger hjärtöra
Rechtsmedicin	rättsmedicin
Reflexbewegung	reflexrörelse
Regenbogenhaut	regnbågshinna
Rehabilitation	rehabilitering
reinigend	rengörande
Reizung	retning
Rettungswagen	ambulans
rezeptfrei	receptfri
rezeptpflichtig	receptbelagd
Rezidiv	recidiv
Rhagaden	ragader
Rhesusfaktor	rhesusfaktor, rh-faktor
Rheuma	reumatism
Rheumatologie	reumatologi
Rhinitis	snuva
Riemenmuskel	remmuskel
Ringelröteln	femte sjukan
Ringknorpel	sköldbrosk
Rippenfellentzündung	lungsäcksinflammation
Risikogruppe	riskgrupp
Rohköstler	råkostätare
Rosskur	hästkur
Rotatorenmanschette	rotatorkuff
rotäugig	rödögd
ruhebedürftig	i behov av vila
Ruhepuls	vilopuls
ruhigstellen	stadga
Rumpf	bål
Rumpfmuskulatur	bålens muskulatur
runder Einwärtsdreher	rund pronator
Rundrücken	kutrygg
Rundrückenbildung	bildande av kutrygg
Runzel	skrynkla, rynka
Salbe	salva
Salzstauungssyndrom	symptom på dehydrering
Samen	sperma
Samenbläschen	sädesblåsa
Samenleiter	sädesledare
Samenspender	spermadonator
Samenstrange	sädessträng
Sanitätsflugzeug	ambulansflygplan
Sarkom	sarkom
SARS	SARS
Sauerstoff	syre
Sauerstoffentsättigung	desaturation
Sauerstoffsättigung	syrgasmättnad
Sauerstoffsättigung	oxygenmättnad
Sauerstoffsättigung	saturation
Säugling	spädbarn
Säuglingsalter	spädbarnsålder
Säuglingsnahrung	barnmat
Säuglingspflege	spädbarnsvård
Säuglingsschwester	barnsköterska
Säuglingssterblichkeit	spädbarnsdödlighet
südamerikanische Trypanosomiasis	Chagas' sjukdom
Schafhaut	amnion
Schambein	blygdben
Schamlippen	blygdläppar
Schädel	skalle, kranium
Schädelbruch	skallfraktur
Schädeldecke	skalltak
Schönheitsfarm	skönhetsinstitut
Schönheitsoperation	skönhetsoperation
Schürfwunde	skrubbsår
Schüttelfrost	frossa
Scheidewand	skiljevägg
Scheitel	hjässa
Scheitelbein	hjässben
Schenkel	lår; skänkel
Schenkelbruch	lårbensbrott
Schenkelhals	lårbenshals
Schenkelmuskel	lårmuskel
Scheuerdesinfektion	intensivdesinfektion
schielen	skela
Schienbein	skenben
Schienbeinmuskel	skenbensmuskel
Schilddrüse	sköldkörtel
Schlaf	sömn
Schlafkrankheit	sömnsjuka
schlaflos	sömnlös
Schlaflosigkeit	sömnlöshet
Schlafmittel	sömnmedel
Schlafstörungen	sömnlöshet, insomnia, asomnia
Schlaftablette	sömnpiller, sömntablett
schlaftrunken	yrvaken, sömndrucken
schlafwandeln	gå i sömnen
Schlafwandler	sömngångare
Schlag	slag
Schlagader	pulsåder
Schlaganfall	slaganfall
Schlangenbiss	ormbett
Schläfe	tinning
schläfrig	sömnig
Schlüsselbein	nyckelben
Schleim	slem
Schleimbeutel	slemsäck
Schleimbeutelentzündung	slemsäcksinflammation
Schleimbeutelentzündung	bursit
Schleimhaut	slemhinna
Schließmuskel	slutmuskel
Schlussbissstellung	interkuspidation
Schmerzempfinden	smärtförnimmelse
Schmerzen	smärtor
Schnecke	öronsnäcka
Schneidermuskel	skräddarmuskel
Schnittwunde	skärsår
Schnupfen	snuva
Schock	chock
Schocktherapie	chockbehandling
Schollenmuskel	flundraliknande muskel
Schonkost	diet, skonkost
schonungsbedürftig	i behov av vila
Schramme	skråma
schrammen	repa
Schrittmacher	pacemaker
Schrumpfleber	skrumplever, levercirros
Schrumpfniere	skrumpnjure
Schulmedizin	skolmedizin
Schulter	skuldra
Schulter	axel
Schulterblatt	skulderblad
Schussverletzung	skottskada
Schusswunde	skottsår
Schwachsinn	begåvningshandikapp, förståndshandikapp
schwachsinnig	förståndshandikappad
schwanger	gravid
Schwangere	havande kvinna
Schwangerschaft	graviditet
Schwangerschaftsabbruch	abort
Schwangerschaftstest	graviditetstest
Schwangerschaftsunterbrechung	framkallad abort, framkallat missfall
Schwangerschaftsurlaub	graviditetsledighet
schwarzer Star	svart starr
Schwarzwucherhaut	svartpigmenterad hudförändring
Schwächeanfall	plötsligt könna sig svag
schwängern	göra gravid
Schweißausbruch	plötsligt börja svettas
Schweißdrüse	svettkörtel
Schweigepflicht	tystnadsplikt
Schwellenangst	rädsla för att gå in i byggnader
Schwellung	svullnad
schwer verwundet	svårt sårad
Schwerbehinderter	svårt handikappad
schwere akute Atemwegssyndrom (SARS)	SARS
schwerhörig	lomhörd
Schwerhörigkeit	nedsatt hörsel
schwermütig	melankolisk, tungsint
Schwermut	melankoli, tungsinne
Schwielen	hudvalkar
Schwindel	svindel, yrsel
schwindelfrei	inte besväras av yrsel
Schwindelgefühl	svindel
schwindlig	yr
Schwitzbad	ångbad, svettdrivande bad
schwitzen	svettas
Schwitzen	svettning
Schwitzkur	svettkur
schwummrig	yr, illamående
Schwund	förtvining
seekrank	sjösjuk
Seekrankheit	sjösjuka
Seele	själ
Seelenfriede	sinnesfrid
Seelenleben	själsliv
Seelenwanderung	själavandring
Seelenzustand	själstillstånd
seelisch	själslig, psykisk
seelische Belastung	psykisk påfrestning
Seelsorge	själavård
Seelsorger	själasörjare
Sehbehindert	synskadad
Sehbehinderter	synskadad
Sehfeler	synfel
Sehkraft	synförmåga
Sehne	sena
Sehnenansatz	senfäste
Sehnenscheidenentzündung	senskideinflammation
Sehnenscheidenentzündung	tendovaginit
Sehnenzerrung	sensträckning
Sehnerv	synnerv
Sehnervkreuzung	synnervskorsning
Sehschärfe	synskärpa
Sehschwäche	nedsatt syn
Sehstörung	synrubbning
Sehtest	syntest
Sehvermögen	syn
seine Gesundheit vernachlässigen	missköta sin hälsa
Seitenstechen	håll i sidan
Sekret	sekret
Sekretstau	kraftig slembildning
Sekundenschlaf	sekundsömn
Selbstbefriedigung	onani
Selbstmord	självmord
Selbstmordgefährdet	person som riskerar att begå självmord
Selbstvertrauen	självförtroende
sensibel	sensibel, känslig
Sensibilität	sensibilitet
sentimental	sentimental
Sentimentalität	sentimentalitet
Septum	septum
Serum	serum
Seuche	epidemi
Seuchenbekämpfung	bekämpning av epidemi
Seuchengefahr	risk för epidemi
Sexappeal	sexuell dragningskraft
Sexualerziehung	sexualundervisning
Sexualität	sexualitet
Sexualkunde	sexualkunskap
Sexualleben	sexualliv
sezieren	dissekera
siamesische Zwillinge	siamesiska tvillingar
sich ärztlich untersuchen lassen	låta läkarundersöka sig
sich einen Muskel verzerren	sträcka en muskel
sich verbrühen	skålla sig
sich verbrennen	bränna sig
sich verheben	förlyfta sig
sich verschlucken	sätta något i halsen
Sie ist in anderen Umständen	Hon väntar barn
Siebenmonatskind	barn fött i sjunde månaden
Silikos	silikos
Sinnesart	sinnelag
Sinneseindruck	sinnesintryck
Sinnesorgan	sinnesorgan
Sinnestäuschung	sinnesvilla
Sinusitis	bihåleinflammation
Sitiomanie	sitiomani
Sitophobie	sitofobi
Sitzbein	sittben
Skalpell	skalpell
Skelettmuskulatur	skelettmuskulatur
Sklera	senhinna
Sklerose	skleros
Skorbut	skörbjugg
Skotophobie	skotofobi, aklyofobi
Skotophobie	skotofobi
Sodbrennen	halsbränna
Soforthilfe	akuthjälp
Sofortmaßnahme	omedelbar åtgärd
Sohlenspanner	fotsulemuskel
Sommersprossen	fräknar
Sonnenallergie	soleksem
Sonnenöl	sololja
Sonnenbrand	solsveda
Sonnenbräune	solbränna
Sonnenekzem	soleksem
Sonnengeflecht	solar plexus
Sonnenschutzmittel	solskyddsmedel
Sonnenstich	solsting
Soziologe	sociolog
Soziologie	sociologi
soziologisch	sociologisk
Spann	vrist
Spastiker	spastiker
spastisch	spastisk
Spatel	spatel
Spätentwickler	barn med sen utveckling
Spätfolgen	efterverkningar
Spätzünder	barn med sen utveckling
Speiche	strålben
Speichel	saliv
Speicheldrüse	spottkörtel
Speichelfluß	stark spottavsöndring
Speischale	spottkopp
Speiseröhre	matstrupe
Spezialarzt	specialist
Spezialist	specialist
spinal	ryggrads...
spindeldürr	spinkig
splitterfasernackt	spritt språngande naken
splitternackt	spritt språngande naken
spontanatmend	spontanandande
Sporttherapie	sportterapi
Sportverletzung	idrottsskada
Sprachfehler	talfel
sprachlos	mållös
Sprechstunde	mottagningstid
Sprechstundenhilfe	mottagningssköterska
Sprechzimmer	mottagningsrum
Sprechzimmer	läkarens mottagningsrum
Spreizfuß	spretfot
Spritze	spruta
Sprungbein	språngben
Sprunggelenk	språngbensled
Sprunggelenkorthese	ortos för språngbensleden
Starbrille	starrglasögon
Station	avdelning
Staublunge	dammlunga
Ständer	stånd
Steißbein	svansben
Steigbügel	stigbygel
sterile Druckluft	steril tryckluft
Stickstoff	kväve
stillen	amma
Stimmbänder	stämband
Stirn	panna
Stirnbein	pannben
Stirnhöhle	pannhåla
Stoffwechsel	ämnesomsättning
straffend	stramande
Striktur	striktur
stumm	stum
Symphyse	blygdbensfog
Systole	systole
systolisch	systolisk
systolisch	systolisk
Tablette	tablett
Tablettensüchtiger	läkemedelsmissbrukare
Taille	midja
Talgdrüse	talgkörtel
Tamponade	tamponad
taub	döv
taub	avdomnad
Taubheit	dövhet
Taubheit	känslolöshet i ben eller armar
taubstumm	dövstum
Taucherkrankheit	dykarsjuka
Teerstuhl	melena
Teilprothese	partialprotes
Tendovaginitis	senskideinflammation
teratogen	fosterskadande
thorakal	torakal
Thorax	bröstkorg
Thoraxchirurgie	toraxkirurgi
Thrombozyt	trombocyt
Thrombozytopenie	trombocytopeni
Thymusdrüse	inre bröstkörtel
Tibiakopf	tibiakondyl
Tibiakopffraktur	tibiakondylfraktur
Tinnitus	tinnitus
Totalprothese	helprotes
Toxikologie	toxikologi
Transfusionsmedizin	transfusionsmedicin
Trauma	trauma
Tränen	tårar
Tränendrüse	tårkanal
Tränenflüssigkeit	tårar
Tränenwege	tårkanaler
trübend	opacifierande
Trichotillomanie	trikotillomani
Trikuspidalklappe	trikuspidalklaff
Trikuspidalklappe	tresegelsklaffen
Tropophobie	tropofobi
Tupfer	sudd
Ultrafiltration	ultrafiltration
Ultraschallbad	ultraljudsbad
Umweltmedizin	miljömedicin
umwickeln	binda om (med förband)
Unfallchirurgie	olycksfallskirurgi
Unfallopfer	olycksoffer
Unfallstation	akutmottagning
Unfallstelle	olycksplats
Unfallwagen	ambulans, krockskadat fordon
unheilbar	inkurabel
unhygienisch	ohygienisk
unoperierbar	inoperabel
unreif	omogen
Unterarm	underarm
Unterbewusstsein	undermedvetande
unterdurchschnittlich begabt	svagt begåvad
untere Hohlvene	nedre hålven
untere Hohlvene	undre hålvenen
unterentwickelt	underutvecklad
unterernährt	undernärd
Unterernährung	undernäring
Unterfütterung	underfyllning
Unterfunktion	hypofunktion
Untergewicht	undervikt
untergewichtig	underviktig
Untergrätenmuskel	musculus infraspinatus
Unterkörper	underkropp
unterkühlt	nedkyld, reserverad
Unterkiefer	underkäksben
unterlassene Hilfeleistung	underlåten hjälp
Unterleib	underliv
Unterlied	nedre ögonlock
Unterlippe	underläpp
Unterschenkel	underben
Unterschenkelgurt	underbensband
unterschwellig	undermedveten
unterstellen	insinuera
Unterstellung	insinuation
untersuchen	undersöka
Untersuchungsraum	behandlingsrum
Unterversorgung	otillräckligt näringsintag
unversehrt	oskadd, välbehållen
unverträglich	intolerant
Unverträglichkeit	intolerans
unverwüstliche Gesundheit	järnhälsa
unweiblich	okvinnlig
Unwohlsein	illamående
Urin	urin
Urinprobe	urinprov
Vagina	vagina
Vaterschaftsurlaub	pappaledighet
väterlicherseits	på fädernet
VE-Wasser	komplett avsaltat vatten
Veilchen	blått öga
venöse Insuffizienz	venös insufficiens
venöser Blutstau	venös stasning
venöses Blut	venöst blod
Vene	ven
Vene	ven
Venenentzündung	flebit, blodåderinflammation
Venenpunktion	venpunktion
venerisch	venerisk
verabreichen	dosera
Veranlagung	anlag
verarzten	plåstra om
veröden	behandla åderbråck med injektioner
Verband	bandage, förband
Verbandkasten	förbandslåda
Verbandmaterial	förbandsutrustning
Verbandskasten	förbandslåda
verblassen	blekna, bli blek
verbluten	förblöda
verbrennen	brännas till döds
Verbrennung	brännskada, kremering
Verdauung	matsmältning
Verdauungsapparat	matsmältningssystem
Verdauungsbeschwerden	matsmältningsbevsär
verdrießlich	misslynt
vererbt	medfödd, nedärvd
Vererbung	ärftlighet
Vererbungslehre	ärftlighetslära
Verfolgungswahn	förföljelsemani
Vergällung	denatureringsmedel
vergesslich	glömsk
Vergesslichkeit	glömska
vergewaltigen	våldta
Vergewaltigung	våldtäkt
vergreisen	bli äldre
Verhaltensforschung	beteendeforskning
verhärmt	sliten, tärd av bekymmer
Verhütung	användning av preventivmedel
Verhütungsmittel	preventivmedel
verhungern	svälta ihjäl
verkalken	bli åderförkalkad
verkalkt	åderförkalkad
verkatert	bakfull
verkeimt	kontaminerad
Verlangen	begär
verlängertes Mark	förlängd märg
verletzbar	lättsårad
Verletzbarkeit	sårbarhet
Verletzter	skadad, sårad
verletztlich	ömtålig, sårbar
Verletzung	skada, sår
vernachlässigt aussehen	ge ett ovårdat intryck
vernarben	ärra sig, läkas
verordnen	ordinera
Verordnung	ordination
verrückt	tokig, galen
Verrückter	galning, sinnesrubbad
verrenken	vrida ur ledm vricka
Verrenkung	vrickning
verschlafen	sömndrucken, yrvaken
Verschleiß	förslitning
Verschleißerscheinung	förslitningssymptom
verschlucken	svälja
verschreibungspflichtig	receptbelagd
verschwitzt	genomsvettig
verschwommen	otydlig, suddig
versehrt	invalidiserad
Versehrter	invalid
verseuchen	smitta ned
Verstand	förnuft, vett
verstandesmäßig	förnuftsmässig
verstauchen	stuka, vricka
Verstauchung	stukning, vrickning
Verständigungsschwierigkeiten	svårigheter att göra sig förstådd
verstört	uppskakad, uppriven
verstümmeln	lemlästa
Verstopfung	förstoppning
verstorben	avliden
verstummen	bli stum, förstummas
Versuchskaninchen	försökskanin
Versuchsperson	försöksperson
Vertrauensarzt	förtroendeläkare
verträgliche Speisen	lättsmält mat
Verträglichkeit	tolerans
verwachsen	växa ihop, läkas
verweichlicht	förvekligad, klen
verweint	förgråten
verwirrt	virrig, förvirrad
verwundbar	sårbar
Verzweiflung	förtvivlan
Virustatika	virustatika
viskositätsregelnd	viskositetsreglerande
Viszeralchirurgie	abdominalkirurgi
Vitaldaten	vitaldata
Vitalfunktionen	allmäntillstånd
Vitamin	vitamin
Vitaminbedarf	vitaminbehov
Vitaminmangel	vitaminbrist
Vitaminstoß	vitaminchock
voll	packad, full
vollentsalztes Wasser	komplett avsaltat vatten
vollschlank	fyllig, kraftig
Vollwaise	föräldralöst barn
Vollwertkost	näringsriktig kost, hälsokost
vom Mund entfernt	aboral
Vorahnung	föraning, förkänsla
Vorbau	kraftig byst
vorbeugen	förebygga
vorbeugende Gesundheitsvorsorge	friskvård
Vorderzahn	framtand
vorehelich	föräktenskaplig
Vorgeschichte	amnes
Vorhof	förmak
Vormundschaft	förmyndarskap
vorverlagertes Schlafphasensyndrom	för tidigt sömnfassyndrom
Voyeur	smygtittare, voyeur
Wacholderbeerenöl	enbärsolja
Wachstum	tillväxt
wachstumsfördernd	tillväxtfrämjande
wachstumshemmend	tillväxthämmande
Wachstumshormon	tillväxthormon
Wade	vad
Wadenbein	vadben
Wanderniere	vandrande njure
Wange	kind
Wangenknochen	kindknota
Wasserretention	vattenretention
wächsern	vaxblek
Wöchnerin	nyförlöst kvinna
Wechselbad	växelbad
wiederaufbereiten	behandla för återanvändning
wiederbeleben	återuppliva
Winde	väderspänning
Windpocken	vattkoppor
Wirbel	kota
Wirbelkörper	kotkropp
Wirbelsäule	ryggrad
Wirksubstanzen	verksamma ämnen
Wirkweise	verkningssätt
Wischdesinfektion	avtorkningsdesinfektion
Wischdesinfektion	avtorkningsdesinfektion
WK-Fraktur	fraktur i kotkroppen
Workaholic	arbetsnarkoman
Wundauflage	förband
Wunddehiszenz	sårruptur
Wunde	sår
Wundstarrkrampf	stelkramp
Wundverband	sårförband
Wurzelfüllung	rotfyllning
Wurzelkanal	rotkanal
X-Beine	kobent
Xenophobie	xenofobi
Zahn	tand
Zahnarzt	tandläkare
Zahnarzthelferin	tandläkarassistent
Zahnbelag	plack
Zahnen	tandsprickning
Zahnersatz	tandprotes
Zahnfächer	tandhålor
Zahnfäule	tandröta
Zahnfleisch	tandkött
Zahnfleischbluten	blödande tandkött
Zahnklammer	tandställning
Zahnkrone	tandkrona
zahnlos	tandlös
Zahnlücke	glugg
Zahnmedizin	odontologi
Zahnpflege	tandvård
Zehenendglied	distalfalang
Zehengrundglied	proximal falang
Zeigefinger	pekfinger
Zeitgeber	tidsgivare
Zentralnervensystem	centrala nervsystemet
Zirbeldrüse	tallkottskörtel
Zirbeldrüse	epifys, tallkottkörtel
Zoophobie	zoofobi
Zuckerkrankheit	sockersjuka
Zunge	tunga
Zwerchfell	diafragma, mellangärde
Zwillinge	tvillingar
Zwillingswadenmuskel	vadmuskel
Zwischenknochenmuskel	inter ossermuskel
Zwischenwirbelgelenke	fasettleder
Zwölffingerdarm	tolvfingertarm
Zwölffingerdarm	tolvfingertarm
Zyste	cysta
zytologischer Abstrich	cellprov
Zytostatikaabfall	cytostatikaavfall
Zytostatikawerkbank	cytostatikabänk
zytostatikum	cytostatikum
