compromissioni	daños o lesiones corporales
controcampione	contramuestra del certificado de análisis
elicina	elicina
gambale	reposapiernas
metodo ratio	método de relación, método ratio
Reporting Officers	funcionarios/personal informante(s)
riduttività	reductividad
stato drammatico di empasse	estado dramático de bloqueo o callejón sin salida
tensioliti	tensiolíticos
titolo	concentración
trattamenti sanitari / medici	tratamientos sanitarios y/o médicos
parti/tessuti molli	partes blandas
posizione di riposo	postura de descanso
predittori indipendenti	predictores independientes
biopsia ossea	punción ósea
lastra radiografica	laminilla
i fini	los finos
risvolti singolari	repercusiones, implicancias particulares, (únicas, peculiares)
anagrafica trattamenti	tratamiento de los síntomas distintivos de una enfermedad
Effetto collaterale	efectos secundarios
laser luce guida	guía [posicionador]  de rayo láser
Direzione Medica di Presidio	dirección médica del centro hospitalario
medico privato	medico particular
attaccaglie	abrazadera/grapa (de sujeción)
Ipopotassiemia	Hipopotasemia/Hipokalemia
pur/sia pur	aunque
rimbalzo	congestión de rebote
barella ** da corsia **	camilla de crujía/pasillo
cucine di reparto	cocinas por departamento/ por sección/ departamentales
gambale	reposapiernas
hiperhidrosidad	iperidrosi
presidio	sustancia
materiale da otturazione/di riempimento (amalgama)	relleno
rosso bovino diffuso	coloración rojo oscura difusa/de aspecto difuso
sintomi di prima e seconda comparsa	síntomas primarios y secundarios
sintomi di prima e seconda comparsa	síntomas primarios y secundarios
tubulonecrosi renale acuta	necrosis tubular renal aguda
veicolare	vehicular
legami	enlaces
accidente cerebrovascolare	accidente cerebrovascular
Actina	Actina
Abductor largo	Adduttore lungo
Adeguamento (della dose)	Ajuste
Alvéolo	Alveolo
Amigdalite	Amigdalitis
Anestesista	Anestesista
Angiomas	Angiomi
Anisocórico	Anisocorico
Antehelix	Antelice
Antipertensivo	Antihipertensivo
Sistema circulatorio	Apparato circolatorio
Aparato de Golgi	Apparato del Golgi
Sistema respiratorio	Apparato respiratorio
Arco aórtico	Arco dell'aorta
Arteria aorta	Arteria aorta
Arteria axilar	Arteria Ascellare
Arteria braquial	Arteria brachiale
Arteria Carótide	Arteria Carotide
Arteria mesentérica superior/inferior	Arteria mesenterica superiore/inferiore
Arteria pulmonar izquierda/derecha	Arteria polmonare sinistra/destra
Arteria renal	Arteria renale
Arteria subclavia	Arteria succlavia
Arteria testicular	Arteria testicolare
Arteria tibial anterior/posterior	Arteria tibiale anteriore/posteriore
Axón	Assone
Dispensario	Astanteria
Atelectasia	Atelettasia
Atelectasia adquirida	Atelettasia acquisita
Aurícula derecha/izquierda	Atrio destro/sinistro
Bíceps femoral	Bicipite femorale
Bifurcación de la tráquea	Biforcazione della trachea
Bilis	Bile
Biochimica ematologica	Bioquímica sanguínea
Blastocisto	Blastocisti
Braquial	Brachiale
Bronquiectasie	Bronchiectasie
Bulbo olfatorio	Bulbo olfattivo
Canal radicular	Canale della radice
Carpo	Carpo
Cartílago	Cartilagine
Caja torácica	Cassa toracica
células madre totipotentes	cellule staminali pluripotenti/totipotenti
Cerebelo	Cervelletto
Pelvis	Cinto pelvico
Catecol-O-metiltransferasi	COMT
segala comuta	cornezuelo de centeno
Cuerpo calloso	Corpo calloso
Cuerpo ciliar	Corpo ciliare
Humor vítreo	Corpo vitreo
Córtax cerebral	Corteccia cerebrale
Deltoide	Deltoide
Dendritas	Dendriti
Dentina	Dentina
Dermis	Derma
stato off	estado off
información adicional	inf. adic.
información adicional/informazione aggiuntiva/ulteriori informazioni	inf. adic.
Referto medico	Informe médico
Innesti	Injertos
Rilascio del farmaco	Liberación
Cerotto transdermico	Parche transdérmico
Pergolide	Pergolida
post-infettivo	postinfectoso
Test esatto di Fisher	Prueba exácta de Fisher
Retrovirus	Retrovirus
Saturímetro	Saturimetro
sindrome delle gambe senza riposo	síndrome de las piernas inquietas
Monitoraggio, controllo	seguimiento
Tomografia assiale computerizzata ad emissione di fotoni singoli	SPECT
TAC	TAC
Tracciante	Trazador
UPDRS (Scala Unificata per la Valutazione della Gravità della Malattia di Parkinson)	UPDRS
Svuotamento gastrico	Vaciado gástrico
Emivita	Semivida
corticoidi	corticoides
a strappo	a presión (en este contexto)
a strappo	a presión (en este contexto)
carico	carga
piano crestale	plano/nivel crestal
SEM	SEM (microscopio electrónico de barrido)
stop	tope de fresa
morsi uterini o crampi (uterini)	dolores de entuerto o calambres del útero
dosaggio/dì = dosaggio/giorno / dosaggio al dì / dosaggio al giorno	dosaje/día
(gel) Ioson stabilizzante	Ioson reafirmante
soffrire come un'anima in pena	penar como un aparecido
(complesso di) estratti vegetali	Poliplant
rimanere senza assistenza	quedar desantendido
spostato verso la dolcezza	con tendencia hacia lo dulce / tendiente...
setto vescicovaginale	tabique vesicovaginal
soffrire o essere sconvolti nel corpo e nello spirito	tener desazonados el cuerpo y el espíritu
tripide	trip
avvitatore	atornillador
bagnabilità	mojabilidad
cappette di copertura	cofias de cobertura
connessioni	conexiones
fixture	implante / tornillo
fresa	fresa
legami trabecolari	trabéculas
marcatura (impianti)	marcas
maschiatura	roscado
mounter	mounter transportador
osteointegrazione	osteointegración
sabbiatura	arenado
spire autofilettanti	espiras autorroscantes
strumenti diamantati	instrumental diamantado
strumenti rotativi	instrumental rotatorio
zona di sfogo	aliviadero
(applicazione/impiego di) sostanza colorante	Tinción
usa al bisogno	toma ... según necesidad // cuando/cada vez que sea necesario
basi normoespansibili	expansión normal de los pulmones/bases pulmonares
Day hospital	hospital de día/unidad de antención diurna
Deflussore Sangue	(Dispositivo) Regulador de Flujo Sanguíneo (para infusiones)
distaccamento	dependencia
esiti tubercolari	complicaciones de tipo/carácter tuberculoso // casos sucesivo/resultantes // consecuencias/resultados de tuberculosis
esito fatale/infausto	exitus
istomorfologiche	Histomórficas
in sede mantellare	en la zona del manto
manifestazione clinica, (costituita da) segni e sintomi, di [...]	manifestación clínica síntomas y signos, de [...]
(Orto)panoramica preoperatoria	Pano preoperatoria
[incidenza annuale] per età ogni 100000 abitanti nel primo anno	[La incidencia anual] por cada 100.000 habitantes y año 1 y es edad-dependiente
X concatenati	X en cadena
precedentemente, in precendeza	preventivamente
navicella per pesata	Navetas de pesada
carta da filtro - a basso contenuto di azoto	papel filtro bajo en
automedicazione	autocuidado
terme minerali-curative	balnearios mineromedicinales
ristagno d'acqua	coleccion de agua
morbo di Chagas/ tripanosomiasi americana)	enfermedad de Chagas
malattie diarroiche acute	enfermedades diarréicas agudas (EDA)
febbre tifoide	fiebre tidoidea
istituti di sostegno alla maternità/trutture sanitarie per gestant	hogar materno
ittero	ictericia
infezioni respiratorie acute (IRA)	infecciones respiratorias agudas (IRA)
Leishmaniosi	Leishmaniasis
morbi-morbilità	morbi-mortalidad
parossismo malarico	paroxismo palúdico
prodomo	pródromo
ecchimosi	roncha
tifo epidemico	tifus epidémico
tifo murino	tifus murino
bypass aorto-femorali	Derivación aorto-femoral
diluito al XX%	diluido al XX%
morfofenotipici	morfofenotípicos
fi se die	ampolla subcutánea al dìa
Toni cardiaci ritmici/validi/normofrequenti	RBG (ruidos bien golpeados)
Azienda ospedaliera	Empresa Hospitalaria
Espansibilità polmonare	Expansibilidad pulmonar
Gabbia toracica	Caja Torácica
interstizio polmonare	intersticio pulmonar
MDC (mezzo di contrasto)	Medio de contraste
Otorinolaringoiatria	Otorrinolaringología
perfusione endovenosa	perfusión intravenosa
Reparto	División
TC	TAC/ TOMOGRAFÍA COMPUTARIZADA
chiraliche (molecole)	quiralicas (moleculas)
vernici poliuretaniche	pinturas poliuretanicas
andamento bimodale	evolución bimodal
efficacia o meno di una data cura biologica	eficacia eventual de un determinado tratamiento biológico
rosa mosqueta; Rosa affinis rubiginosa	rosa mosqueta
